--------------------------------------------------------------------------------------------------------------------------------------------------------------------------------------------------------
--------------------------------------------------------------------------------------------------------------------------------------------------------------------------------------------------------
--------------------------------------------------------------------------------------------------------------------------------------------------------------------------------------------------------
--------------------------------------------------------------------------------------------------------------------------------------------------------------------------------------------------------
--------------------------------------------------------------------------------------------------------------------------------------------------------------------------------------------------------
--------------------------------------------------------------------------------------------------------------------------------------------------------------------------------------------------------
--------------------------------------------------------------------------------------------------------------------------------------------------------------------------------------------------------
--------------------------------------------------------------------------------------------------------------------------------------------------------------------------------------------------------
--------------------------------------------------------------------------------------------------------------------------------------------------------------------------------------------------------
--------------------------------------------------------------------------------------------------------------------------------------------------------------------------------------------------------
--------------------------------------------------------------------------------------------------tt-----------------------------------#---#------------------------------------------------------------
--------------------------------------------------------------------------------------------Tt----tt----------------------------------##---##-----------------------------------------------------------
-------------------%%---%%---------------------------------------------%%%%%--%%%%%%%--%%---tt----tt--------------------------------%%%%---%%%%---------------------------------------------------------
%%%%%%%%%%%%%------||---||%%%%%--%%%%%----------#--#---------%%%%--%%%%|||||--|||||||--||%%%%%%%%%%%%-----------%%---%%%%%%%---%%%%%||||---||||%%%%%%%%F%%%%%%%%%%%%%%%%%%%%%%%%%%%%%%%%%%%%%%%%%%%%%%%%
|||||||||||||%%%%%%||---|||||||--|||||%%---%%--##--##--------||||--|||||||||--|||||||--||||||||||||||%%%%---%%%%||---|||||||---|||||||||---||||||||||||%||||||||||||||||||||||||||||||||||||||||||||||||
|||||||||||||||||||||---|||||||--|||||||---||XXXX--XXXXXX--XX||||--|||||||||--|||||||--||||||||||||||||||---||||||---|||||||---|||||||||---|||||||||||||||||||||||||||||||||||||||||||||||||||||||||||||
