--------------------------------------------------------------------------------------------------------------------------------------------------------------------------------------------------------
--------------------------------------------------------------------------------------------------------------------------------------------------------------------------------------------------------
--------------------------------------------------------------------------------------------------------------------------------------------------------------------------------------------------------
--------------------------------------------------------------------------------------------------------------------------------------------------------------------------------------------------------
----------------------------------SS2-------------------------------------------------------------------------------------------------------------------------------------------------------------------
--------------------------------------------------------------------------------------------------------------------------------------------------------------------------------------------------------
--------------------------------------------------------------------------------------------------------------------------------------------------------------------------------------------------------
----------------------------------y---------------------------------------------------------------------------------------------------------------------------------------------------------------------
--------------------------------%%%%%%%-------UUSS------------------------------------------------------------------------------------------------------------------------------------------------------
--------------------------------|||||||----------------------------------kr--Y--------------------------------------------------------------------------------------------------------------------------
--------------------------------||||y||----------------------------------%%%%%-------------------------------------------y------------------------------------------------------------------------------
--------------------------------|%%%%%|-----------k----------------------|||||-----------------------------------------%%%------------------------------------------------------------------------------
--------------------------------|||||||----%%%%%%%%%%------#--#----------|||||-------------%%%%%%%--%%-------------g---|||-g----------------------------------------------------------------------------
-----------------%%%---%%%------|||||kg----||||||||||%%%--##--##---------|||||G------#--#--|||||||--||------------%%%%%%%%%%%%%%%%%%--------------------------------------------------------------------
%%%%%%%%%%%%-----|||---|||-----%%%%%%%%%%%%|||||||||||||%%%%--%%%%%%%%%%%%%%%%%%%%%%%%--%%%|||||||--||------------||||||||||||||||||%%--%%%%%%%%%%F%%%%%%%%%%%%%%%%%%%%%%%%%%%%%%%%%%%%%%%%%%%%%%%%%%%%%
||||||||||||XXXXX|||---|||XXXXX|||||||||||||||||||||||||||||--||||||||||||||||||||||||--||||||||||--||XXXXX--XXXXX||||||||||||||||||||--||||||||||X|||||||||||||||||||||||||||||||||||||||||||||||||||||
