--------------------------------------------------------------------------------------------------------------------------------------------------------------------------------------------------------
--------------------------------------------------------------------------------------------------------------------------------------------------------------------------------------------------------
--------------------------------------------------------------------------------------------------------------------------------------------------------------------------------------------------------
--------------------------------------------------------------------------------------------------------------------------------------------------------------------------------------------------------
--------------------------------------------------------------------------------------------------------------------------------------------------------------------------------------------------------
--------------------------------------------------------------------------------------------------------------------------------------------------------------------------------------------------------
--------------------------------------------------------------------------------------------------------------------------------------------------------------------------------------------------------
--------------------------------------------------------------------------------------------------------------------------------------------------------------------------------------------------------
--------------------------------g--------------------------------------------------------------------y-y------------------------------------------------------------------------------------------------
------------------------------%%%%%%%-------------------------------------------------------------%%%%%%------------------------------------------------------------------------------------------------
------------------------------|||||||-------------------------------------------------BB2UBB2B----||||||-----------------------------#---#--------------------------------------------------------------
------------------------------|||||||-------------------------------------------------------------||||||----------------------------##---##-------------------------------------------------------------
-----------------------------%%%%%%%%%%%------------------------------#--#------------------------|||r||-----tt--------%%%%---%%%%%%%%---%%%%-----------------------------------------------------------
-----------------------------|||||||||||%%%%%---%%%%%---------------%%%--%%%%%%--%%%----g------%%%%%%%%%%%---tt-tt--Tt-||||---||||||||---||||-----------------------------------------------------------
-----------------------------||||||||||||||||---|||||%%---%%--------|||--||||||--|||%%%%%%%%%%%|||||||||||---tt-tt--tt-||||---||||||||---||||-----------------------------------------------------------
%%%%%%%%%%%%%%%---%%%%%%--%%%||||||||||||||||---|||||||---||%%%--%%%|||--||||||--|||||||||||||||||||||||||%%%%%%%%%%%%%||||---||||||||---||||%%%%%%%%F%%%%%%%%%%%%%%%%%%%%%%%%%%%%%%%%%%%%%%%%%%%%%%%%%%
