--------------------------------------------------------------------------------------------------------------------------------------------------------------------------------------------------------
--------------------------------------------------------------------------------------------------------------------------------------------------------------------------------------------------------
--------------------------------------------------------------------------------------------------------------------------------------------------------------------------------------------------------
--------------------------------------------------------------------------------------------------------------------------------------------------------------------------------------------------------
--------------------------------------------------------------------------------------------------------------------------------------------------------------------------------------------------------
--------------------------------------------------------------------------------------------------------------------------------------------------------------------------------------------------------
--------------------------------------------------------------------------------------------------------------------------------------------------------------------------------------------------------
--------------------------------------------------------------------------------------------------------------------------------------------------------------------------------------------------------
-----------------------------------------------------------------------------------BCCUB----------------------------------------------------------------------------------------------------------------
----------------------------tt----tt--------------------------------------------------------------------------------------------------------------------------------------------------------------------
----------------------------tt----tt--------------------------------------------------------------------------------------------------------------------------------------------------------------------
----------------------------tt----tt--------------------------------------------------------------------------------------------------------------------------------------------------------------------
%%%%%%%%%%%%%------------%%%%%%%%%%%%%%------------------------------%%%%%---%%%%%%%%%%%%%%%%%---%%%%%%%------------------------------------------------------------------------------------------------
|||||||||||||------------||||||||||||||%%---%%-----%%%%%%%%%---------|||||---|||||||||||||||||---|||||||--------------------#---#-----------------------------------------------------------------------
|||||||||||||------------||||||||||||||||---||%%%%%|||||||||%%%---%%%|||||---|||||||||||||||||---|||||||%%%%%%%%%---%%%%%--##---##-----------%%%%%%%%F%%%%%%%%%%%%%%%%%%%%%%%%%%%%%%%%%%%%%%%%%%%%%%%%%%
|||||||||||||%%--%%%%%%%%||||||||||||||||---|||||||||||||||||||---||||||||---|||||||||||||||||---||||||||||||||||---|||||%%%%---%%%%%%%---%%%||||||||X||||||||||||||||||||||||||||||||||||||||||||||||||
