--------------------------------------------------------------------------------------------------------------------------------------------------------------------------------------------------------
--------------------------------------------------------------------------------------------------------------------------------------------------------------------------------------------------------
--------------------------------------------------------------------------------------------------------------------------------------------------------------------------------------------------------
--------------------------------------------------------------------------------------------------------------------------------------------------------------------------------------------------------
--------------------------------------------------------------------------------------------------------------------------------------------------------------------------------------------------------
--------------------------------------------------------------------------------------------------------------------------------------------------------------------------------------------------------
--------------------------------------------------------------------------------------------------------------------------------------------------------------------------------------------------------
--------------------------------------------------------------------------------------------------------------------------------------------------------------------------------------------------------
--------------------------------------g------SSSC2U-----------------------------------------------------------------------------------------------------------------------------------------------------
---------------tt---------------%%%%%%%-----------------------------------------------------------------------------------------------------------------------------------------------------------------
---------------tt----tt---------|||||||-----------------------------------------------------------------------------------------------------------------------------------------------------------------
---------------tt----tt---------|%%%%||-----------------------------------------------------------------------------------------------------------------------------------------------------------------
--------------%%%%%%%%%%%%%%----|||||||-----%%%%%%%%%%%--------------#--#------------#--#----------r----------------------------------------------------------------------------------------------------
%%%%%%%%%%%%%%||||||||||||||----|||||||---%%|||||||||||-------------##--##--%%%%%---##--##---------%%%%----------%%%%%---%%%%%-----%%%---%%%------------------------------------------------------------
||||||||||||||||||||||||||||--k-||||k||---|||||||||||||-----------%%%%--%%%%|||||--###--###--------||||-------g--|||||---|||||-----|||---|||%%%%%%%%F%%%%%%%%%%%%%%%%%%%%%%%%%%%%%%%%%%%%%%%%%%%%%%%%%%%
||||||||||||||||||||||||||||XXXXXXXXXXXXXX|||||||||||||XXXX---XXXX||||--|||||||||XXXXX--XXXXXXXXXXXXXXXXXXXXXXXXX|||||---|||||XXXXX|||---|||||||||||X|||||||||||||||||||||||||||||||||||||||||||||||||||
