--------------------------------------------------------------------------------------------------------------------------------------------------------------------------------------------------------
--------------------------------------------------------------------------------------------------------------------------------------------------------------------------------------------------------
--------------------------------------------------------------------------------------------------------------------------------------------------------------------------------------------------------
--------------------------------------------------------------------------------------------------------------------------------------------------------------------------------------------------------
--------------------------------------------------------------------------------------------------------------------------------------------------------------------------------------------------------
--------------------------------------------------------------------------------------------------------------------------------------------------------------------------------------------------------
--------------------------------------------------------------------------------------------------------------------------------------------------------------------------------------------------------
--------------------------------------------------------------------------------------------------------------------------------------------------------------------------------------------------------
------------BBBC-----------------------------------------------------------------------------------------------------------------------------y----------------------------------------------------------
-------------------------------------------------------------------------------------------------------------------------------------------%%%----------------------------------------------------------
----------------X--------------------------%%%---------------------------------------------------------------------------------------------|||----------------------------------------------------------
---------------y--k------------------------|||--------------------------------------------------------------------------------------%%%%---|||----------------------------------------------------------
%%%%%%%%%%%%%%%%%%%%---%%%%%-----------k--y|||-------------------------------------------%%%%%---%%%%%------------------------------||||---|||------%%%%%%%%F%%%%%%%%%%%%%%%%%%%%%%%%%%%%%%%%%%%%%%%%%%%
||||||||||||||||||||---|||g|--%%%%%%%%%%%%%%%%%%%%%%%---%%%-----------------%%---%%------|||||---|||||-----------%%--%%-------------||||---|||------||||||||X|||||||||||||||||||||||||||||||||||||||||||
||||||||||||||||||||%%%%%%%%%%|||||||||||||||||||||||---|||-----------%%%%%%||---||%%--%%|||||---|||||%%%%---%%%%||--||%%%%%--%%%%%-|G||---|||----y-||||||||X|||||||||||||||||||||||||||||||||||||||||||
|||||||||||||||||||||||||||||||||||||||||||||||||||||---|||%%%%---%%%%||||||||---||||--|||||||---|||||||||---||||||--|||||||--|||||%%%%%%%%%%%%%%%%%||||||||X|||||||||||||||||||||||||||||||||||||||||||
