--------------------------------------------------------------------------------------------------------------------------------------------------------------------------------------------------------
--------------------------------------------------------------------------------------------------------------------------------------------------------------------------------------------------------
--------------------------------------------------------------------------------------------------------------------------------------------------------------------------------------------------------
--------------------------------------------------------------------------------------------------------------------------------------------------------------------------------------------------------
--------------------------------------------------------------------------------------------------------------------------------------------------------------------------------------------------------
--------------------------------------------------------------------------------------------------------------------------------------------------------------------------------------------------------
--------------------------------------------------------------------------------------------------------------------------------------------------------------------------------------------------------
--------------------------------------------------------------------------------------------------------------------------------------------------------------------------------------------------------
----------------------------%%%-------------------------------------------------------------------------------------------------------------------------------------------------------------------------
----------------------------|||-------------------------------------------------------------------------------------------------------------------------------------------------------------------------
----------------------------|||------------SCS-------------tt----------#--#-------------CUCC------------------------------------------------%%%---------------------------------------------------------
----------------------------rY|----------------------------tt---tt----##--##----------------------------------------------------------------|||---------------------------------------------------------
----------------%%%%%%%%%%%%%%%%%------k--%----------------tt---tt--%%%%--%%%%%%--%%--------%-----#--#------------------------%%--%%--------|||---r-%%%%%%%%F%%%%%%%%%%%%%%%%%%%%%%%%%%%%%%%%%%%%%%%%%%%
----------%%--%%|||||||||||||||||%%%%%%%%-|---Y-%%%--%%%%%%%%%%%%%%%||||--||||||--||---k--k-|----##--##-----------------------||--||%%%%%%%%%%%%%%%%||||||||%|||||||||||||||||||||||||||||||||||||||||||
----------||--|||||||||||||||||||||||||||%%%%%%%|||--|||||||||||||||||||--||||||--||%%%%%%%%%%--###--###----------------------||--||||||||||||||||||||||||||||||||||||||||||||||||||||||||||||||||||||||
XXXXXXXXXX||--|||||||||||||||||||||||||||||||||||||--|||||||||||||||||||--||||||--||||||||||||XXXXX--XXXXXXXXXX---XXXXXXX---XX||--||||||||||||||||||||||||||||||||||||||||||||||||||||||||||||||||||||||
