--------------------------------------------------------------------------------------------------------------------------------------------------------------------------------------------------------
--------------------------------------------------------------------------------------------------------------------------------------------------------------------------------------------------------
--------------------------------------------------------------------------------------------------------------------------------------------------------------------------------------------------------
--------------------------------------------------------------------------------------------------------------------------------------------------------------------------------------------------------
--------------------------------------------------------------------------------------------------------------------------------------------------------------------------------------------------------
----------------------------------------------------------------------------------------------------------------CSSS------------------------------------------------------------------------------------
--------------------------------------------------------------------------------------------------------------------------------------------------------------------------------------------------------
--------------------------------------------------------------------------------------------------------------------------------------------------------------------------------------------------------
--------------------------------------------------------------------------------------------------------------gr----------------------------------------------------------------------------------------
-----------------------------------------------------------------------------------------#--#-----------------%%%%%%------------------------------------------------------------------------------------
-----------------#--#-------------------------------------------------------------------##--##----------------||||||------------------------------------------------------------------------------------
----------------##--##--------------tt-------------------------------------------------###--###---------------||||||------------------------------------------------------------------------------------
--------------%%%%--%%%%------------tt-----------------------------------------------%%%%%--%%%%%-----------k-||||||k-----------%%--%%------------------------------------------------------------------
--------------||||--||||---------%%%%%%%%%%-------%%%%%%%--%%%%%%--%%--------------k-|||||--|||||---------%%%%%%%%%%%%----------||--||------------------------------------------------------------------
--------------||||--||||---------||||||||||-------|||||||--||||||--||%%%%--%%%%%%%%%%|||||--|||||--#---#--||||||||||||----------||--||------------------------------------------------------------------
XXXXXXXXXXXXXX||||--||||XXX---XXX||||||||||XX---XX|||||||--||||||--||||||--|||||||||||||||--|||||XXX---XXX||||||||||||XXXX--XXXX||--||XX--XXXXXXXXXXFXXXXXXXXXXXXXXXXXXXXXXXXXXXXXXXXXXXXXXXXXXXXXXXXXXX
