--------------------------------------------------------------------------------------------------------------------------------------------------------------------------------------------------------
--------------------------------------------------------------------------------------------------------------------------------------------------------------------------------------------------------
--------------------------------------------------------------------------------------------------------------------------------------------------------------------------------------------------------
--------------------------------------------------------------------------------------------------------------------------------------------------------------------------------------------------------
--------------------------------------------------------------------------------------------------------------------------------------------------------------------------------------------------------
--------------------------------------------------------------------------------------------------------------------------------------------------------------------------------------------------------
--------------------------------------------------------------------------------------------------------------------------------------------------------------------------------------------------------
--------------------------------------------------------------------------------------------------------------------------------------------------------------------------------------------------------
--------------------------------------------------------------------------------------------------------------------------------------------------------------------------------------------------------
--------------------------------------------------------------------------------------------------------------------------------------------------------------------------------------------------------
-------------------------------------------------------------------------------------------------------------------------------#--#---------------------------------------------------------------------
------------------------------------------------------------------------------------------------------------------tt----------##--##--------------------------------------------------------------------
------------------------%%%-------%%%%%---%%%%%%%%---%%%--------%%%%--%%%%---------------------------------%%%%---tt-%%---%%%%%%--%%%%------------------------------------------------------------------
%%%%%%%%%%%-------------|||%%---%%|||||---||||||||---|||--------||||--||||-----------%%%--%%%--------------||||---tt-||---||||||--||||------------------------------------------------------------------
|||||||||||------#---#--|||||---|||||||---||||||||---|||--------||||--||||%%%%---%%%%|||--|||-------%%---%%||||%%%%%%||---||||||--||||------------------------------------------------------------------
|||||||||||XXXXXXX---XXX|||||---|||||||---||||||||---|||XXX--XXX||||--||||||||---|||||||--|||XX---XX||---||||||||||||||---||||||--||||XX---XXXXXXXXXXFXXXXXXXXXXXXXXXXXXXXXXXXXXXXXXXXXXXXXXXXXXXXXXXXXX
