--------------------------------------------------------------------------------------------------------------------------------------------------------------------------------------------------------
--------------------------------------------------------------------------------------------------------------------------------------------------------------------------------------------------------
--------------------------------------------------------------------------------------------------------------------------------------------------------------------------------------------------------
--------------------------------------------------------------------------------------------------------------------------------------------------------------------------------------------------------
--------------------------------------------------------------------------------------------------------------------------------------------------------------------------------------------------------
--------------------------------------------------------------------------------------------------------------------------------------------------------------------------------------------------------
--------------------------------------------------------------------------------------------------------------------------------------------------------------------------------------------------------
--------------------------------------------------------------------------------------------------------------------------------------------------------------------------------------------------------
----------------------BCB--------------------------------------------y----------------------------------------------------------------------------------------------------------------------------------
---------------------------------------------------------------------%%%%%%------------------------------------------------------------%%%%-------------------------------------------------------------
---------------------------------------------------------------------||||||--------------------------------------%%%%%----BU2BB--------||||-------------------------------------------------------------
---------------------------------------------------------------------||r|||--r-----------------------------------|||||-----------------||||-------------------------------------------------------------
-------------%%%--%%%%%%%%%---------------------------------------%%%%%%%%%%%%%%%--------------------------------|||||-------------%%%%%%%%%%%%%%%%%%F%%%%%%%%%%%%%%%%%%%%%%%%%%%%%%%%%%%%%%%%%%%%%%%%%%
%%%%%%%%%%%%%|||--|||||||||---g---------------------------%%%--%%%|||||||||||||||------------------------------kk|g|||----------g--||||||||||||||||||X||||||||||||||||||||||||||||||||||||||||||||||||||
||||||||||||||||--|||||||||%%%%%%-------------------------|||--||||||||||||||||||-----------------y----------%%%%%%%%%%%%%%%%%%%%%%||||||||||||||||||X||||||||||||||||||||||||||||||||||||||||||||||||||
||||||||||||||||--|||||||||||||||%%%%%%%%%%%%--%%%%%%---%%|||--||||||||||||||||||%%%%%--%%%%%%%%%%%%%%%---%%%||||||||||||||||||||||||||||||||||||||||X||||||||||||||||||||||||||||||||||||||||||||||||||
