--------------------------------------------------------------------------------------------------------------------------------------------------------------------------------------------------------
--------------------------------------------------------------------------------------------------------------------------------------------------------------------------------------------------------
---------------------%%%--------------------------------------------------------------------------------------------------------------------------------------------------------------------------------
---------------------|||--------------------------------------------------------------------------------------------------------------------------------------------------------------------------------
------------------k--|||--------------------------------------------------------------------------------------------------------------------------------------------------------------------------------
-----------------%%%%%||--------------------------------------------------------------------------------------------------------------------------------------------------------------------------------
-----------------|||||||--------------------------------------------------------------------------------------------------------------------------------------------------------------------------------
-----------------|||||||--------------------------------------------------------------------------------------------------------------------------------------------------------------------------------
-------------%%%%%||||||--------------------------------------------------------------------------------------------------------------------------------------------------------------------------------
-------------|||||||||||--------------------------------------------------------------------------------------------------------------------------------------------------------------------------------
-------------|||||||||||----------------------------------------------------------------------------------------------------------G---------------------------------------------------------------------
-------------|y|||||||y|y------------------------------------------------------------------------------------------------------%%%%---------------------------------------------------------------------
----------%%%%%%%%%%%%%%%%%%---#--#--------------------------%%%%-------------------------------------------------#--#--------k|||k----k----------------------------------------------------------------
----------||||||||||||||||||--##--##--%%%%---%%%%%%%%%--%%%%%||||%%---%%%%%---%%%-----------%%%--%%%%%%%%--%%%%%%%%--%%%%%%%%%%%%%%%%%%%%%%%%%%%%%F%%%%%%%%%%%%%%%%%%%%%%%%%%%%%%%%%%%%%%%%%%%%%%%%%%%%%
----------||||||||||||||||||%%%%--%%%%||||---|||||||||--|||||||||||---|||||---|||-----------|||--||||||||--||||||||--|||||||||||||||||||||||||||||%|||||||||||||||||||||||||||||||||||||||||||||||||||||
XXXXXXXXXX||||||||||||||||||||||--||||||||---|||||||||--|||||||||||---|||||---|||XXXX---XXXX|||--||||||||--||||||||--|||||||||||||||||||||||||||||||||||||||||||||||||||||||||||||||||||||||||||||||||||
