--------------------------------------------------------------------------------------------------------------------------------------------------------------------------------------------------------
--------------------------------------------------------------------------------------------------------------------------------------------------------------------------------------------------------
--------------------------------------------------------------------------------------------------------------------------------------------------------------------------------------------------------
--------------------------------------------------------------------------------------------------------------------------------------------------------------------------------------------------------
--------------------------------------------------------------------------------------------------------------------------------------------------------------------------------------------------------
--------------------------------------------------------------------------------------------------------------------------------------------------------------------------------------------------------
--------------------------------------------------------------------------------------------------------------------------------------------------------------------------------------------------------
--------------------------------------------------------------------------------------------------------------------------------------------------------------------------------------------------------
------------------------------------------------------------------------------------------UCC-----------------------------------------------------------------------------------------------------------
--------------------------------------------------------------------------------------------------------------------------------------------------------------------------------------------------------
---------------------------------BBBCCCB------------tt-tt-----------------------------------------BUBBCB------------------------------------------------------------------------------------------------
----------------------------------------------------tt-tt---------------------------------y-ky----------------------------------------------------------------------------------------------------------
-------------------%%%%---%%%%--------------#--#----tt-tt-------------------------------%%%%%%%%---------------%%%%%---%%%%%----------------------------------------------------------------------------
%%%%%%%%%%%--------||||---||||-----r-------##--##--%%%%%%%%%%%%---%%%%%%%%%---%%%%%-----||||||||-y-------------|||||---|||||-------------%%%%%%%%F%%%%%%%%%%%%%%%%%%%%%%%%%%%%%%%%%%%%%%%%%%%%%%%%%%%%%%
|||||||||||%%%%%%%%||||---||||%%%%%%%%%%%%%%%--%%%%||||||||||||---|||||||||---|||||-----||||||||%%%%%%%%%------|||||---|||||%%%%%---%%%%%||||||||X||||||||||||||||||||||||||||||||||||||||||||||||||||||
|||||||||||||||||||||||---|||||||||||||||||||--||||||||||||||||---|||||||||---|||||%%%%%|||||||||||||||||%%--%%|||||---||||||||||---|||||||||||||X||||||||||||||||||||||||||||||||||||||||||||||||||||||
