--------------------------------------------------------------------------------------------------------------------------------------------------------------------------------------------------------
--------------------------------------------------------------------------------------------------------------------------------------------------------------------------------------------------------
--------------------------------------------------------------------------------------------------------------------------------------------------------------------------------------------------------
--------------------------------------------------------------------------------------------------------------------------------------------------------------------------------------------------------
--------------------------------------------------------------------------------------------------------------------------------------------------------------------------------------------------------
--------------------------------------------------------------------------------------------------------------------------------------------------------------------------------------------------------
--------------------------------------------------------------------------------------------------------------------------------------------------------------------------------------------------------
------------------------------------------------------------------------------------------2BBBBB--------------------------------------------------------------------------------------------------------
--------------------------------------------------------------------------------------------------------------------------------------------------------------------------------------------------------
--------------------------------------------------------------------------------------------------------------------------------------------------------------------------------------------------------
------------------------------------------------------------------------------------------g-g-k---------------------------------------------------------------------------------------------------------
------------------------------tt----------------------------------------------------------%%%%%%---------------------------B222-------------------------------------------------------------------------
--------------------------tt--tt-----%%%%---%%%%----------------------------------%%---%%-||||||-----------#--#---%%--%%--------------------------------------------------------------------------------
%%%%%%%%%%----------------tt--tt-----||||---||||%%%%---%%%%------%%%%-------------||---||-||||||----------##--##--||--||-----------------%%%%%%%%F%%%%%%%%%%%%%%%%%%%%%%%%%%%%%%%%%%%%%%%%%%%%%%%%%%%%%%
||||||||||%%%%%---%%%%%%%%%%%%%%%%%%%||||---||||||||---||||%%--%%||||%%%%%---%%%%%||---||%%%%%%%%%%%%%%%%%%%--%%%%||--||-r---------------||||||||X||||||||||||||||||||||||||||||||||||||||||||||||||||||
|||||||||||||||---|||||||||||||||||||||||---||||||||---||||||--|||||||||||---|||||||---|||||||||||||||||||||--||||||--||%%%%%%%%%%%%%--%%||||||||X||||||||||||||||||||||||||||||||||||||||||||||||||||||
