--------------------------------------------------------------------------------------------------------------------------------------------------------------------------------------------------------
--------------------------------------------------------------------------------------------------------------------------------------------------------------------------------------------------------
--------------------------------------------------------------------------------------------------------------------------------------------------------------------------------------------------------
--------------------------------------------------------------------------------------------------------------------------------------------------------------------------------------------------------
--------------------------------------------------------------------------------------------------------------------------------------------------------------------------------------------------------
--------------------------------------------------------------------------------------------------------------------------------------------------------------------------------------------------------
--------------------------------------------------------------------------------------------------------------------------------------------------------------------------------------------------------
--------------------------------------------------------------------------------------------------------------------------------------------------------------------------------------------------------
------------------------------------------%%%%%--------------------------------------------------------------------------------S-2S---------------------------------------------------------------------
-----------------------------SC2CSS-------|||||---------------------------------------------------------------------------------------------------------------------------------------------------------
--------------S-C-------------------------|||||---------------------------------------------------------------------------------%-----------------------------------------------------------------------
-----------------------------------------y|||||---------------S2SCS----------------#---#--------------------#---#---------------|y----------------------------------------------------------------------
---------------%--------------Y--------%%%%%%%%%%%--------------------------------##---##----------tt------##---##-----------%%%%%%%--------------------------------------------------------------------
---------------|-----%%---%%%%%%%%%%%%%|||||||||||---#--#-----------------------%%%%---%%%%--------tt----%%%%---%%%%---------|||||||%%%%---%%%%%%%%%%%%F%%%%%%%%%%%%%%%%%%%%%%%%%%%%%%%%%%%%%%%%%%%%%%%%
%%%%%%%%%%%%%%%%%%%%%||---||||||||||||||||||||||||--##--##----------%%%%%--%%%%%||||---||||%%--%%%%%%%%%%||||---||||---------|||||||||||---||||||||||||%||||||||||||||||||||||||||||||||||||||||||||||||
|||||||||||||||||||||||---||||||||||||||||||||||||XXXX--XXXXXXXXXXXX|||||--|||||||||---||||||--||||||||||||||---||||XXX---XXX|||||||||||---|||||||||||||||||||||||||||||||||||||||||||||||||||||||||||||
