--------------------------------------------------------------------------------------------------------------------------------------------------------------------------------------------------------
--------------------------------------------------------------------------------------------------------------------------------------------------------------------------------------------------------
--------------------------------------------------------------------------------------------------------------------------------------------------------------------------------------------------------
--------------------------------------------------------------------------------------------------------------------------------------------------------------------------------------------------------
--------------------------------------------------------------------------------------------------------------------------------------------------------------------------------------------------------
--------------------------------------------------------------------------------------------------------------------------------------------------------------------------------------------------------
--------------------------------------------------------------------------------------------------------------------------------------------------------------------------------------------------------
--------------------------------------------------------------------------------------------------------------------------------------------------------------------------------------------------------
---------------------------------------------------------------------------------------------------------------CC-S--------------------%%%--------------------------------------------------------------
---------------------------------------------------------------------------------------------------------------------------------------|||--------------------------------------------------------------
-----------------------------------------------------------------------------------------------------------------%----------------%%%%%%||--------------------------------------------------------------
---------------------------------------------------------------SSSSSC----------------------------------K---------|----------------||||||||--------------------------------------------------------------
%%%%%%%%%%%%%---%%%%---%%%%----------------%%%--%%%---#---#-------------------------%%%%%%%---%%%%%---%%%%---%%%%%%%%----Tt-tt----|||g||||--r--%%%%%%%%F%%%%%%%%%%%%%%%%%%%%%%%%%%%%%%%%%%%%%%%%%%%%%%%%
|||||||||||||---||||---||||--#--#-----tt---|||--|||--##---##---------|--------------|||||||---|||||---||g|-r-||||||||----tt-tt---%%%%%%%%%%%%%%||||||||%||||||||||||||||||||||||||||||||||||||||||||||||
|||||||||||||---||||---||||%%%--%%%---tt---|||--|||%%%%---%%%%--y----r---%%%%---%%%%|||||||---|||||%%%%%%%%%%||||||||----tt-tt---|||||||||||||||||||||||||||||||||||||||||||||||||||||||||||||||||||||||
|||||||||||||XXX||||---|||||||--|||XXXXXXXX|||--|||||||---||||XXXXXXXXXXX||||---|||||||||||---|||||||||||||||||||||||XXXXXXXXXXXX|||||||||||||||||||||||||||||||||||||||||||||||||||||||||||||||||||||||
