--------------------------------------------------------------------------------------------------------------------------------------------------------------------------------------------------------
--------------------------------------------------------------------------------------------------------------------------------------------------------------------------------------------------------
--------------------------------------------------------------------------------------------------------------------------------------------------------------------------------------------------------
--------------------------------------------------------------------------------------------------------------------------------------------------------------------------------------------------------
--------------------------------------------------------------------------------------------------------------------------------------------------------------------------------------------------------
--------------------------------------------------------------------------------------------------------------------------------------------------------------------------------------------------------
--------------------------------------------------------------------------------------------------------------------------------------------------------------------------------------------------------
--------------------------------------------------------------------------------------------------------------------------------------------------------------------------------------------------------
--------------------------------------------------CCSS--------------------------------------------------------------------------------------------------------------------------------------------------
------------------------------------------------------------------------------------------------------------------SCSS----------------------------------------------------------------------------------
--------------#---#---------------------------------------------------------------S22C------------------------------------------------------------------------------------------------------------------
-------------##---##-----------------------------k--------------------------------------------------------------------------------#---#-----------------------------------------------------------------
------------###---###---------------------------%%%%%%%%%%%%--%%%%---------------------------------------------------yy---------%%%---%%%---------------------------------------------------------------
%%%%%%%%%%%%%%%---%%%%%---------------%%%%--%%%%||||||||||||--||||---------------r--------%%--%%------%%%%--%%%%%%%%%%%%%%------|||---|||%%%%%%%%F%%%%%%%%%%%%%%%%%%%%%%%%%%%%%%%%%%%%%%%%%%%%%%%%%%%%%%
|||||||||||||||---|||||%%%---%%%------||||--||||||||||||||||--||||-------------%%%%%%%%%%%||--||%%--%%||||--||||||||||||||------|||---|||||||||||%||||||||||||||||||||||||||||||||||||||||||||||||||||||
|||||||||||||||---||||||||---|||XXXXXX||||--||||||||||||||||--||||XXXXX---XXXXX|||||||||||||--||||--||||||--||||||||||||||XX--XX|||---||||||||||||||||||||||||||||||||||||||||||||||||||||||||||||||||||
