--------------------------------------------------------------------------------------------------------------------------------------------------------------------------------------------------------
--------------------------------------------------------------------------------------------------------------------------------------------------------------------------------------------------------
--------------------------------------------------------------------------------------------------------------------------------------------------------------------------------------------------------
--------------------------------------------------------------------------------------------------------------------------------------------------------------------------------------------------------
------------------------------------------------------------y-------------------------------------------------------------------------------------------------------------------------------------------
------------------------------------------------------------%%%%----------------------------------------------------------------------------------------------------------------------------------------
------------------------------------------------------------||||----------------------------------------------------------------------------------------------------------------------------------------
------------------------------------------------------------||||----------------------------------------------------------------------------------------------------------------------------------------
------------------------------------------------------------||r|---------------------------------------------------------------SSSUSS-------------------------------------------------------------------
---------------------------------------------------------%%%%%%|------#---#-----------------------------------------------------------------------------------------------------------------------------
---------------------------#--#--------------------------|||||||-----##---##-------------------------------------------------------------g-k------------------------------------------------------------
--------------------------##--##-------------------------|||||||----###---###------#--#------CSS--------------r----------------g--------%%%%%-----------------------------------------------------------
%%%%%%%%%%%%%%%%%--%%%%%%%%%--%%%%%%%---%%%-------%%--%%-|||||||--%%%%%---%%%%%---##--##---------------------%%%%%%%%-------%%%%%%%%%%--|||||-----------------------------------------------------------
|||||||||||||||||--|||||||||--|||||||---|||-------||--||%%%%%%%%%%|||||---|||||--###--###--------------------||||||||-------||||||||||--|||yg-----------------------------------------------------------
|||||||||||||||||--|||||||||--|||||||---|||-------||--|||||||||||||||||---|||||%%%%%--%%%%%-----y-%%%%---%%%%||||||||-------||||||||||%%%%%%%%%%%%%%%%%%F%%%%%%%%%%%%%%%%%%%%%%%%%%%%%%%%%%%%%%%%%%%%%%%
|||||||||||||||||--|||||||||--|||||||---|||XX---XX||--|||||||||||||||||---||||||||||--|||||XXXXXXX||||---||||||||||||XX---XX||||||||||||||||||||||||||||X|||||||||||||||||||||||||||||||||||||||||||||||
