--------------------------------------------------------------------------------------------------------------------------------------------------------------------------------------------------------
--------------------------------------------------------------------------------------------------------------------------------------------------------------------------------------------------------
--------------------------------------------------------------------------------------------------------------------------------------------------------------------------------------------------------
--------------------------------------------------------------------------------------------------------------------------------------------------------------------------------------------------------
--------------------------------------------------------------------------------------------------------------------------------------------------------------------------------------------------------
--------------------------------------------------------------------------------------------------------------------------------------------------------------------------------------------------------
--------------------------------------------------------------------------------------------------------------------------------------------------------------------------------------------------------
--------------------------------------------------------------------------------------------------------------------------------------------------------------------------------------------------------
--------------------------------------------------------------------------------------------------------------y-----------------------------------------------------------------------------------------
------------------------------------------------------------------------------------------------------------%%%%%---------------------------------------------------------------------------------------
-------------------------------------------#--#-------------------------------------------------------------|||||---------------------------------------------------------------------------------------
---------------------------------#---#----##--##-----------------CC2S---------------------------------------|||||---------------------------------------------------------------------------------------
-------------------------------%%%---%%%%%%%--%%%%--------------------%%%%%--%%%%%-------------%%%%%%%------g||||g-k--K---------------------------------------------------------------------------------
%%%%%%%%%%%%%%----------Tt-tt--|||---|||||||--||||--------------------|||||--|||||%%%%%---%%%%%|||||||---%%%%%%%%%%%%%%%%---#--#------------------------------------------------------------------------
||||||||||||||----------tt-tt--|||---|||||||--||||--------------K-----|||||--||||||||||---||||||||||||%%%||||||||||||||||--##--##--%%%%%%%%%%%%%%%%F%%%%%%%%%%%%%%%%%%%%%%%%%%%%%%%%%%%%%%%%%%%%%%%%%%%%
||||||||||||||XX--XXXXXXXXXXXXX|||---|||||||--||||XXXXX---XXXXXXXXXXXX|||||--||||||||||---|||||||||||||||||||||||||||||||XXXX--XXXX||||||||||||||||X||||||||||||||||||||||||||||||||||||||||||||||||||||
