--------------------------------------------------------------------------------------------------------------------------------------------------------------------------------------------------------
--------------------------------------------------------------------------------------------------------------------------------------------------------------------------------------------------------
--------------------------------------------------------------------------------------------------------------------------------------------------------------------------------------------------------
--------------------------------------------------------------------------------------------------------------------------------------------------------------------------------------------------------
--------------------------------------------%%%%%%------------------------------------------------------------------------------------------------------------------------------------------------------
--------------------------------------------||||||------------------------------------------------------------------------------------------------------------------------------------------------------
--------------------------------------------||||||------------------------------------------------------------------------------------------------------------------------------------------------------
--------------------------------------------||||||------------------------------------------------------------------------------------------------------------------------------------------------------
--------------------------------------------||%%%|------------------------------------------------------------------------------------------------------------------------------------------------------
--------------------------------------------||||||------------------------------------------------------------------------------------------------------------------------------------------------------
--------------------------------------------|||%%%%%----------------------------------------------------------------------------------------------------------------------------------------------------
--------------------------------------------||||||||----------------------------------S2S-SSU-----------------------------------------------------------------------------------------------------------
-------------%%%---%%%%%%%%---%%%%%-----g---||||||||--%%%%--%%%%----------tt----tt-------------------------------%%%%---%%%%----------------------------------------------------------------------------
-------------|||---||||||||---|||||-%%%%%---||||||||--||||--||||--#---#---tt----tt-------%-----------------------||||---||||----------------%%%%%%%%F%%%%%%%%%%%%%%%%%%%%%%%%%%%%%%%%%%%%%%%%%%%%%%%%%%%
%%%%%%%%%%%%%|||---||||||||---|||||-|||||-r-|y||K|||--||||--||||%%%---%%%-tt----tt-------|-----------------------||||---||||----------------||||||||%|||||||||||||||||||||||||||||||||||||||||||||||||||
||||||||||||||||---||||||||---|||||XXXXXXXXXXXXXXXXXXX||||--|||||||---|||XXXXXXXXXXXXXXXXXXXXXXXXXX---XXXXXX---XX||||---||||XXXXXXXXXXXXXXXX||||||||||||||||||||||||||||||||||||||||||||||||||||||||||||
