--------------------------------------------------------------------------------------------------------------------------------------------------------------------------------------------------------
--------------------------------------------------------------------------------------------------------------------------------------------------------------------------------------------------------
--------------------------------------------------------------------------------------------------------------------------------------------------------------------------------------------------------
--------------------------------------------------------------------------------------------------------------------------------------------------------------------------------------------------------
--------------------------------------------------------------------------------------------------------------------------------------------------------------------------------------------------------
--------------------------------------------------------------------------------------------------------------------------------------------------------------------------------------------------------
--------------------------------------------------------------------------------------------------------------------------------------------------------------------------------------------------------
--------------------------------------------------------------------------------------------------------------------------------------------------------------------------------------------------------
--------------------------------------------------------------------------------------------------------------------------------------------------------------------------------------------------------
----------------------------------------------------------------------------------------------------------------------------#---#-----------------------------------------------------------------------
-----------------------------SSC2------------------------Tt----------------------------------------------------------------##---##----------------------------------------------------------------------
------------------------------------------------------tt-tt---------------------------------------------------------------###---###---------------------------------------------------------------------
----------------------------%-------------%%%%--%%%%--tt-tt-------------------------------------------#---#-------------%%%%%---%%%%%-------------------------------------------------------------------
----------------#--#--------|-------------||||--||||%%%%%%%%%%%%%%%%---%%%%-----%%%---------#--#-----##---##------------|||||---|||||-------------%%%%%%%%F%%%%%%%%%%%%%%%%%%%%%%%%%%%%%%%%%%%%%%%%%%%%%
--------------%%%--%%%-----%%%%%%%%%%--%%%||||--||||||||||||||||||||---||||-----|||%%%%%%--##--##--%%%%---%%%%-----%%%%%|||||---|||||%%%%%---%%%%%||||||||%|||||||||||||||||||||||||||||||||||||||||||||
XXXXXXXXXXXXXX|||--|||XXXXX||||||||||--|||||||--||||||||||||||||||||---||||XXXXX|||||||||XXXX--XXXX||||---||||XXXXX||||||||||---||||||||||---|||||||||||||||||||||||||||||||||||||||||||||||||||||||||||
