--------------------------------------------------------------------------------------------------------------------------------------------------------------------------------------------------------
--------------------------------------------------------------------------------------------------------------------------------------------------------------------------------------------------------
--------------------------------------------------------------------------------------------------------------------------------------------------------------------------------------------------------
--------------------------------------------------------------------------------------------------------------------------------------------------------------------------------------------------------
--------------------------------------------------------------------------------------------------------------------------------------------------------------------------------------------------------
---------------------------------------------------------------------------------------------------------------%%%--------------------------------------------------------------------------------------
---------------------------------------------------------------------------------------------------------------|||--------------------------------------------------------------------------------------
---------------------------------------------------------------------------------------------------------------|||--------------------------------------------------------------------------------------
---------------------------------------------------------------------------------------------------------------|||--------------------------------------------------------------------------------------
--------------------------------tt-tt------------------------------------------------------------------------%%%%|--------------------------------------------------------------------------------------
--------------------------------tt-tt--------------------------------------------------#---#-----------------|||||--------------------------------------------------------------------------------------
--------------------------------tt-tt-------#--#--------------------------------------##---##----------------|||||-----------------#---#----------------------------------------------------------------
---------------------#--#----%%%%%%%%%%%---##--##---%%%%---%%%%%%%%%---%%%%%--#--#--%%%%---%%%%--------------|||||------%%%%%-----##---##---------------------------------------------------------------
%%%%%%%%%%%%%-------##--##---|||||||||||--###--###--||||---|||||||||---|||||%%%--%%%||||---||||%%%%%---%%%%%-|||||------|||||----###---###--------------------------------------------------------------
|||||||||||||------###--###--|||||||||||%%%%%--%%%%%||||---|||||||||---||||||||--|||||||---|||||||||---|||||-|||||-----r||k||--%%%%%---%%%%%------------------------------------------------------------
|||||||||||||XXXXXXXXX--XXXXX||||||||||||||||--|||||||||---|||||||||---||||||||--|||||||---|||||||||---|||||XXXXXXXXXXXXXXXXXXX|||||---|||||XXXXXXXXFXXXXXXXXXXXXXXXXXXXXXXXXXXXXXXXXXXXXXXXXXXXXXXXXXXX
