--------------------------------------------------------------------------------------------------------------------------------------------------------------------------------------------------------
--------------------------------------------------------------------------------------------------------------------------------------------------------------------------------------------------------
--------------------------------------------------------------------------------------------------------------------------------------------------------------------------------------------------------
--------------------------------------------------------------------------------------------------------------------------------------------------------------------------------------------------------
--------------------------------------------------------------------------------------------------------------------------------------------------------------------------------------------------------
---------------------------------------------------------------------------------------------------SCS--------------------------------------------------------------------------------------------------
--------------------------------------------------------------------------------------------------------------------------------------------------------------------------------------------------------
----------------y---------------------------------------------------------------------------------------------------------------------------------------------------------------------------------------
---------------%%%%---------------------------------------------------------------------------------g---------------------------------------------------------------------------------------------------
---------------||||--------------------------------------------------------------------------------%%%----------------------------tt-----UCS22S---------------------------------------------------------
---------------||%%%%%----------------------------SS2----------------------------------------------|||-------------------------tt-tt--------------------------------------------------------------------
---------------|||||||-------------------------------------------------------------------tt--tt----|||-------------------------tt-tt--------------------------------------------------------------------
---------------|||||||-----------%%%%%---%%%%%---%--------#---#------------%%%%%---%%%%%-tt--tt----||%%%%------------------%%%%%%%%%%%------------------------------------------------------------------
---------------|||||||y--------%%|||||---|||||---|-k-----##---##-----#--#--|||||---|||||-tt--tt----|g||||--gg--------------|||||||||||%%%%%%%%%%--------------------------------------------------------
%%%%%%%%%%%%%%%%%%%%%%%%%%%%%%%|||||||---|||||%%%%%%%%--###---###--%%%--%%%|||||---|||||%%%%%%%%%%%%%%%%%%%%%%%%-----------|||||||||||||||||||||--------------------------------------------------------
||||||||||||||||||||||||||||||||||||||---|||||||||||||XXXXX---XXXXX|||--||||||||---|||||||||||||||||||||||||||||XXXX---XXXX|||||||||||||||||||||XXXXXXXXFXXXXXXXXXXXXXXXXXXXXXXXXXXXXXXXXXXXXXXXXXXXXXXX
