--------------------------------------------------------------------------------------------------------------------------------------------------------------------------------------------------------
--------------------------------------------------------------------------------------------------------------------------------------------------------------------------------------------------------
--------------------------------------------------------------------------------------------------------------------------------------------------------------------------------------------------------
--------------------------------------------------------------------------------------------------------------------------------------------------------------------------------------------------------
--------------------------------------------------------------------------------------------------------------------------------------------------------------------------------------------------------
--------------------------------------------------------------------------------------------------------------------------------------------------------------------------------------------------------
--------------------------------------------------------------------------------------------------------------------------------------------------------------------------------------------------------
--------------------------------------------------------------------------------------------------------------------------------------------------------------------------------------------------------
--------------------------------------------------------------------------------------------------------------------------------------------------------------------------------------------------------
----------------------------------#--#------------------------------------------------------------------------------------------------------------------------------------------------------------------
---------------------------------##--##-----------------------------------------------------#---#-------------------------------------------------------------------------------------------------------
--------------------------------###--###---------------------------------------------------##---##------#---#----------------CSSCUS---------------------------------------------------------------------
-------------tt-tt------------%%%%%--%%%%%-------------#--#----------------------#--#----%%%%---%%%%---##---##-----#--#---------------------------------------------------------------------------------
-------------tt-tt--%%%%--%%%%|||||--|||||---#--#-----##--##--------------------##--##---||||---||||--###---###--%%%--%%%---------------------%%%%%%%%F%%%%%%%%%%%%%%%%%%%%%%%%%%%%%%%%%%%%%%%%%%%%%%%%%
-------------tt-tt--||||--|||||||||--|||||--##--##--%%%%--%%%%%%--%%%%%---%%%--###--###--||||---||||%%%%%---%%%%%|||--|||-----------%%%%--%%%%||||||||%|||||||||||||||||||||||||||||||||||||||||||||||||
XXXXXXXXXXXXXXXXXXXX||||--|||||||||--|||||XXXX--XXXX||||--||||||--|||||---|||XXXXX--XXXXX||||---|||||||||---||||||||--|||XXXXXXXXXXX||||--||||||||||||||||||||||||||||||||||||||||||||||||||||||||||||||
