--------------------------------------------------------------------------------------------------------------------------------------------------------------------------------------------------------
--------------------------------------------------------------------------------------------------------------------------------------------------------------------------------------------------------
--------------------------------------------------------------------------------------------------------------------------------------------------------------------------------------------------------
--------------------------------------------------------------------------------------------------------------------------------------------------------------------------------------------------------
--------------------------------------------------------------------------------------------------------------------------------------------------------------------------------------------------------
--------------------------------------------------------------------------------------------------------------------------------------------------------------------------------------------------------
--------------------------------------------------------------------------------------%%%---------------------------------------------------------------------------------------------------------------
--------------------------------------------------------------------------------------|||---------------------------------------------------------------------------------------------------------------
---------------------------%%%%%--------------------------------%%%%%%%---------------||g---------------------------------------------------------------------------------------------------------------
---------------------------|||r|--------------------------------|||||||-------------%%%%%%%-------------------------------------------------------------------------------------------------------------
---------------------------|||%%%%------------------------------|||||||-------------|||||||-------------------------------------------------------------------------------------------------------------
---------------------------|||||||-----#---#-----------------r--|||||||-r-----------|||||||-------------------------------------------------------------------------------------------------------------
-------------%%%%%%%%%%%---|||||k|g---##---##------------%%%%%%%%%%%%%%%%%----------||||||g--------------%%%%%--%%%%%-----------------------------------------------------------------------------------
-------------|||||||||||%%%%%%%%%%%%%%%%---%%%%---#--#---|||||||||||||||||%%%---%%%%%%%%%%%%%%%%---------|||||--|||||---------%%--%%---#--#-------------------------------------------------------------
-------------|||||||||||||||||||||||||||---||||--##--##--||||||||||||||||||||---||||||||||||||||%%--%%%%%|||||--|||||%%%---%%%||--||--##--##------------------------------------------------------------
%%%%%%%%%%%%%|||||||||||||||||||||||||||---||||%%%%--%%%%||||||||||||||||||||---||||||||||||||||||--||||||||||--||||||||---|||||--||%%%%--%%%%%%%%%%%%F%%%%%%%%%%%%%%%%%%%%%%%%%%%%%%%%%%%%%%%%%%%%%%%%%
