--------------------------------------------------------------------------------------------------------------------------------------------------------------------------------------------------------
--------------------------------------------------------------------------------------------------------------------------------------------------------------------------------------------------------
--------------------------------------------------------------------------------------------------------------------------------------------------------------------------------------------------------
--------------------------------------------------------------------------------------------------------------------------------------------------------------------------------------------------------
--------------------------------------------------------------------------------------------------------------------------------------------------------------------------------------------------------
--------------------------------------------------------------------------------------------------------------------------------------------------------------------------------------------------------
--------------------------------------------------------------------------------------------------------------------------------------------------------------------------------------------------------
--------------------------------------------------------------------------------------------------------------------------------------------------------------------------------------------------------
--------------------------------------------------------------------------------------------------------------------------------------------------------------------------------------------------------
--------------------------------------------------------------------------------------------------------------------------------------------------------------------------------------------------------
--------------------------------------------------------------------------------------BB2----#--#-------------------------------------------------------------------------------------------------------
--------------------------------------------------------------------------------------------##--##---------------------------------------BBC------------------------------------------------------------
------------%%%%%%------------------%%%%--%%%%-----------%%--%%----#--#----%%---%%--------%%%%--%%%%----------------------------------------------------------------------------------------------------
------------||||||---------%%%%%%%%%||||--||||-----------||--||---##--##---||---||----g---||||--||||-------------%%%%%--%%%%%---------------------------------------------------------------------------
%%%%%%%%%%%%%%%%%%%%%%%%%%%|||||||||||||--||||%%%%---%%%%||--||--###--###--||---||%%%%%%%%||||--||||-------------|||||--|||||-------------k-------------------------------------------------------------
||||||||||||||||||||||||||||||||||||||||--||||||||---||||||--||%%%%%--%%%%%||---||||||||||||||--||||%%%%%---%%%%%|||||--|||||%%%%--%%%%%%%%%%%%%%%%%%%%%F%%%%%%%%%%%%%%%%%%%%%%%%%%%%%%%%%%%%%%%%%%%%%%%
