--------------------------------------------------------------------------------------------------------------------------------------------------------------------------------------------------------
--------------------------------------------------------------------------------------------------------------------------------------------------------------------------------------------------------
--------------------------------------------------------------------------------------------------------------------------------------------------------------------------------------------------------
--------------------------------------------------------------------------------------------------------------------------------------------------------------------------------------------------------
--------------------------------------------------------------------------------------------------------------------------------------------------------------------------------------------------------
--------------------------------------------------------------------------------------------------------------------------------------------------------------------------------------------------------
--------------------------------------------------------------------------------------------------------------------------------------------------------------------------------------------------------
--------------------------------------------------------------------------------------------------------------------------------------------------------------------------------------------------------
------------------------------------------------------------------------------------------------------USSS----------------------------------------------------------------------------------------------
------------------------------------------------------------CSCS------------r---------------------------------------------------------------------------------------------------------------------------
---------------------------------------------------------------------------%%%--------------------------------------------------------------------------------------------------------------------------
--------------%%%----------------------------------------------------------|||----------------------r----ykg---------------------------#---#------------------------------------------------------------
--------------|||----------------------------%%%%%-------------------------|||--------%%%%%---%%%%%%%%%%%%%%%%-----------------------%%%---%%%----------------------------------------------------------
--------------||g-g--------------------------|||||--------%%%%%%%----------|||y-------|||||---||||||||||||||||-------------%%%%--%%%%|||---|||%%%%%%%%F%%%%%%%%%%%%%%%%%%%%%%%%%%%%%%%%%%%%%%%%%%%%%%%%%
-------------%%%%%%%%%%%%%%------------------|||||%%%--%%%|||||||--------%%%%%%%%%%%%%|||||---||||||||||||||||%%%%%---%%%%%||||--|||||||---|||||||||||%|||||||||||||||||||||||||||||||||||||||||||||||||
XXXXXXXXXXXXX||||||||||||||XXXXX--XXXXXXXXXXX||||||||--||||||||||XXX--XXX||||||||||||||||||---|||||||||||||||||||||---|||||||||--|||||||---|||||||||||||||||||||||||||||||||||||||||||||||||||||||||||||
