--------------------------------------------------------------------------------------------------------------------------------------------------------------------------------------------------------
--------------------------------------------------------------------------------------------------------------------------------------------------------------------------------------------------------
--------------------------------------------------------------------------------------------------------------------------------------------------------------------------------------------------------
--------------------------------------------------------------------------------------------------------------------------------------------------------------------------------------------------------
--------------------------------------------------------------------------------------------------------------------------------------------------------------------------------------------------------
--------------------------------------------------------------------------------------------------------------------------------------------------------------------------------------------------------
--------------------------------------------------------------------------------------------------------------------------------------------------------------------------------------------------------
--------------------------------------------------------------------------------------------------------------------------------------------------------------------------------------------------------
--------------------------------------------------------------------------------------------------------------------------------------------------------------------------------------------------------
--------------------------------------------SC2SSS2------------------------------SCCCC2---------------g--g--------------------------------k-------------------------------------------------------------
-----------------------------------------------------------------------------------------------------%%%%%%-------------------------------%%%%%---------------------------------------------------------
-----------------------------------------------------------------------------------------------------||||||-------------------------------|||||---------------------------------------------------------
--------------------------------------------Yr------------------------------------y------------------||||||-------------------------------|||||--%%%%---------------------------------------------------
-----------------#--#---------%%%%%--#--#--%%%%%%%%%-------------%%%--%%%-------%%%%%%%%%%%%---------y|||||K---%%%%---%%%%%%%%%--%%%%%----|||||--|||gy--------------------------------------------------
%%%%%%%%%%%%%%--##--##--%%--%%|||||%%%--%%%|||||||||%%%%%---%%%%%|||--|||%%---%%||||||||||||%%--%%%%%%%%%%%%%%%||||---|||||||||--|||||%%%%%%%%%%%%%%%%%%%-----------------------------------------------
||||||||||||||XXXX--XXXX||--||||||||||--|||||||||||||||||---||||||||--|||||---||||||||||||||||--|||||||||||||||||||---|||||||||--||||||||||||||||||||||||XXXXXXXXFXXXXXXXXXXXXXXXXXXXXXXXXXXXXXXXXXXXXXX
