--------------------------------------------------------------------------------------------------------------------------------------------------------------------------------------------------------
--------------------------------------------------------------------------------------------------------------------------------------------------------------------------------------------------------
--------------------------------------------------------------------------------------------------------------------------------------------------------------------------------------------------------
--------------------------------------------------------------------------------------------------------------------------------------------------------------------------------------------------------
--------------------------------------------------------------------------------------------------------------------------------------------------------------------------------------------------------
--------------------------------------------------------------------------------------------------------------------------------------------------------------------------------------------------------
--------------------------------------------------------------------------------------------------------------------------------------------------------------------------------------------------------
--------------------------------------------------------------------------------------------------------------------------------------------------------------------------------------------------------
--------------------------------Y------------------CCSSSS------SSS--------------------------------------------------------------------------------------------------------------------------------------
--------------------------------%%%%-------------------------------------------------------SSU2SU-------------------------------------------------------------------------------------------------------
--------------------------------||||--------------------------%-----------------------------------------------------------------------------------------------------------------------------------------
--------------------------------||||--------------------------|-----------------------------------------------------------------------------------------------------------------------------------------
--------------------------%%%%%%%%%%%%%---------%%%%%%%%%%%%%%%%%%%%----------------------------k-----------%%%%---%%%%---------------------------------------------------------------------------------
--------------------------|||||||||||||--#---#--||||||||||||||||||||----------------------%%%%%%%%%---------||||---||||---------------------------------------------------------------------------------
%%%%%%%%%%%%%%%%%%---%%%%%|||||||||||||%%%---%%%||||||||||||||||||||----------------------|||||||||--#---#--||||---||||%%%%---%%%%%%%%%--%%%%%----------------------------------------------------------
||||||||||||||||||---|||||||||||||||||||||---|||||||||||||||||||||||XXXXX--XXXXXXXXX--XXXX|||||||||XXX---XXX||||---||||||||---|||||||||--|||||XXXXXXXXFXXXXXXXXXXXXXXXXXXXXXXXXXXXXXXXXXXXXXXXXXXXXXXXXX
