--------------------------------------------------------------------------------------------------------------------------------------------------------------------------------------------------------
--------------------------------------------------------------------------------------------------------------------------------------------------------------------------------------------------------
--------------------------------------------------------------------------------------------------------------------------------------------------------------------------------------------------------
--------------------------------------------------------------------------------------------------------------------------------------------------------------------------------------------------------
--------------------------------------------------------------------------------------------------------------------------------------------------------------------------------------------------------
--------------------------------------------------------------------------------------------------------------------------------------------------------------------------------------------------------
--------------------------------------------------------------------------------%%%---------------------------------------------------------------------------------------------------------------------
-----------------------------------------------------------------------------k--|||--------------UCC----------------------------------------------------------------------------------------------------
----------------------------------------------------------------------------%%%%%||---------------------------------------------------------------------------------------------------------------------
----------------------------------------------------------------------------|||||||---------------------------------------------------------------------------------------------------------------------
----------------------------------------------------------------------------|||||||---------------k--y--------------------------------------------------------------------------------------------------
------------------------------------%%%-------------------------------r-----|k|||||------------%%%%%%%-----------------------------------#--#-----------------------------------------------------------
----------%%%%%--%%%%%%%%%%---------|||--------%%%%--%%%%------------%%%%%%%%%%%%%%%%----------|||||||-----%%%---%%%--------------------##--##----------------------------------------------------------
%%%%%%%%%%|||||--||||||||||---------|||--------||||--||||%%%%%--%%%%%||||||||||||||||----------|||||||-----|||---|||------------------%%%%--%%%%--------------------------------------------------------
|||||||||||||||--||||||||||%%%%%%%%%%%%%%------||||--|||||||||--|||||||||||||||||||||%%%--%%%%%%%%%%%%%%%%%|||---|||%%%%%---%%%%%-----||||--||||--------------------------------------------------------
|||||||||||||||--||||||||||||||||||||||||XX--XX||||--|||||||||--||||||||||||||||||||||||--||||||||||||||||||||---||||||||---|||||XXXXX||||--||||XXXXXXXXFXXXXXXXXXXXXXXXXXXXXXXXXXXXXXXXXXXXXXXXXXXXXXXX
