--------------------------------------------------------------------------------------------------------------------------------------------------------------------------------------------------------
--------------------------------------------------------------------------------------------------------------------------------------------------------------------------------------------------------
--------------------------------------------------------------------------------------------------------------------------------------------------------------------------------------------------------
--------------------------------------------------------------------------------------------------------------------------------------------------------------------------------------------------------
----------------------------------------BBB-------------------------------------------------------------------------------------------------------------------------------------------------------------
--------------------------------------------------------------------------------------------------------------------------------------------------------------------------------------------------------
--------------------------------------------------------------------------------------------------------------------------------------------------------------------------------------------------------
--------------------------------------------------------------------------------------------------------------------------------------------------------------------------------------------------------
-------------------------------------%%%%%%----------U22C------------------------------------------------2BBB-B-----------------------------------------------------------------------------------------
------------------------------------k||||||-------------------------------------------------------------------------------------------------------------------------------------------------------------
-----------------------------------%%%|||||--------------X---------------------------------------------------X------------------------------------------------------------------------------------------
-----------------------------------||||||||---------r--------------------------------------------------------------------BBU----------------------------------------------------------------------------
%%%%%%%%%%--------%%--%%%%---%%----||||||||-------%%%%%%%%%%%--%%---------------Tt----------------------%%%%%%%%----------------------------------------------------------------------------------------
||||||||||--------||--||||---||%%%%%%%%%%%%%%%%%%%|||||||||||--||---------------tt----------------------||||||||---------------%%--%%-------%%%%%%%%F%%%%%%%%%%%%%%%%%%%%%%%%%%%%%%%%%%%%%%%%%%%%%%%%%%%
||||||||||--------||--||||---||||||||||||||||||||||||||||||||--||%%--%%%%---%%%%%%%%%%%-------%%%%--%%%%||||||||---------------||--||-------||||||||X|||||||||||||||||||||||||||||||||||||||||||||||||||
||||||||||%%%--%%%||--||||---||||||||||||||||||||||||||||||||--||||--||||---|||||||||||%%---%%||||--||||||||||||%%--%%%%%%%%%%%||--||%%%%%%%||||||||X|||||||||||||||||||||||||||||||||||||||||||||||||||
