--------------------------------------------------------------------------------------------------------------------------------------------------------------------------------------------------------
--------------------------------------------------------------------------------------------------------------------------------------------------------------------------------------------------------
--------------------------------------------------------------------------------------------------------------------------------------------------------------------------------------------------------
--------------------------------------------------------------------------------------------------------------------------------------------------------------------------------------------------------
--------------------------------------------------------------------------------------------------------------------------------------------------------------------------------------------------------
--------------------------------------------y-----------------------------------------------------------------------------------------------------------------------------------------------------------
----------------------------------------%%%%%%----------------------------------------------------------------------------------------------------------------------------------------------------------
----------------------------------------||||||----------------------------------------------------------------------------------------------------------------------------------------------------------
----------------------------------------||||||----------------------------------------------------------------------------------------------------------------------------------------------------------
---------------------------2BBC---------|||||r--------------------------------------------------------------------------------------y-------------------------------------------------------------------
----------------------------------------||%%%%%%%---------------------------------------------------------------------------------%%%%%-----------------------------------------------------------------
----------------#--#--------------------|||||||||---------------------------------------------------------------------------------|||||-----------------------------------------------------------------
---------------##--##-------------------|||||||||--------------------------------------------%%%---%%%----------------------------|||%%%%%--------------------------------------------------------------
-------------%%%%--%%%%%%%%%%%%%%---g---|||||||||-----#---#----------------------------------|||---|||----------------------------||||||||----%%%%%%%%F%%%%%%%%%%%%%%%%%%%%%%%%%%%%%%%%%%%%%%%%%%%%%%%%%
-------------||||--||||||||||||||%%%%%%%%%%%%%%%%%%%%%%---%%%----------%%---%%%%%--%%%%%---%%|||---|||-------#--#-----------------|yr||||y----||||||||X|||||||||||||||||||||||||||||||||||||||||||||||||
%%%%%%%%%%%%%||||--||||||||||||||||||||||||||||||||||||---|||%%%%--%%%%||---|||||--|||||---|||||---|||%%%%%%%%--%%%%%%%%%%%%%%%%%%%%%%%%%%%%%%||||||||X|||||||||||||||||||||||||||||||||||||||||||||||||
