--------------------------------------------------------------------------------------------------------------------------------------------------------------------------------------------------------
--------------------------------------------------------------------------------------------------------------------------------------------------------------------------------------------------------
--------------------------------------------------------------------------------------------------------------------------------------------------------------------------------------------------------
--------------------------------------------------------------------------------------------------------------------------------------------------------------------------------------------------------
--------------------------------------------------------------------------------------------------------------------------------------------------------------------------------------------------------
--------------------------------------------------------------------------------------------------------------------------------------------------------------------------------------------------------
--------------------------------------------------------------------------------------------------------------------------------------------------------------------------------------------------------
--------------------------------------------------------------------------------------------------------------------------------------------------------------------------------------------------------
--------------------------------------------------------------------------------------------------------------------------------------------------------------------------------------------------------
-------------------------------------------------------------------------------------------------------------------------------------------------r------------------------------------------------------
------------------------tt---------------------------------------------------------------------------------------------------------------------%%%%-----------------------------------------------------
------------------------tt---------------------------------------------------------------------------------------------------------------------||||-----------------------------------------------------
------------------------tt------%%--%%--%%%%----%%%%%--%%%%%---#--#----tt---tt----%%%%%--%%%%%--------%%---%%------------------------------y---||||r---%%%%%%%%F%%%%%%%%%%%%%%%%%%%%%%%%%%%%%%%%%%%%%%%%
-------------%%%---%%%%%%%%%%%%%||--||-k||||----|||||--|||||--##--##---tt---tt----|||||--|||||--------||---||--------------------------%%%%%%%%%%%%%%%%||||||||%||||||||||||||||||||||||||||||||||||||||
%%%%%%%%%%%%%|||---|||||||||||||||--||%%%%%%%%%%|||||--|||||%%%%--%%%%%%%%%%%%%%%%|||||--|||||--------||---||--------------------------|||||||||||||||||||||||||||||||||||||||||||||||||||||||||||||||||
||||||||||||||||---|||||||||||||||--|||||||||||||||||--|||||||||--|||||||||||||||||||||--|||||XXX--XXX||---||XX---XXXXXX--XXXXXXX---XXX|||||||||||||||||||||||||||||||||||||||||||||||||||||||||||||||||
