--------------------------------------------------------------------------------------------------------------------------------------------------------------------------------------------------------
--------------------------------------------------------------------------------------------------------------------------------------------------------------------------------------------------------
--------------------------------------------------------------------------------------------------------------------------------------------------------------------------------------------------------
--------------------------------------------------------------------------------------------------------------------------------------------------------------------------------------------------------
--------------------------------------------------------------------------------------------------------------------------------------------------------------------------------------------------------
----------------------------------------------------------------------------------------------------------------------------------G-g-------------------------------------------------------------------
---------------------------------------------------------C-BB--------------------------------------------------------------------%%%%%------------------------------------------------------------------
---------------------------------------------------------------------------------------------------------------------------------||k||------------------------------------------------------------------
----------------------------------------------------------X----------------------------------------------------------------------|%%%|------------------------------------------------------------------
-------------------------------------------------------r------------------------------------------B2BUUB-------------------------|||||------------------------------------------------------------------
------------------------------------------------------%%%%%%%---------------Tt---------------------------------------------------|||||------------------------------------------------------------------
------------------------------------------------------|||||||---------------tt---------------------------------------------------|||||------------------------------------------------------------------
---------------------------------------------Tt---tt--|||g|||--------------%%%%%%%------------------------------------%%%--%%%%%%%%%%%%%----------------------------------------------------------------
----------------------------#---#------------tt---tt-%%%%%%%%%%%%%%%---%%%%|||||||%%%---%%%%%%%%%%%%%%%%%-------------|||--|||||||||||||%%%%%%%%F%%%%%%%%%%%%%%%%%%%%%%%%%%%%%%%%%%%%%%%%%%%%%%%%%%%%%%%
---------------------------##---##--%%---%%--tt---tt-|||||||||||||||---||||||||||||||---|||||||||||||||||%%--%%%%---%%|||--|||||||||||||||||||||X|||||||||||||||||||||||||||||||||||||||||||||||||||||||
%%%%%%%%%%%%%%%%%%--%%%%%%%%%---%%%%||---||%%%%%%%%%%|||||||||||||||---||||||||||||||---|||||||||||||||||||--||||---|||||--|||||||||||||||||||||X|||||||||||||||||||||||||||||||||||||||||||||||||||||||
