--------------------------------------------------------------------------------------------------------------------------------------------------------------------------------------------------------
--------------------------------------------------------------------------------------------------------------------------------------------------------------------------------------------------------
--------------------------------------------------------------------------------------------------------------------------------------------------------------------------------------------------------
--------------------------------------------------------------------------------------------------------------------------------------------------------------------------------------------------------
--------------------------------------------------------------------------------------------------------------------------------------------------------------------------------------------------------
--------------------------------------------------------------------------------------------------------------------------------------------------------------------------------------------------------
--------------------------------------------------------------------------------------------------------------------------------------------------------------------------------------------------------
--------------------------------------------------------------------------------------------------------------------------------------------------------------------------------------------------------
---------------------------------------------------------------------------------------------------------------------------2UCSSC-----------------------------------------------------------------------
--------------------------------------------------------------------------------------------------------------------------------------------------------------------------------------------------------
--------------------------------------------------------------------------------------------------------------------------------------------------------------------------------------------------------
----------------y----------g------------------------------#---#-----------------------------------------------------------------------------------------------------------------------------------------
------------%%%%%-------%%%%%%---------------------------##---##--%%%%%---%%%%%--------------------------------%%---%%----%%%%%%%%%---------------------------------------------------------------------
------------|||||-------||||||-------------------------%%%%---%%%%|||||---|||||-------------%%%--%%%---#---#---||---||--%%|||||||||%%%%%%%%%%%----------------------------------------------------------
%%%%%%%%%%%-|||||----%%%||||||-------------------------||||---|||||||||---|||||%%%%%---%%%%%|||--|||--##---##--||---||%%||||||||||||||||||||||%%%%%%%%F%%%%%%%%%%%%%%%%%%%%%%%%%%%%%%%%%%%%%%%%%%%%%%%%%
|||||||||||XXXXXXXXXX|||||||||XX---XXXXXX--XXXXXXX--XXX||||---|||||||||---||||||||||---||||||||--|||XXXX---XXXX||---||||||||||||||||||||||||||||||||||X|||||||||||||||||||||||||||||||||||||||||||||||||
