--------------------------------------------------------------------------------------------------------------------------------------------------------------------------------------------------------
--------------------------------------------------------------------------------------------------------------------------------------------------------------------------------------------------------
--------------------------------------------------------------------------------------------------------------------------------------------------------------------------------------------------------
--------------------------------------------------------------------------------------------------------------------------------------------------------------------------------------------------------
--------------------------------------------------------------------------------------------------------------------------------------------------------------------------------------------------------
--------------------------------------------------------------------------------------------------------------------------------------------------------------------------------------------------------
--------------------------------------------------------------------------------------------------------------------------------------------------------------------------------------------------------
--------------------------------------------------------------------------------------------------------------------------------------------------------------------------------------------------------
-----------------------------------------SU2-S2----2SU2SS2-------------------------------------------------%%%%-----------SSSS--------------------------------------------------------------------------
-----------------------------------------------------------------------------------------------------------||||----tt-----------------------------------------------------------------------------------
--------------------------------------------|--------------------------------------------------------------||||----tt-----------------------------------------------------------------------------------
------------------------------------C2S-----k----------r----------------------CC2--------------------------||||----tt-----------------------------------------------------------------------------------
--------------#--#------#--#------------%%%%%%%%%%%%%%%%%%%%%%%------------------------------------------%%%|||---%%%%%%%%%%%%%%%%%%%%------------------------------------------------------------------
%%%%%%%%%%---##--##---%%%--%%%----------|||||||||||||||||||||||------%%---%%------%%%--%%%---------------||||||---||||||||||||||||||||------------------------------------------------------------------
||||||||||--###--###--|||--|||%%%-------|||||||||||||||||||||||%%--%%||---||-r----|||--|||%%%%%%%--------|||||g-g-||||||||||||||||||||--------%%%%%%%%F%%%%%%%%%%%%%%%%%%%%%%%%%%%%%%%%%%%%%%%%%%%%%%%%%
||||||||||XXXXX--XXXXX|||--||||||XXXXXXX|||||||||||||||||||||||||--||||---||XXXXXX|||--||||||||||XXXXXXXXXXXXXXXXX||||||||||||||||||||XXXXXXXX||||||||X|||||||||||||||||||||||||||||||||||||||||||||||||
