--------------------------------------------------------------------------------------------------------------------------------------------------------------------------------------------------------
--------------------------------------------------------------------------------------------------------------------------------------------------------------------------------------------------------
--------------------------------------------------------------------------------------------------------------------------------------------------------------------------------------------------------
--------------------------------------------------------------------------------------------------------------------------------------------------------------------------------------------------------
--------------------------------------------------------------------------------------------------------------------------------------------------------------------------------------------------------
--------------------------------------------------------------------------------------------------------------------------------------------------------------------------------------------------------
--------------------------------------------------------------------------------------------------------------------------------------------------------------------------------------------------------
--------------------------------------------------------------------------------------------------------------------------------------------y-----------------------------------------------------------
---------------------------------------------------------------------------------------------------------------------------------------%%%%%%-----------------------------------------------------------
---------------------------%%%%--------------------------------------------------------------------------------------------------------||||||-----------------------------------------------------------
---------------------------||||--------------------------------------------------------------------------------------------------------||||||-----------------------------------------------------------
---------------------------||||--%%%-----------------------------%%%%%%---------#---#--------------------------------------------------||||||-----------------------------------------------------------
---------------------------||||--|||------%%---%%%%%%%%%%%-g-----||gy||--------##---##--%%%%%--%%%%%----#---#----%%%%%---%%%%%------%%%%%%%%%%%%%%%%%%%%%F%%%%%%%%%%%%%%%%%%%%%%%%%%%%%%%%%%%%%%%%%%%%%%
------------%%---%%%%---%%-||||g-|||------||---|||||||||||%%%%%%%%%%%%%%%%%%%%%%%---%%%%|||||--|||||---##---##---|||||---|||||%%--%%|||||||||||||||||||||%||||||||||||||||||||||||||||||||||||||||||||||
%%%%%%%%%%%%||---||||---||%%%%%%%%%%%%%%%%||---||||||||||||||||||||||||||||||||||---|||||||||--|||||--###---###--|||||---|||||||--||||||||||||||||||||||||||||||||||||||||||||||||||||||||||||||||||||||
||||||||||||||---||||---||||||||||||||||||||---||||||||||||||||||||||||||||||||||---|||||||||--|||||XXXXX---XXXXX|||||---|||||||--||||||||||||||||||||||||||||||||||||||||||||||||||||||||||||||||||||||
