--------------------------------------------------------------------------------------------------------------------------------------------------------------------------------------------------------
--------------------------------------------------------------------------------------------------------------------------------------------------------------------------------------------------------
--------------------------------------------------------------------------------------------------------------------------------------------------------------------------------------------------------
--------------------------------------------------------------------------------------------------------------------------------------------------------------------------------------------------------
--------------------------------------------------------------------------------------------------------------------------------------------------------------------------------------------------------
--------------------------------------------------------------------------------------------------------------------------------------------------------------------------------------------------------
--------------------------------------------------------------------------------------------------------------------------------------------------------------------------------------------------------
--------------------------------------------------------------------------------------------------------------------------------------------------------------------------------------------------------
--------------------------------------------------------------------------------------------------------------------------------------------------------------------------------------------------------
--------------------------K-y----------------------------------------------------------------------------------r----------------------------------------------------------------------------------------
----------------CCBCC----%%%%%%%-------------------------------------------------------BBC2B-----------------%%%%%--------------------------------------------------------------------------------------
-------------------------|||||||----------------------BBBBUB2------------------------------------------------|||||--------------------------------------------------------------------------------------
%%%%%%%%%%%%%%---------%%%%%%%%%%%--------------------------------------------%%%%%-----------%%%%%%%%-------k|||r-r------------------------------------------------------------------------------------
||||||||||||||---------|||||||||||%%--%%--------------------------------------|||||-----------||||||||%%%%%%%%%%%%%%%%%%%-------------------------------------------------------------------------------
||||||||||||||%%%%%%%%%|||||||||||||--||%%%%%---%%%%%-------------------------|||||%%%%%%%%%%%|||||||||||||||||||||||||||-----------%%%%%%--------------------------------------------------------------
||||||||||||||||||||||||||||||||||||--|||||||---|||||%%%%%%%%%%%%%%--%%%%%--%%|||||||||||||||||||||||||||||||||||||||||||%%%%---%%%%||||||%%%%%%%%F%%%%%%%%%%%%%%%%%%%%%%%%%%%%%%%%%%%%%%%%%%%%%%%%%%%%%
