--------------------------------------------------------------------------------------------------------------------------------------------------------------------------------------------------------
--------------------------------------------------------------------------------------------------------------------------------------------------------------------------------------------------------
--------------------------------------------------------------------------------------------------------------------------------------------------------------------------------------------------------
--------------------------------------------------------------------------------------------------------------------------------------------------------------------------------------------------------
--------------------------------------------------------------------------------------------------------------------------------------------------------------------------------------------------------
--------------------------------------------------------------------------------------------------------------------------------------------------------------------------------------------------------
--------------------------------------------------------------------------------------------------------------------------------------------------------------------------------------------------------
--------------------------------------------------------------------------------------------------------------------------------------------------------------------------------------------------------
--------------------------------y-----SCSSCS2-----------------------------------------------------------------------------------------------------------------------------------------------------------
---------------CSS-----------%%%%%%---------------------------------------------------------------------------------------------------------------------------------------------------------------------
-----------------------------||||||---------------------------------------------------------------------------------------------------------------------------------------------------------------------
---------------------------g-||||||------k---r--------------------------------------------------------r-----------------2SCC----------------------------------------------------------------------------
--------------y----%%%%%%%%%%%%%%%%%%%%%%%%%%%%%%--%%-------#---#--------------------%%%%--%%%%%%%%%%%%%%%%%%%------------------------------------------------------------------------------------------
%%%%%%%%%%%%%%%%%%%||||||||||||||||||||||||||||||--||------##---##--------------%%%%%||||--|||||||||||||||||||------------------------------------------------------------------------------------------
|||||||||||||||||||||||||||||||||||||||||||||||||--||%%%%%%%%---%%%%%%%%%--%%%%%|||||||||--|||||||||||||||||||------------k-----------------------------------------------------------------------------
|||||||||||||||||||||||||||||||||||||||||||||||||--||||||||||---|||||||||--||||||||||||||--|||||||||||||||||||XX---XXXXXXXXXXXXXXXXXXXX---XXXXXXXXXXXXXFXXXXXXXXXXXXXXXXXXXXXXXXXXXXXXXXXXXXXXXXXXXXXXXX
