--------------------------------------------------------------------------------------------------------------------------------------------------------------------------------------------------------
--------------------------------------------------------------------------------------------------------------------------------------------------------------------------------------------------------
--------------------------------------------------------------------------------------------------------------------------------------------------------------------------------------------------------
--------------------------------------------------------------------------------------------------------------------------------------------------------------------------------------------------------
--------------------------------------------------------------------------------------------------------------------------------------------------------------------------------------------------------
--------------------------------------------------------------------------------------------------------------------------------------------------------------------------------------------------------
--------------------------------------------------------------------------------------------------------------------------------------------------------------------------------------------------------
--------------------------------------------------------------------------------------------------------------------------------------------------------------------------------------------------------
--------------------------------------------------------------------------------------------------------------------------------------------------------------------------------------------------------
-------------------------------------------------------------------------------------%%%%%%%------------------------------------------------------------------------------------------------------------
-------------------------------------------------------------------------------------|||||||------------------------------------------------------------------------------------------------------------
-------------------------r-y-----------------------#--#------------------------------||||kr|------------------------------------------------------------------------------------------------------------
%%%%%%%%%%---------------%%%%%%%------------------##--##-----------------------------|||%%%|---------------%%--%%---#---#-------------------------------------------------------------------------------
||||||||||---------------|||||||---%%%%%---%%%%%%%%%--%%%%---------------------------|||K|||--%%--%%-------||--||--##---##-------------%%--%%-----------------------------------------------------------
||||||||||%%%%%---%%%%%%%%%%%%%%%%%|||||---|||||||||--||||--------%%%%%---%%%%%%%%%%%%%%%%%%%%||--||%%---%%||--||%%%%---%%%%%%%%---%%%%||--||%%%%%%%%F%%%%%%%%%%%%%%%%%%%%%%%%%%%%%%%%%%%%%%%%%%%%%%%%%%
|||||||||||||||---||||||||||||||||||||||---|||||||||--||||XXX--XXX|||||---||||||||||||||||||||||--||||---||||--||||||---||||||||---||||||--||||||||||X||||||||||||||||||||||||||||||||||||||||||||||||||
