--------------------------------------------------------------------------------------------------------------------------------------------------------------------------------------------------------
--------------------------------------------------------------------------------------------------------------------------------------------------------------------------------------------------------
--------------------------------------------------------------------------------------------------------------------------------------------------------------------------------------------------------
--------------------------------------------------------------------------------------------------------------------------------------------------------------------------------------------------------
--------------------------------------------------------------------------------------------------------------------------------------------------------------------------------------------------------
--------------------------------------------------------------------------------------------------------------------------------------------------------------------------------------------------------
--------------------------------------------------------------------------------------------------------------------------------------------------------------------------------------------------------
--------------------------------------------------------------------------------------------------------------------------------------------------------------------------------------------------------
--------------------------------------------------------------------------------------------------------------------------------------------------------------------------------------------------------
---------------------------------------------k----------------------------------------------------------------------------------------------------------------------------------------------------------
------------------------------------------%%%%-------------------------------------------------------------------------------------------CCBB2BC--------------------------------------------------------
------------------------------------------||||------------------------------------------g---------------------------------------------------------------------------------------------------------------
----------------------------%%%--%%%-----y||r|k--------%%%%%--%%%%%------------%%---%%--%%%%%%%---------%%%%%%%%%%%-----------%%%---%%%-----------%%%%%%%%F%%%%%%%%%%%%%%%%%%%%%%%%%%%%%%%%%%%%%%%%%%%%%
--------------------%%%--%%%|||--|||%%%%%%%%%%%%%%%%%%%|||||--|||||%%%%%--%%%%%||---||--|||||||---------|||||||||||%%%%---%%%%|||---|||-----------||||||||X|||||||||||||||||||||||||||||||||||||||||||||
%%%%%%%%%%%%%%%%----|||--||||||--|||||||||||||||||||||||||||--||||||||||--|||||||---||-k||g||||---------|||||||||||||||---|||||||---|||%%%%%%%%%%%||||||||X|||||||||||||||||||||||||||||||||||||||||||||
||||||||||||||||%%%%|||--||||||--|||||||||||||||||||||||||||--||||||||||--|||||||---||%%%%%%%%%%%%%%%%%%|||||||||||||||---|||||||---||||||||||||||||||||||X|||||||||||||||||||||||||||||||||||||||||||||
