--------------------------------------------------------------------------------------------------------------------------------------------------------------------------------------------------------
--------------------------------------------------------------------------------------------------------------------------------------------------------------------------------------------------------
--------------------------------------------------------------------------------------------------------------------------------------------------------------------------------------------------------
--------------------------------------------------------------------------------------------------------------------------------------------------------------------------------------------------------
--------------------------------------------------------------------------------------------------------------------------------------------------------------------------------------------------------
--------------------------------------------------------------------------------------------------------------------------------------------------------------------------------------------------------
--------------------------------------------------------------------------------------------------------------------------------------------------------------------------------------------------------
--------------------------------------------------------------------------------------------------------------------------------------------------------------------------------------------------------
------------------------------------------------------------------------------------%%%%----------------------------------------------------------------------------------------------------------------
------------------------------------------------------------------------------------||||----------------------------------------------------------------------------------------------------------------
--------------------------------------------------------------------%%%%%-----------||||---g------------------------------------------------------------------------------------------------------------
--------------------------------------------------------tt----------|||||-----------||||--%%%%%---------------------------------------------------------------------------------------------------------
----------------------------#---#-----------------r-----tt----------||||k--%%%--%%%-||||--|||||------------------%%%%---%%%%%%%--%%%-------------%%%%%%%%F%%%%%%%%%%%%%%%%%%%%%%%%%%%%%%%%%%%%%%%%%%%%%%
---------------------------##---##-----------%%%%%%%%---tt---%%%%%%%%%%%%%%|||--|||-||||--|||||-----#---#--%%--%%||||---|||||||--|||-------------||||||||%||||||||||||||||||||||||||||||||||||||||||||||
%%%%%%%%%%%%%%-----------%%%%---%%%%----gk---||||||||%%%%%%%%|||||||||||||||||--|||%%%%%%%%%%%%%%%%%%---%%%||--||||||---|||||||--|||-------------|||||||||||||||||||||||||||||||||||||||||||||||||||||||
||||||||||||||XXXX---XXXX||||---||||XXXXXXXXX|||||||||||||||||||||||||||||||||--|||||||||||||||||||||---|||||--||||||---|||||||--|||XXXXX---XXXXX|||||||||||||||||||||||||||||||||||||||||||||||||||||||
