--------------------------------------------------------------------------------------------------------------------------------------------------------------------------------------------------------
--------------------------------------------------------------------------------------------------------------------------------------------------------------------------------------------------------
--------------------------------------------------------------------------------------------------------------------------------------------------------------------------------------------------------
--------------------------------------------------------------------------------------------------------------------------------------------------------------------------------------------------------
-----------------------------------------------------------------------------------------------------------------------r--------------------------------------------------------------------------------
----------------------------------------------------------------------------------------------------------------------%%%%%%%---------------------------------------------------------------------------
----------------------------------------------------------------------------------------------------------------------|||||||---------------------------------------------------------------------------
----------------------------------------------------------------------------------------------------------------------|||||||---------------------------------------------------------------------------
-------------------------%%%%%%%------------------%%%%----------------------------------------------------------------|||||||---------------------------------------------------------------------------
-------------------------|||||||------------------||||------------------------------------------------USCUC---------%%%%|||||---------------------------------------------------------------------------
-------------tt----------|||||||---S-USSSS--------||||----C-C-------------------------------------------------------|||||||||---------------------------------------------------------------------------
-------------tt-tt-------||%%%||-----------------y||||--------------------------------------------------------------|||||||||---------------------------------------------------------------------------
-------------tt-tt-------|||||||----%--------%%%%%%%%%%%---%-----%%%---%%%----------------------------kg------%%%%%%%%%%%%%%%%%%%-----------------------------------------------------------------------
%%%%%%%%%%%%%%%%%%%%%%%--|||||||----|---y----|||||||||||---|-g---|||---|||----------------%%%%--%%%%%%%%%%%%%%|||||||||||||||||||-----------------------------------------------------------------------
|||||||||||||||||||||||--|||k|||k-%%%%%%%%%%%|||||||||||%%%%%%%%%|||---|||%%---%%---------||||--|||||||||||||||||||||||||||||||||%%--%%%%%%%--%%%%%-----------------------------------------------------
|||||||||||||||||||||||XXXXXXXXXXX||||||||||||||||||||||||||||||||||---|||||---||XXX---XXX||||--|||||||||||||||||||||||||||||||||||--|||||||--|||||XXXXXXXXFXXXXXXXXXXXXXXXXXXXXXXXXXXXXXXXXXXXXXXXXXXXX
