--------------------------------------------------------------------------------------------------------------------------------------------------------------------------------------------------------
--------------------------------------------------------------------------------------------------------------------------------------------------------------------------------------------------------
--------------------------------------------------------------------------------------------------------------------------------------------------------------------------------------------------------
--------------------------------------------------------------------------------------------------------------------------------------------------------------------------------------------------------
--------------------------------------------------------------------------------------------------------------------------------------------------------------------------------------------------------
--------------------------------------------------------------------------------------------------------------------------------------------------------------------------------------------------------
--------------------------------------------------------------------------------------------------------------------------------------------------------------------------------------------------------
--------------------------------------------------------------------------------------------------------------------------------------------------------------------------------------------------------
--------------------------------------------------------------------------------------------------------------------------------------------------------------------------------------------------------
-------------------------------------------------------------------------------------------------------S2CSS--------------------------------------------------------------------------------------------
--------------------------------------------------------------------------------------------------------------------------------------------------------------------------------------------------------
--------------------------------------------------------------------------------------------------------------------------------------------------------------------------------------------------------
------------------------#---#---------------#--#----%%%---%%%%%%%%--%%%%%---------------------------------r--------------%%%%%%%%%%---------------------------------------------------------------------
-----------------------##---##-------------##--##---|||---||||||||--|||||--------------------%%%---%%%%%%%%%%%-----------||||||||||---%%%%%---%%%%%-----------------------------------------------------
----------------------###---###--%%---%%--###--###--|||---||||||||--|||||------------%%%--%%%|||---|||||||||||%%--%%%%%%%||||||||||---|||||---|||||%%%%%%%%F%%%%%%%%%%%%%%%%%%%%%%%%%%%%%%%%%%%%%%%%%%%%
XXXXXXXXXXXXXXXXXXXXXXXXX---XXXXX||---||XXXXX--XXXXX|||---||||||||--|||||XXXXX--XXXXX|||--||||||---|||||||||||||--|||||||||||||||||XXX|||||---|||||||||||||X||||||||||||||||||||||||||||||||||||||||||||
