--------------------------------------------------------------------------------------------------------------------------------------------------------------------------------------------------------
--------------------------------------------------------------------------------------------------------------------------------------------------------------------------------------------------------
--------------------------------------------------------------------------------------------------------------------------------------------------------------------------------------------------------
------------------------------------------------------BCCC----------------------------------------------------------------------------------------------------------------------------------------------
--------------------------------------------------------------------------------------------------------------------------------------------------------------------------------------------------------
--------------------------------------------------------------------------------------------------------------------------------------------------------------------------------------------------------
-------------------------------------------------------r----k-------------------------------------------------------------------------------------------------------------------------------------------
------------------------------------------------------%%%%%%%-------------------------------------------------------------------------------------------------------------------------------------------
------------------------------------------------------|||||||-----------------------------------------y-------BUBBB-------------------------------------------------------------------------------------
-------------------------------------%%%%%------------||||%%%%%--------------------------------------%%%%-----------------------------------------------------------------------------------------------
-------------------------------------|||||------------|||||||||--------------------------------------||||-----------------------------------------------------------------------------------------------
-------------------------------------|||||------------|||||||||--y--------------------Tt--tt---------||||-----------------------------------------------------------------------------------------------
------------------------%%%%%--%%%%%-|||||-----------%%%%%%%%%%%%%%%%%---%%%----------tt--tt-----%%%%%|||----%%%%%%%--tt---tt------%%%%---%%%%%%%%%%%%F%%%%%%%%%%%%%%%%%%%%%%%%%%%%%%%%%%%%%%%%%%%%%%%%%
------------------------|||||--|||||-|%%%|----%%---%%|||||||||||||||||---|||%%%%%%%%%%%%%%%%%%%%-|||y|r||-rr-|||||||--tt---tt------||||---||||||||||||X|||||||||||||||||||||||||||||||||||||||||||||||||
-------------%%%%---%%%%|||||--|||||-|||r|----||---|||||||||||||||||||---|||||||||||||||||||||||%%%%%%%%%%%%%|||||||%%%%%%%%%%%%%%%||||---||||||||||||X|||||||||||||||||||||||||||||||||||||||||||||||||
%%%%%%%%%%%%%||||---|||||||||--|||||%%%%%%%%%%||---|||||||||||||||||||---||||||||||||||||||||||||||||||||||||||||||||||||||||||||||||||---||||||||||||X|||||||||||||||||||||||||||||||||||||||||||||||||
