--------------------------------------------------------------------------------------------------------------------------------------------------------------------------------------------------------
--------------------------------------------------------------------------------------------------------------------------------------------------------------------------------------------------------
--------------------------------------------------------------------------------------------------------------------------------------------------------------------------------------------------------
--------------------------------------------------------------------------------------------------------------------------------------------------------------------------------------------------------
--------------------------------------------------------------------------------------------------------------------------------------------------------------------------------------------------------
--------------------------------------------------------------------------------------------------------------------------------------------------------------------------------------------------------
--------------------------------------------------------------------------------------------------------------------------------------------------------------------------------------------------------
--------------------------------------------------------------------------------------------------------------------------------------------------------------------------------------------------------
--------------------------------------------------------------------------------------------------------------------------------------------------------------------------------------------------------
--------------------------------------------------------------------------------------------------------------------------------------------------------------------------------------------------------
--------------------------------------------------------------------------------------------------------------------------------------------------------------------------------------------------------
--------------------------------------------------------------------------------------------------------------------------------------------------------------------------------------------------------
------------------------------------------------------------------#---#------#---#------#---#-----------------------------------------tt----Tt----------------------------------------------------------
----------------------#---#-------------------------------------%%%---%%%---##---##---%%%---%%%%%%---%%%-------------------%%%%--%%%%-tt----tt---%%%%%%%%F%%%%%%%%%%%%%%%%%%%%%%%%%%%%%%%%%%%%%%%%%%%%%%
%%%%%%%%%%%%%%%---%%%%%---%%%----------%%%--%%%-------------%%%%|||---|||--###---###--|||---||||||---|||-------------------||||--||||-tt----tt---||||||||X||||||||||||||||||||||||||||||||||||||||||||||
|||||||||||||||---|||||---|||%%%%--%%%%|||--|||%%%%%---%%%%%|||||||---|||%%%%%---%%%%%|||---||||||---|||%%---%%%%%%%--%%%%%||||--||||%%%%%%%%%%%%||||||||X||||||||||||||||||||||||||||||||||||||||||||||
