--------------------------------------------------------------------------------------------------------------------------------------------------------------------------------------------------------
--------------------------------------------------------------------------------------------------------------------------------------------------------------------------------------------------------
--------------------------------------------------------------------------------------------------------------------------------------------------------------------------------------------------------
--------------------------------------------------------------------------------------------------------------------------------------------------------------------------------------------------------
--------------------------------------------------------------------------------------------------------------------------------------------------------------------------------------------------------
--------------------------------------------------------------------------------------------------------------------------------------------------------------------------------------------------------
--------------------------------------------------------------------------------------------------------------------------------------------------------------------------------------------------------
--------------------------------------------------------------------------------------------------------------------------------------------------------------------------------------------------------
--------------------------------------------------------------------------------------------------------------------------------------------------------------------------------------------------------
--------------------------------------#---#-------------------------------------------------------------------------------------------------------------------------------------------------------------
-------------------------------------##---##------------------------------------------------------------------------%%%%%%------------------------------------------------------------------------------
------------------------------------###---###------#--#---------------------------------------------------tt---Tt---g|||||------k-----------------------------------------------------------------------
--------------------%%%%%%%----tt-%%%%%---%%%%%---##--##--------------------------------------------------tt---tt-%%%%%%%%%%%%%%%%----------------------------------------------------------------------
-----------------rggyg|||||----tt-|||||---|||||--###--###--%%--%%%%%%%%---%%%%%%%-------------------------tt---tt-||||||||||||||||----------------------------------------------------------------------
%%%%%%%%%%%%%%%%%%%%%%%%%%%%%%%%%%|||||---|||||%%%%%--%%%%%||--||||||||---|||||||---------%%%%%--%%%%%%%%%%%%%%%%%||||||||||||||||------%%%%%%%%F%%%%%%%%%%%%%%%%%%%%%%%%%%%%%%%%%%%%%%%%%%%%%%%%%%%%%%%
|||||||||||||||||||||||||||||||||||||||---||||||||||--|||||||--||||||||%%%|||||||%%%---%%%|||||--|||||||||||||||||||||||||||||||||%%--%%||||||||X|||||||||||||||||||||||||||||||||||||||||||||||||||||||
