--------------------------------------------------------------------------------------------------------------------------------------------------------------------------------------------------------
--------------------------------------------------------------------------------------------------------------------------------------------------------------------------------------------------------
--------------------------------------------------------------------------------------------------------------------------------------------------------------------------------------------------------
--------------------------------------------------------------------------------------------------------------------------------------------------------------------------------------------------------
--------------------------------------------------------------------------------------------------------------------------------------------------------------------------------------------------------
--------------------------------------------------------------------------------------------------------------------------------------------------------------------------------------------------------
--------------------------------------------------------------------------------------------------------------------------------------------------------------------------------------------------------
--------------------------------------------------------------r-----------------------------------------------------------------------------------------------------------------------------------------
-----------------------------------------------------------%%%%-----------------------------------------------------------------------------------------------------------------------------------------
-----------------------------------------------------------||||-----------------------------------------------------------------------------------------------------------------------------------------
-------------------------------------------BCBB------------||||-----------------------------------#--#----2BBBCB----------------------------------------------------------------------------------------
-----------------------------------------------------------||||----------------r------%%%--------##--##-------------------------------------------------------------------------------------------------
--------------------------------------------------------%%%%%%|-----------%%%%%%%%%%--|||------%%%%--%%%%---------------%%%---%%%%%%%%---%%%%%----------------------------------------------------------
------------%%%---%%%---#--#----------------------------|||||||-----------||||||||||--|||------||||--||||----------%%%%%|||---||||||||---|||||----------------------------------------------------------
------------|||---|||--##--##--%%%---%%%%%%%%%%%%%%%%%%%%%%%%%%%%%%%------||||||||||--||G------||||--||||%%%%%%%%%%||||||||---||||||||---|||||%%%%%%%%F%%%%%%%%%%%%%%%%%%%%%%%%%%%%%%%%%%%%%%%%%%%%%%%%%
%%%%%%%%%%%%|||---|||%%%%--%%%%|||---|||||||||||||||||||||||||||||||%%%%%%||||||||||%%%%%%%%%%%||||--||||||||||||||||||||||---||||||||---|||||||||||||X|||||||||||||||||||||||||||||||||||||||||||||||||
