--------------------------------------------------------------------------------------------------------------------------------------------------------------------------------------------------------
--------------------------------------------------------------------------------------------------------------------------------------------------------------------------------------------------------
--------------------------------------------------------------------------------------------------------------------------------------------------------------------------------------------------------
--------------------------------------------------------------------------------------------------------------------------------------------------------------------------------------------------------
--------------------------------------------------------------------------------------------------------------------------------------------------------------------------------------------------------
--------------------------------------------------------------------------------------------------------------------------------------------------------------------------------------------------------
--------------------------------------------------------------------------------------------------------------------------------------------------------------------------------------------------------
--------------------------------------------------------------------------------------------------------------------------------------------------------------------------------------------------------
--------------------------------------------------------------------------------------------------------------------------------------------------------------------------------------------------------
----------------------------------------------------------------------------------------------------------------------------BBBU------------------------------------------------------------------------
------------------------#--#----------------------------------------------------------------------------------------------------------------------------------------------------------------------------
-----------------------##--##---------------------------------------------------------------------------------------------------------------------------------------------------------------------------
---------------------%%%%--%%%%-----------------------------------%%%%%---%%%%%---#---#---%%%%%--%%%%%%%%%%%%%%------------------r-%%%%%%%%%%%%%%%%%%%F%%%%%%%%%%%%%%%%%%%%%%%%%%%%%%%%%%%%%%%%%%%%%%%%%
%%%%%%%%%%%%%%%%--%%%||||--||||----------------------%%%%---------|||||---|||||--##---##--|||||--||||||||||||||----------%%%%%%%%%%|||||||||||||||||||X|||||||||||||||||||||||||||||||||||||||||||||||||
||||||||||||||||--|||||||--||||---------#---#----g-r-||||---------|||||---|||||%%%%---%%%%|||||--||||||||||||||----------|||||||||||||||||||||||||||||X|||||||||||||||||||||||||||||||||||||||||||||||||
||||||||||||||||--|||||||--||||%%---%%%%%---%%%%%%%%%||||%%%---%%%|||||---|||||||||---|||||||||--||||||||||||||%%%%--%%%%|||||||||||||||||||||||||||||X|||||||||||||||||||||||||||||||||||||||||||||||||
