--------------------------------------------------------------------------------------------------------------------------------------------------------------------------------------------------------
--------------------------------------------------------------------------------------------------------------------------------------------------------------------------------------------------------
--------------------------------------------------------------------------------------------------------------------------------------------------------------------------------------------------------
--------------------------------------------------------------------------------------------------------------------------------------------------------------------------------------------------------
--------------------------------------------------------------------------------------------------------------------------------------------------------------------------------------------------------
--------------------------------------------------------------------------------------------------------------------------------------------------------------------------------------------------------
--------------------------------------------------------------------------------------------------------------------------------------------------------------------------------------------------------
--------------------------------------------------------------------yg--------------------------------SCUSS---------------------------------------------------------------------------------------------
-------------------------------------------------------------------%%%----------------------------------------------------------------------------------------------------------------------------------
-------------------------------------------------------------------|||-------------------------------------|--------------------------------------------------------------------------------------------
-------------------------------------------------------------------|||---------------------------------g--gr----------------------y---------------------------------------------------------------------
-------------------------------#--#--------------------------------|||---------------------------tt---%%%%%%%------------------%%%%---------------------------------------------------------------------
%%%%%%%%%%%%%%----#---#-------##--##---%%--%%--------------------%%%%|---------------------------tt---|||||||--%%%%%%----------g|||---------------------------------------------------------------------
||||||||||||||---##---##-----###--###--||--||--------------------|||||-----------------%%--%%----tt---|||||||--||||||--------%%%%||---%%%%--%%%%--------------------------------------------------------
||||||||||||||--###---###--%%%%%--%%%%%||--||--------------------|k|||--%%%%%%%%%---%%%||--||%%%%%%%%-|||||||--||||||--k---g-|||k||---||||--||||%%%%%%%%F%%%%%%%%%%%%%%%%%%%%%%%%%%%%%%%%%%%%%%%%%%%%%%%
||||||||||||||XXXXX---XXXXX|||||--|||||||--||XXX---XXXXXX--XXXXXXXXXXXXX|||||||||---|||||--||||||||||XXXXXXXXXX||||||XXXXXXXXXXXXXXXXX||||--||||||||||||X|||||||||||||||||||||||||||||||||||||||||||||||
