--------------------------------------------------------------------------------------------------------------------------------------------------------------------------------------------------------
--------------------------------------------------------------------------------------------------------------------------------------------------------------------------------------------------------
--------------------------------------------------------------------------------------------------------------------------------------------------------------------------------------------------------
--------------------------------------------------------------------------------------------------------------------------------------------------------------------------------------------------------
--------------------------------------------------------------------------------------------------------------------------------------------------------------------------------------------------------
--------------------------------------------------------------------------------------------------------------------------------------------------------------------------------------------------------
--------------------------------------------------------------------------------------------------------------------------------------------------------------------------------------------------------
--------------------------------------------------------------------------------------------------------------------------------------------------------------------------------------------------------
--------------------------------------------------------------------------------------------------------------------------------------------------------------------------------------------------------
--------------------------------------------------------------------------------------------------------------------------------------------------------------------------------------------------------
--------------------------------------------------------------------------------------------------------------------------------------------------------------------------------------------------------
-------------------------tt-----------------------------------------------------------------------------------------tt--------#--#----------------------------------------------------------------------
-------------------------tt------------%%%---%%%---------------------------------%%---%%--%%------------------------tt--tt--%%%--%%%--------------------------------------------------------------------
%%%%%%%%%%%%-------------tt----%%%--%%%|||---|||----%%%--------------------------||---||--||--#--#--%%%%------------tt--tt--|||--|||%%%--%%%%%%%%%%%F%%%%%%%%%%%%%%%%%%%%%%%%%%%%%%%%%%%%%%%%%%%%%%%%%%%
||||||||||||%%%---%%%%%%%%%%%%%|||--||||||---|||----r||----------%%%---%%%%%---%%||---||--||%%%--%%%||||--#---#--%%%%%%%%%%%|||--||||||--|||||||||||%|||||||||||||||||||||||||||||||||||||||||||||||||||
|||||||||||||||---||||||||||||||||--||||||---|||XXXXXXXXXXXXXXXXX|||---|||||---||||---||XX|||||--|||||||XXX---XXX||||||||||||||--||||||--|||||||||||||||||||||||||||||||||||||||||||||||||||||||||||||||
