--------------------------------------------------------------------------------------------------------------------------------------------------------------------------------------------------------
--------------------------------------------------------------------------------------------------------------------------------------------------------------------------------------------------------
--------------------------------------------------------------------------------------------------------------------------------------------------------------------------------------------------------
----------------------------------------------------------------------------------------------------------SSS-------------------------------------------------------------------------------------------
--------------------------------------------------------------------------------------------------------------------------------------------------------------------------------------------------------
--------------------------------------------------------------------------------------------------------------------------------------------------------------------------------------------------------
--------------------------------------------------------------------------------------------------------------------------------------------------------------------------------------------------------
----------------------------------------------------------------------------------------------------------%%%-------------------------------------------------------------------------------------------
----------------------------------------------------------------------------------------------------------|||-------------------------------------------------------------------------------------------
---------------------------------------------------------------------------------CS-----------------------|||-------------------------------------------------------------------------------------------
----------------------------------------------------y-----------------------------------------------------|%%%%%%---------------------------------------------------------------------------------------
------------------------------------------------%%%%%---------------------------%-------------------------|||||||---------------------------------------------------------------------------------------
------------------------%%---%%---#---#---------|||||-------------%%%%%---%%%%%-|-r--r------%%%%%----g----|||||||----------%%%%--%%%%------%%%%%%%%F%%%%%%%%%%%%%%%%%%%%%%%%%%%%%%%%%%%%%%%%%%%%%%%%%%%%
%%%%%%%%%%%%%%%%---%%%%%||---||--##---##--%%%%%%%%%%%%%%%%%%---%%%|||||---|||||%%%%%%%%-----|||||%%%%%%%%%%%%%%%%%%--------||||--||||------||||||||%||||||||||||||||||||||||||||||||||||||||||||||||||||
||||||||||||||||---|||||||---||%%%%---%%%%||||||||||||||||||---||||||||---|||||||||||||-----|||||||||||||||||||||||%%%--%%%||||--||||------|||||||||||||||||||||||||||||||||||||||||||||||||||||||||||||
||||||||||||||||---|||||||---||||||---||||||||||||||||||||||---||||||||---|||||||||||||XXXXX||||||||||||||||||||||||||--|||||||--||||XX--XX|||||||||||||||||||||||||||||||||||||||||||||||||||||||||||||
