--------------------------------------------------------------------------------------------------------------------------------------------------------------------------------------------------------
--------------------------------------------------------------------------------------------------------------------------------------------------------------------------------------------------------
--------------------------------------------------------------------------------------------------------------------------------------------------------------------------------------------------------
--------------------------------------------------------------------------------------------------------------------------------------------------------------------------------------------------------
--------------------------------------------------------------------------------------------------------------------------------------------------------------------------------------------------------
--------------------------------------------------------------------------------------------------------------------------------------------------------------------------------------------------------
--------------------------------------------------------------------------------------------------------------------------------------------------------------------------------------------------------
-----------------------------------------------------------------------------------------------------------CB2B-----------------------------------------------------------------------------------------
------------------------------------BUCC----------------------------------------------------------------------------------------------------------------------------------------------------------------
-------------------------------------------------------------------------BUB----------------------------------------------------------------------------------------------------------------------------
--------------------------------------------------------------------------------------y-----------------------------------------------------------------------------------------------------------------
-------------------------------------------------------------------------------------%%%%%%%--------------%%%%%------------y------#--#------------------------------------------------------------------
%%%%%%%%%%%--------------%%%%--%%%%%%%%%%%%%%%%------------%%%%---%%%%-----g---------|||||||--------------|||||-----------%%%%%%%%%--%%%----------------------------------------------------------------
|||||||||||-----------%%%||||--||||||||||||||||%%--%%%%--%%||||---||||%%%%%%%--------|||||||--------------|||||-----------|||||||||--|||----------------------------------------------------------------
|||||||||||%%%%---%%%%|||||||--||||||||||||||||||--||||--||||||---|||||||||||%%--%%%%%%%%%%%%%%%%%---%%-g-||||y-----------|||||||||--|||----------------------------------------------------------------
|||||||||||||||---|||||||||||--||||||||||||||||||--||||--||||||---|||||||||||||--|||||||||||||||||---||%%%%%%%%%%%%%%%%%%%|||||||||--|||%%%%%%%%F%%%%%%%%%%%%%%%%%%%%%%%%%%%%%%%%%%%%%%%%%%%%%%%%%%%%%%%
