--------------------------------------------------------------------------------------------------------------------------------------------------------------------------------------------------------
--------------------------------------------------------------------------------------------------------------------------------------------------------------------------------------------------------
--------------------------------------------------------------------------------------------------------------------------------------------------------------------------------------------------------
--------------------------------------------------------------------------------------------------------------------------------------------------------------------------------------------------------
--------------------------------------------------------------------------------------------------------------------------------------------------------------------------------------------------------
--------------------------------------------------------------------------------------------------------------------------------------------------------------------------------------------------------
--------------------------------------------------------------------------------------------------------------------------------------------------------------------------------------------------------
--------------------------------------------------------------------------------------------------------------------------------------------------------------------------------------------------------
------------------------------------------------------------------------------------------------------------------------------------BBBBCB--------------------------------------------------------------
------------------------------------------------------------------tt------------------------------------------------------------------------------------------------------------------------------------
----------------#--#------------------------------------------Tt--tt--------------------------y----------------#---#------------------------------------------------------------------------------------
---------------##--##--------2BBB2----------------#---#-------tt--tt----------------------%%%%%---------------##---##---------------------g-------------------------------------------------------------
-------------%%%%--%%%%--------------------------##---##--%%%%%%%%%%%%--------------------|||||-------------%%%%---%%%%%%%%---------%%%%%%%-------------------------------------------------------------
-------------||||--||||------------------------%%%%---%%%%||||||||||||%%%%---%%%%---------|||||------#--#---||||---||||||||---------|||k||y---%%%%%%%%F%%%%%%%%%%%%%%%%%%%%%%%%%%%%%%%%%%%%%%%%%%%%%%%%%
%%%%%%%%%%%%%||||--||||----------y-------------||||---||||||||||||||||||||---||||-----gr--|||||-----##--##--||||---||||||||--------%%%%%%%%%%%||||||||X|||||||||||||||||||||||||||||||||||||||||||||||||
|||||||||||||||||--||||%%%%%%%%%%%%%%%%%--%%%%%||||---||||||||||||||||||||---||||%%%%%%%%%%%%%%%%%%%%%--%%%%||||---||||||||%%%--%%%|||||||||||||||||||X|||||||||||||||||||||||||||||||||||||||||||||||||
