--------------------------------------------------------------------------------------------------------------------------------------------------------------------------------------------------------
--------------------------------------------------------------------------------------------------------------------------------------------------------------------------------------------------------
--------------------------------------------------------------------------------------------------------------------------------------------------------------------------------------------------------
--------------------------------------------------------------------------------------------------------------------------------------------------------------------------------------------------------
--------------------------------------------------------------------------------------------------------------------------------------------------------------------------------------------------------
--------------------------------------------------------------------------------------------------------------------------------------------------------------------------------------------------------
--------------------------------------------------------------------------------------------------------------------------------------------------------------------------------------------------------
--------------------------------------------------------------------------------------------------------------------------------------------------------------------------------------------------------
-----------------------------------------2SCS----------------------------------------------------------------%%%%%%-------------------------------------------------------------------------------------
-----------------------------------------------------------------------------------r-------------------------||||||-------------------------------------------------------------------------------------
----------------------------#---#-------------------------------------------------%%%%%%%-------#--#---------||||||-------------------------------------------------------------------------------------
---------------------------##---##------------------------------------------------||k||||------##--##--------||||||-------------------------------------------------------------------------------------
--------------------------###---###--%%%%%%%%%%%-------------------tt----Tt----%%%%%%%%%%%%%--###--###--%%%%%%%%%%%%%%%----------------%%%---%%%%%%%%%%%F%%%%%%%%%%%%%%%%%%%%%%%%%%%%%%%%%%%%%%%%%%%%%%%
%%%%%%%%%%%%%%----------%%%%%---%%%%%|||||||||||-------------------tt----tt--%%|||||||||||||%%%%%--%%%%%|||||||||||||||----------%%%%%%|||---|||||||||||%|||||||||||||||||||||||||||||||||||||||||||||||
||||||||||||||%%%%--%%%%|||||---||||||||||||||||--#--#--%%%---%%%%%%%%%%%%%%%||||||||||||||||||||--||||||||||||||||||||----------|||||||||---|||||||||||||||||||||||||||||||||||||||||||||||||||||||||||
||||||||||||||||||--|||||||||---||||||||||||||||XXX--XXX|||---|||||||||||||||||||||||||||||||||||--||||||||||||||||||||XXXXXXXXXX|||||||||---|||||||||||||||||||||||||||||||||||||||||||||||||||||||||||
