--------------------------------------------------------------------------------------------------------------------------------------------------------------------------------------------------------
--------------------------------------------------------------------------------------------------------------------------------------------------------------------------------------------------------
--------------------------------------------------------------------------------------------------------------------------------------------------------------------------------------------------------
--------------------------------------------------------------------------------------------------------------------------------------------------------------------------------------------------------
--------------------------------------------------------------------------------------------------------------------------------------------------------------------------------------------------------
--------------------------------------------------------------------------------------------------------------------------------------------------------------------------------------------------------
--------------------------------------------------------------------------------------------------------------------------------------------------------------------------------------------------------
--------------------------------------------------------------------------------------------------------------------------------------------------------------------------------------------------------
------------------------------------------------------------------------------------------------------------------------SCU-----------------------------------------------------------------------------
------------tt---------------------------------------------------------------------2SS------------------------------------------------------------------------------------------------------------------
------------tt----------#---#------------------------------------------------------------------------------------------------------Tt-tt-tt-------------------------------------------------------------
------------tt---------##---##--------------------------------#--#------------------------------Tt-Tt------%%%%%%------g--G--------tt-tt-tt-------------------------------------------------------------
%%%%%%%%%%%%%%%%-----%%%%---%%%%----------------------------%%%--%%%%%%%%---%%%%%---y-----------tt-tt------||||||-----%%%%%%-------tt-tt-tt-------------------------------------------------------------
||||||||||||||||%%%%%||||---||||%%--%%----------------------|||--||||||||---|||||%%%%%%%%%%%%%--tt-tt------||||||-----||K|||---%%%%%%%%%%%%%------------------------------------------------------------
|||||||||||||||||||||||||---||||||--||--#---#--%%%%%---%%%%%|||--||||||||---||||||||||||||||||%%%%%%%%-----|||kg|-k--%%%%%%%%%%|||||||||||||%%%%%%%%F%%%%%%%%%%%%%%%%%%%%%%%%%%%%%%%%%%%%%%%%%%%%%%%%%%%
|||||||||||||||||||||||||---||||||--||XXX---XXX|||||---||||||||--||||||||---||||||||||||||||||||||||||XXXXXXXXXXXXXXX|||||||||||||||||||||||||||||||X|||||||||||||||||||||||||||||||||||||||||||||||||||
