--------------------------------------------------------------------------------------------------------------------------------------------------------------------------------------------------------
--------------------------------------------------------------------------------------------------------------------------------------------------------------------------------------------------------
--------------------------------------------------------------------------------------------------------------------------------------------------------------------------------------------------------
--------------------------------------------------------------------------------------------------------------------------------------------------------------------------------------------------------
--------------------------------------------------------------------------------------------------------------------------------------------------------------------------------------------------------
--------------------------------------------------------------------------------------------------------------------------------------------------------------------------------------------------------
--------------------------------------------------------------------------------------------------------------------------------------------------------------------------------------------------------
----------------------------------------------------------------------------------------------------------------------------BB--------------------------------------------------------------------------
--------------------------------------------------------------------------------22CB2C------------------------------------------------------------------------------------------------------------------
-------------------------------%%%---------------------CCB-----------------------------------------------------------------X----------------------------------------------------------------------------
-------------------------------|||--------------------------------------------------------------------------------------------g-------------------------------------------------------------------------
-------------------------------|||----%%%%-------------------------------------------k-------------------------------------%%%%%%-----------------------------------------------------------------------
-------------------------------|||----||||--------------Gk----%%%--%%%%%%--%%%%%%%%%%%%%%------------------#---#-----------||||||-----------------------------------------------------------------------
------------%%%%---%%%%%%--%%--|||----||||------------%%%%----|||--||||||--||||||||||||||-----------%%%---##---##----------r|||||----------%%%%%%%%F%%%%%%%%%%%%%%%%%%%%%%%%%%%%%%%%%%%%%%%%%%%%%%%%%%%%
%%%%%%%%%%%%||||---||||||--||--|||---K|||y------g-----||||----|||--||||||--||||||||||||||-----------|||--###---###--%%%%%%%%%%%%%%%--------||||||||X||||||||||||||||||||||||||||||||||||||||||||||||||||
||||||||||||||||---||||||--||%%%%%%%%%%%%%%%%%%%%%%%%%%%%%%%%%|||--||||||--||||||||||||||%%%%---%%%%|||%%%%%---%%%%%|||||||||||||||%%%--%%%||||||||X||||||||||||||||||||||||||||||||||||||||||||||||||||
