--------------------------------------------------------------------------------------------------------------------------------------------------------------------------------------------------------
--------------------------------------------------------------------------------------------------------------------------------------------------------------------------------------------------------
--------------------------------------------------------------------------------------------------------------------------------------------------------------------------------------------------------
--------------------------------------------------------------------------------------------------------------------------------------------------------------------------------------------------------
--------------------------------------------------------------------------------------------------------------------------------------------------------------------------------------------------------
--------------------------------------------------------------------------------------------------------------------------------------------------------------------------------------------------------
--------------------------------------------------------------------------------------------------------------------------------------------------------------------------------------------------------
--------------------------------------------------------------------------------------------------------------------------------------------------------------------------------------------------------
--------------------------------------------------------------------------------------------------------------------------------------------------------------------------------------------------------
--------------------------------------------------------------------------------------------------------------------------------------------------------------------------------------------------------
--------------------------------------------------------------------------------------------------------------------------------------------------------------------------------------------------------
--------------------------------------tt----------------------------------------------------------------------------------------------U2S---------------------------------------------------------------
%%%%%%%%%%--------------------%%%%----tt-----#--#----------------------------------------------------------------%%%%%----#--#------------%%%%%%%%F%%%%%%%%%%%%%%%%%%%%%%%%%%%%%%%%%%%%%%%%%%%%%%%%%%%%%
||||||||||%%%%%%%-------------||||----tt----##--##-----#--#-----------%%%---%%%----------%%--%%%%%%--%%%%--------|||||---##--##-----------||||||||%|||||||||||||||||||||||||||||||||||||||||||||||||||||
|||||||||||||||||-------%%--%%||||%%%%%%%--###--###--%%%--%%%--#---#--|||---|||%%%%--%%%%||--||||||--||||--------|||||--###--###------g---||||||||||||||||||||||||||||||||||||||||||||||||||||||||||||||
|||||||||||||||||XX---XX||--|||||||||||||XXXXX--XXXXX|||--|||XXX---XXX|||---|||||||--||||||--||||||--||||XXX--XXX|||||XXXXX--XXXXXXXXXXXXX||||||||||||||||||||||||||||||||||||||||||||||||||||||||||||||
