--------------------------------------------------------------------------------------------------------------------------------------------------------------------------------------------------------
--------------------------------------------------------------------------------------------------------------------------------------------------------------------------------------------------------
--------------------------------------------------------------------------------------------------------------------------------------------------------------------------------------------------------
--------------------------------------------------------------------------------------------------------------------------------------------------------------------------------------------------------
--------------------------------------------------------------------------------------------------------------------------------------------------------------------------------------------------------
--------------------------------------------------------------------------------------------------------------------------------------------------------------------------------------------------------
--------------------------------------------------------------------------------------------------------------------------------------------------------------------------------------------------------
--------------------------------------------------------------------------------------------------------------------------------------------------------------------------------------------------------
---------------------BB-U-------------------------------------------------------------------------------------------------------------------------------------------------------------------------------
-----------------------------------------------------------------------------------tt-------------------------------------------------------------------------------------------------------------------
-----------------------X---------r-------------------------------------------------tt-------------------------------------------------------------------------------------------------------------------
---------------------g--------%%%%%%-----------------------------------------------tt-------------------------------------------------------------------------------------------------------------------
--------------------%%%%%%%---||||||----%%---%%--------------------------------%%%%%%%%%%%%---%%%%%-------------------r---------------%%%--%%%----------------------------------------------------------
%%%%%%%%%%%%%%---%%%|||||||---||||||----||---||------------------------#---#---||||||||||||---|||||---#---#------%%%%%%%%%%--%%%------|||--|||----------------------------------------------------------
||||||||||||||---||||||||||---|y||||----||---||-----------------------##---##--||||||||||||---|||||--##---##--%%%||||||||||--|||------|||--|||----------------------------------------------------------
||||||||||||||---||||||||||%%%%%%%%%%%%%||---||%%--%%%%%%--%%%%%%%%%%%%%---%%%%||||||||||||---|||||%%%%---%%%%|||||||||||||--|||%%--%%|||--|||%%%%%%%%F%%%%%%%%%%%%%%%%%%%%%%%%%%%%%%%%%%%%%%%%%%%%%%%%%
