--------------------------------------------------------------------------------------------------------------------------------------------------------------------------------------------------------
--------------------------------------------------------------------------------------------------------------------------------------------------------------------------------------------------------
--------------------------------------------------------------------------------------------------------------------------------------------------------------------------------------------------------
--------------------------------------------------------------------------------------------------------------------------------------------------------------------------------------------------------
--------------------------------------------------------------------------------------------------------------------------------------------------------------------------------------------------------
--------------------------------------------------------------------------------------------------------------------------------------------------------------------------------------------------------
--------------------------------------------------------------------------------------------------------------------------------------------------------------------------------------------------------
--------------------------------------------------------------------------------------------------------------------------------------------------------------------------------------------------------
--------------------------------------------------------------------------------------------------------------------------------------------------------------------------------------------------------
--------------------------------------------------------------------------------------------------------------------------------------------------------------------------------------------------------
----------------------------------------------------------------#--#------------------------------------------------------------------------------------------------------------------------------------
------------------------#--#-----------------------------------##--##-----------------------------------------------------------------------------------------------------------------------------------
%%%%%%%%%%%-----------%%%--%%%---------------------%%%---%%%--###--###----------------------------%%%---%%%-----------------------%%---%%---------------------------------------------------------------
|||||||||||---#---#---|||--|||---------------------|||---|||%%%%%--%%%%%--#---#--%%%--%%%----tt---|||---|||%%%--------------#--#--||---||---------------------------------------------------------------
|||||||||||--##---##--|||--|||%%%--%%%-------------|||---||||||||--|||||%%%---%%%|||--|||----tt---|||---||||||%%%%%--%%%%%%%%--%%%||---||%%%%%%%%F%%%%%%%%%%%%%%%%%%%%%%%%%%%%%%%%%%%%%%%%%%%%%%%%%%%%%%
|||||||||||XXXX---XXXX|||--||||||--|||XXXXX---XXXXX|||---||||||||--||||||||---||||||--|||XXXXXXXXX|||---|||||||||||--||||||||--|||||---||||||||||X||||||||||||||||||||||||||||||||||||||||||||||||||||||
