--------------------------------------------------------------------------------------------------------------------------------------------------------------------------------------------------------
--------------------------------------------------------------------------------------------------------------------------------------------------------------------------------------------------------
--------------------------------------------------------------------------------------------------------------------------------------------------------------------------------------------------------
--------------------------------------------------------------------------------------------------------------------------------------------------------------------------------------------------------
--------------------------------------------------------------------------------------------------------------------------------------------------------------------------------------------------------
--------------------------------------------------------------------------------------------------------------------------------------------------------------------------------------------------------
--------------------------------------------------------------------------------------------------------------------------------------------------------------------------------------------------------
--------------------------------------------------------------------------------------------------------------------------------------------------------------------------------------------------------
--------------------------------------------------------------------------------------------------------------------------------------------------------------------------------------------------------
--------------------------------------------------------------------------------------------------------------------------------------------------------------------------------------------------------
--------------------------------------------------------------------------------------------------------------------------------------------------------------------------------------------------------
----------------------------------------------------------------#--#---------------2CS------y---------------k-g-----------------------------------------------------------------------------------------
-------------------%%---%%%%%%%--%%%%%--------------------%%%--##--##--%%%%---------------%%%%%%%%%%%%---%%%%%%%%%--------------------------------------------------------------------------------------
-------------------||---|||||||--|||||--------%%%%%--%%%%%|||%%%%--%%%%||||%%%%%%%--------||||||||||||---|||||||||--------------------------------------------------------------------------------------
%%%%%%%%%%%--------||---|||||||--|||||--------|||||--||||||||||||--|||||||||||||||--------||||||||||||---|||||||||---------%%%%%--%%%%%-----------------------------------------------------------------
|||||||||||XX--XXXX||---|||||||--|||||XXX--XXX|||||--||||||||||||--|||||||||||||||XXXXXXXX||||||||||||---|||||||||XXX---XXX|||||--|||||XXXXXXXXXXXFXXXXXXXXXXXXXXXXXXXXXXXXXXXXXXXXXXXXXXXXXXXXXXXXXXXXX
