--------------------------------------------------------------------------------------------------------------------------------------------------------------------------------------------------------
--------------------------------------------------------------------------------------------------------------------------------------------------------------------------------------------------------
--------------------------------------------------------------------------------------------------------------------------------------------------------------------------------------------------------
--------------------------------------------------------------------------------------------------------------------------------------------------------------------------------------------------------
--------------------------------------------------------------------------------------------------------------------------------------------------------------------------------------------------------
--------------------------------------------------------------------------------------------------------------------------------------------------------------------------------------------------------
--------------------------------------------------------------------------------------------------------------------------------------------------------------------------------------------------------
--------------------------------------------------------------------------------------------------------------------------------------------------------------------------------------------------------
-------------------------------------------------------------------------------------------------------------SCSS---------------------------------------------------------------------------------------
--------------------------------------------------------------------------------------------------------------------------Tt----------------------------------------------------------------------------
---------------------------------------------------------------------------%%%%%------------------------------------------tt----------------------------------------------------------------------------
-------------------------y------------------------------------------Tt-----|||||------------------------------------------tt----------------------------------------------------------------------------
%%%%%%%%%%------------%%%%%%----------%%--%%--%%%%%%----------------tt-----|||||----------%%---%%%%%%---%%%%%%%%%%------%%%%%%%%%%%---%%%%--------------------------------------------------------------
||||||||||%%%%%--%%%%%||||||----------||--||-K||||||--%%%%%---%%%%%%%%%%-y-|||||----------||---||||||---||||||||||------|||||||||||---||||--------------------------------------------------------------
|||||||||||||||--|||||||||||%%%%%%%%%%||--||%%%%%%%%%%|||||---||||||||||%%%%%%%%%%%%%--%%%||---||||||---||||||||||%%--%%|||||||||||---||||--------------------------------------------------------------
|||||||||||||||--|||||||||||||||||||||||--|||||||||||||||||---|||||||||||||||||||||||--|||||---||||||---||||||||||||--|||||||||||||---||||XXXXXXXXFXXXXXXXXXXXXXXXXXXXXXXXXXXXXXXXXXXXXXXXXXXXXXXXXXXXXX
