--------------------------------------------------------------------------------------------------------------------------------------------------------------------------------------------------------
--------------------------------------------------------------------------------------------------------------------------------------------------------------------------------------------------------
--------------------------------------------------------------------------------------------------------------------------------------------------------------------------------------------------------
--------------------------------------------------------------------------------------------------------------------------------------------------------------------------------------------------------
--------------------------------------------------------------------------------------------------------------------------------------------------------------------------------------------------------
--------------------------------------------------------------------------------------------------------------------------------------------------------------------------------------------------------
--------------------------------------------------------------------------------------------------------------------------------------------------------------------------------------------------------
--------------------------------------------------------------------------------------------------------------------------------------------------------------------------------------------------------
--------------------------------------------22S---------------------------------------------------------------------------------------------------------------------------------------------------------
--------------------------------------------------------------------------------------------------------------------------------------------------------------------------------------------------------
--------------------------------------------------------------------------------------------------------------------------------------------------------------------------------------------------------
-------------------------------------------y------------------------------------------#--#-------U-22SSS----#--#-------#---#----------------------------------------------------------------------------
-----------%%%%%%%%%%%-------------------%%%%%%%-------------------------------------##--##----------------##--##-----##---##---------------%%%%%%%%F%%%%%%%%%%%%%%%%%%%%%%%%%%%%%%%%%%%%%%%%%%%%%%%%%%%
%%%%%%%%%%%|||||||||||-------------%%--%%|||||||----------%%-----------%%---%%%%%%--###--###------%------%%%%--%%%%--###---###--------------||||||||%|||||||||||||||||||||||||||||||||||||||||||||||||||
||||||||||||||||||||||%%%%%---%%%%%||--|||||||||----------||%%%%---%%%%||---||||||%%%%%--%%%%%----|----k-||||--||||%%%%%---%%%%%%%%%%--%%%%%||||||||||||||||||||||||||||||||||||||||||||||||||||||||||||
|||||||||||||||||||||||||||---|||||||--|||||||||XXXX--XXXX||||||---||||||---|||||||||||--|||||XXXXXXXXXXX||||--|||||||||---||||||||||--|||||||||||||||||||||||||||||||||||||||||||||||||||||||||||||||||
