--------------------------------------------------------------------------------------------------------------------------------------------------------------------------------------------------------
--------------------------------------------------------------------------------------------------------------------------------------------------------------------------------------------------------
--------------------------------------------------------------------------------------------------------------------------------------------------------------------------------------------------------
--------------------------------------------------------------------------------------------------------------------------------------------------------------------------------------------------------
--------------------------------------------------------------------------------------------------------------------------------------------------------------------------------------------------------
--------------------------------------------------------------------------------------------------------------------------------------------------------------------------------------------------------
--------------------------------------------------------------------------------------------------------------------------------------------------------------------------------------------------------
--------------------------------------------------------------------------------------------------------------------------------------------------------------------------------------------------------
--------------------------------------------------------------------------------------------------------------------------------------------------------------------------------------------------------
-----------------------------------------------------------------------Tt-------------------------------------------------------------------------------------------------------------------------------
-----------------------------------------------------------------------tt-------------------------------------------------------------------------------------------------------------------------------
----------------------#---#------------------%%%%--------#--#----------tt-------------------------------------------------------------------------------------------------------------------------------
----------%%%--%%%---##---##-----------------||||------%%%--%%%-------%%%%%%%%---------------------------------%%%%--%%%%-------------------------------------------------------------------------------
----------|||--|||--###---###--%%%%---%%%%-g-||||------|||--|||-------||||||||----------------%%---%%----------||||--||||%%%%--%%%%---------------------------------------------------------------------
%%%%%%%%%%|||--|||%%%%%---%%%%%||||---||||%%%%%%%%%%%%%|||--|||-------||||||||----------#--#--||---||----------||||--||||||||--||||%%%%--%%%%%%%%%%%%F%%%%%%%%%%%%%%%%%%%%%%%%%%%%%%%%%%%%%%%%%%%%%%%%%%
|||||||||||||--||||||||---|||||||||---||||||||||||||||||||--|||XX---XX||||||||XXXXXXXXXXX--XXX||---||XXXX--XXXX||||--||||||||--||||||||--||||||||||||X||||||||||||||||||||||||||||||||||||||||||||||||||
