--------------------------------------------------------------------------------------------------------------------------------------------------------------------------------------------------------
--------------------------------------------------------------------------------------------------------------------------------------------------------------------------------------------------------
--------------------------------------------------------------------------------------------------------------------------------------------------------------------------------------------------------
--------------------------------------------------------------------------------------------------------------------------------------------------------------------------------------------------------
--------------------------------------------------------------------------------------------------------------------------------------------------------------------------------------------------------
--------------------------------------------------------------------------------------------------------------------------------------------------------------------------------------------------------
--------------------------------------------------------------------------------------------------------------------------------------------------------------------------------------------------------
--------------------------------------------------------------------------------------------------------------------------------------------------------------------------------------------------------
--------------------------------------------------------------------------------------------------------------------------------------------------------------------------------------------------------
---------------------------SSSCS------------------------------------------------------------------------------------------------------------------------------------------------------------------------
--------------------------------------------------------------------------------------------------------------------------------------------------------------------------------------------------------
-------------------------------------------------------------------------------------------------------%%%%%--------------------------------------------------------------------------------------------
------------------------------y--------------------------------------------------#--#------------------|||||-----------#---#----------------------------------------------------------------------------
-----------%%--%%---------%%%%%%%------------------------------------------%%---##--##-----------------|||||----------##---##-----#--#------------------------------------------------------------------
%%%%%%%%%%%||--||%%%---%%%|||||||--------------%%%%%---%%%%%%%--%%---------||--###--###--%%%%%%%%%%-y--|||||-----Y---###---###--%%%--%%%%%%%%%%%F%%%%%%%%%%%%%%%%%%%%%%%%%%%%%%%%%%%%%%%%%%%%%%%%%%%%%%%
|||||||||||||--|||||---||||||||||XX--XXXXX--XXX|||||---|||||||--||XXX---XXX||XXXXX--XXXXX||||||||||XXXXXXXXXXXXXXXXXXXXX---XXXXX|||--|||||||||||X|||||||||||||||||||||||||||||||||||||||||||||||||||||||
