--------------------------------------------------------------------------------------------------------------------------------------------------------------------------------------------------------
--------------------------------------------------------------------------------------------------------------------------------------------------------------------------------------------------------
--------------------------------------------------------------------------------------------------------------------------------------------------------------------------------------------------------
--------------------------------------------------------------------------------------------------------------------------------------------------------------------------------------------------------
--------------------------------------------------------------------------------------------------------------------------------------------------------------------------------------------------------
-----------------------%%%%%----------------------------------------------------------------------------------------------------------------------------------------------------------------------------
-----------------------|||||----------------------------------------------------------------------------------------------------------------------------------------------------------------------------
-----------------------|||||----------------------------------------------------------------------------------------------------------------------------------------------------------------------------
-----------------------|||||---------------------------%%%----------------------------------------------------------------------------------------------------------------------------------------------
-----------------------|||||-----%%%-------------------|||----------------------------------------------------------------------------------------------------------------------------------------------
-----------------------|||||-----|||-------------------|||--------------------------------------------------SCS-----------------------------------------------------------------------------------------
---------------------g-|k|||---G-||k-------------------|||-r-------------------------------------------------------CSCC---------------------------------------------------------------------------------
--------------------%%%%%%%%%%%%%%%%%%%-------------%%%%%%%%%%%%%%%%%%--%%%----------------------------------------------%%%%%---%%%%%------------------------------------------------------------------
-------------%%---%%|||||||||||||||||||%%%%%---%%%%%||||||||||||||||||--|||%%%%--%%%%%%%%%%%------------------r----------|||||---|||||------------------------------------------------------------------
-------------||---||||||||||||||||||||||||||---|||||||||||||||||||||||--|||||||--|||||||||||------------%%%%%%%%%-y------|||||---|||||------------------------------------------------------------------
XXXXXXXXXXXXX||---||||||||||||||||||||||||||---|||||||||||||||||||||||--|||||||--|||||||||||XXXXX--XXXXX|||||||||XXXXXXXX|||||---|||||XXXXXXXXXXXXXXXXXFXXXXXXXXXXXXXXXXXXXXXXXXXXXXXXXXXXXXXXXXXXXXXXXX
