--------------------------------------------------------------------------------------------------------------------------------------------------------------------------------------------------------
--------------------------------------------------------------------------------------------------------------------------------------------------------------------------------------------------------
--------------------------------------------------------------------------------------------------------------------------------------------------------------------------------------------------------
--------------------------------------------------------------------------------------------------------------------------------------------------------------------------------------------------------
--------------------------------------------------------------------------------------------------------------------------------------------------------------------------------------------------------
--------------------------------------------------------------------------------------------------------------------------------------------------------------------------------------------------------
--------------------------------------------------------------------------------------------------------------------------------------------------------------------------------------------------------
--------------------------------------------------------------------------------------------------------------------------------------------------------------------------------------------------------
----------------------------------------------------------------%%%%%-----------------------------------------------------------------------------------------------------------------------------------
--------------#---#---------------------------------------------|||||-----------------------------------------------------------------------------------------------------------------------------------
-------------##---##------SSCSSS--------------------------------|||||-----------------------------------------------------------------------------------------------------------------------------------
------------###---###---------------------------#---#-----------|||||-----------------------------------------------------------------------------------------------------------------------------------
----------%%%%%---%%%%%------------------------##---##--------%%%%%%|-----------------%%----------------------------------------------------------------------------------------------------------------
----------|||||---|||||----------%%%%---%%%%--###---###-------||||g||-y------%%%---%%%||%%%%---%%%%-------------%%%%%%%---------------------------------------------------------------------------------
%%%%%%%%%%|||||---|||||%%%%%%%%%%||||---||||%%%%%---%%%%%%%%%%%%%%%%%%%%%%%%%|||---|||||||||---||||-------------|||||||%%%%--%%%%-------%%%%%%%%F%%%%%%%%%%%%%%%%%%%%%%%%%%%%%%%%%%%%%%%%%%%%%%%%%%%%%%%
|||||||||||||||---|||||||||||||||||||---|||||||||---||||||||||||||||||||||||||||---|||||||||---||||XXXXX---XXXXX|||||||||||--||||XX---XX||||||||X|||||||||||||||||||||||||||||||||||||||||||||||||||||||
