--------------------------------------------------------------------------------------------------------------------------------------------------------------------------------------------------------
--------------------------------------------------------------------------------------------------------------------------------------------------------------------------------------------------------
--------------------------------------------------------------------------------------------------------------------------------------------------------------------------------------------------------
--------------------------------------------------------------------------------------------------------------------------------------------------------------------------------------------------------
--------------------------------------------------------------------------------------------------------------------------------------------------------------------------------------------------------
---------------------------------------------------------------------------------------------------------------------------G----------------------------------------------------------------------------
--------------------------------------------------------------------------------------------------g-----------------------%%%%--------------------------------------------------------------------------
------------------------------------------------------------------------------------------------%%%-----------------------||||--------------------------------------------------------------------------
-------------------------------------------------------CBBU-------------------------------------|||---------------------r-y|||--------------------------------------------------------------------------
------------------------------------------------------------------------%%%%%----------------%%%%%|--------------------%%%%%||--------------------------------------------------------------------------
----------------------kr------------------------------------------------|||||----------------||||||--------------------|||||||--------------------------------------------------------------------------
---------------------%%%%%--------------------------------r-------------|||||----------------||||||--------------------|||||||--------------------------------------------------------------------------
---------------------|||||-----%%%--%%%%%%%%%--------%%%%%%%%%----------||%%%%%%-----gr--k---||||r|-g------------------||g||||----y----y-%%%%%%%%F%%%%%%%%%%%%%%%%%%%%%%%%%%%%%%%%%%%%%%%%%%%%%%%%%%%%%%
----------%%---%%%%%%%%%%%%%%%%|||--|||||||||%%%--%%%|||||||||%%--%%---y|||r||||---%%%%%%%%%%%%%%%%%%%%%--%%---%%---%%%%%%%%%%%%%%%%%%%%%||||||||X||||||||||||||||||||||||||||||||||||||||||||||||||||||
%%%%%%%%%%||---|||||||||||||||||||--||||||||||||--||||||||||||||--||%%%%%%%%%%%%%%%|||||||||||||||||||||--||---||---|||||||||||||||||||||||||||||X||||||||||||||||||||||||||||||||||||||||||||||||||||||
||||||||||||---|||||||||||||||||||--||||||||||||--||||||||||||||--||||||||||||||||||||||||||||||||||||||--||%%%||---|||||||||||||||||||||||||||||X||||||||||||||||||||||||||||||||||||||||||||||||||||||
