--------------------------------------------------------------------------------------------------------------------------------------------------------------------------------------------------------
--------------------------------------------------------------------------------------------------------------------------------------------------------------------------------------------------------
--------------------------------------------------------------------------------------------------------------------------------------------------------------------------------------------------------
--------------------------------------------------------------------------------------------------------------------------------------------------------------------------------------------------------
--------------------------------------------------------------------------------------------------------------------------------------------------------------------------------------------------------
--------------------------------------------------------------------------------------------------------------------------------------------------------------------------------------------------------
--------------------------------------------------------------------------------------------------------------------------------------------------------------------------------------------------------
-----------------------------------------------K--------------------------------------------------------------------------------------------------------------------------------------------------------
-------------------------------------------%%%%%------gg-r----------------------------------------------------------------------------------------------------------------------------------------------
-------------------------------------------|||||------%%%%%%%--------------------------------------------------------------#--#-------------------------------------------------------------------------
-------------------------------------------|||||------|||||||-------------------------------------------------------------##--##------------------------------------------------------------------------
---------------------------#---#---k---k---k||||------|||||||------------------------------------------#--#--------------###--###-----------------------------------------------------------------------
-----------%%%%%---------%%%---%%%%%%%%%%%%%%%%%%%%%%-||%%%%|-----------------------------------------##--##---%%%--%%%%%%%%--%%%%%---------------------------------------------------------------------
-----------|||||---------|||---||||||||||||||||||||||-|||||||--------------%%%%---%%%%---------------###--###--|||--||||||||--|||||--------%%%%%%%%F%%%%%%%%%%%%%%%%%%%%%%%%%%%%%%%%%%%%%%%%%%%%%%%%%%%%
%%%%%%%%%%%|||||---------|||---||||||||||||||||||||||-y||||||--%%%%%--%%%%%||||---||||%%%%%---%%%%%%%%%%--%%%%%|||--||||||||--|||||%%------||||||||%||||||||||||||||||||||||||||||||||||||||||||||||||||
||||||||||||||||XXX---XXX|||---||||||||||||||||||||||XXXXXXXXXX|||||--|||||||||---|||||||||---||||||||||--||||||||--||||||||--|||||||XXXXXX|||||||||||||||||||||||||||||||||||||||||||||||||||||||||||||
