--------------------------------------------------------------------------------------------------------------------------------------------------------------------------------------------------------
--------------------------------------------------------------------------------------------------------------------------------------------------------------------------------------------------------
--------------------------------------------------------------------------------------------------------------------------------------------------------------------------------------------------------
--------------------------------------------------------------------------------------------------------------------------------------------------------------------------------------------------------
--------------------------------------------------------------------------------------------------------------------------------------------------------------------------------------------------------
--------------------------------------------------------------------------------------------------------------------------------------------------------------------------------------------------------
--------------------------------------------------------------------------------------------------------------------------------------------------------------------------------------------------------
--------------------------------------------------------------------------------------------------------------------------------------------------------------------------------------------------------
--------------------------------------------------------------------------------------------------------------------------------------------------------------------------------------------------------
-----------------------------------------------------------------------------------------------------------------------------------------------%%%------------------------------------------------------
-----------------------------------------------------------------------------------------------------------------------------------------------|||------------------------------------------------------
-----------B2CUBCBB2------------------------------------------------------------------------BCBC-----------------------------------------------|||------------------------------------------------------
-----------------------------------------%%%%%--%%%%%-----------#--#---------------------------------------------------------------------------Y||------------------------------------------------------
-----------------------------------------|||||--|||||---------%%%--%%%%%%%---%%%%----------------------------------------#---#---%%%%%%%%%%%%%%%%%%%%---------------------------------------------------
%%%%%%%%%%--kr-------%%%%---%%%%--#---#--|||||--|||||%%%---%%%|||--|||||||---||||------------------%%%%%---%%%%%--------##---##--||||||||||||||||||||%%%%%%%%F%%%%%%%%%%%%%%%%%%%%%%%%%%%%%%%%%%%%%%%%%%
||||||||||%%%%%%%%%%%||||---||||%%%---%%%|||||--||||||||---||||||--|||||||---||||%%%--%%%%%%%%%%%%%|||||---|||||%%%%%%%%%%---%%%%||||||||||||||||||||||||||||X||||||||||||||||||||||||||||||||||||||||||
