--------------------------------------------------------------------------------------------------------------------------------------------------------------------------------------------------------
--------------------------------------------------------------------------------------------------------------------------------------------------------------------------------------------------------
--------------------------------------------------------------------------------------------------------------------------------------------------------------------------------------------------------
--------------------------------------------------------------------------------------------------------------------------------------------------------------------------------------------------------
--------------------------------------------------------------------------------------------------------------------------------------------------------------------------------------------------------
--------------------------------------------------------------------------------------------------------------------------------------------------------------------------------------------------------
--------------------------------------------------------------------------------------------------------------------------------------------------------------------------------------------------------
--------------------------------------------------------------------------------------------------------------------------------------------------------------------------------------------------------
------------------------%%%%----------------------------------------------------------------------------------------------------------------------------------------------------------------------------
------------------------||||----------------------------------------------------------------------------------------------------------------------------------------------------------------------------
-----------------CSS----|||%%%%-------------------#---#------------------------------------------------------------------%%%----------------------------------------------------------------------------
------------------------|||||||------------------##---##-----------------------------------#--#--------------------------|||----------------------------------------------------------------------------
%%%%%%%%%%%%%-----------|||||||g----------------###---###--%%%---%%%-----%%%--%%%---------##--##--%%%%%---%%%%%----------|||----------------------------------------------------------------------------
|||||||||||||-------g--%%%%%%%%%%%%-----------%%%%%---%%%%%|||---|||-----|||--|||-------%%%%--%%%%|||||---|||||----------|||----y----#--#--%%%%%%%%F%%%%%%%%%%%%%%%%%%%%%%%%%%%%%%%%%%%%%%%%%%%%%%%%%%%%
|||||||||||||%%%%%%%%%%||||||||||||-----------|||||---||||||||---|||-----|||--|||-------||||--|||||||||---|||||--#---#--%%%%%%%%%%%%%%--%%%||||||||%||||||||||||||||||||||||||||||||||||||||||||||||||||
|||||||||||||||||||||||||||||||||||XXXXX---XXX|||||---||||||||---|||XXXXX|||--|||XX---XX||||--|||||||||---|||||XXX---XXX||||||||||||||--||||||||||||||||||||||||||||||||||||||||||||||||||||||||||||||||
