--------------------------------------------------------------------------------------------------------------------------------------------------------------------------------------------------------
--------------------------------------------------------------------------------------------------------------------------------------------------------------------------------------------------------
--------------------------------------------------------------------------------------------------------------------------------------------------------------------------------------------------------
--------------------------------------------------------------------------------------------------------------------------------------------------------------------------------------------------------
--------------------------------------------------------------------------------------------------------------------------------------------------------------------------------------------------------
--------------------------------------------------------------------------------------------------------------------------------------------------------------------------------------------------------
--------------------------------------------------------------------------------------------------------------------------------------------------------------------------------------------------------
--------------------------------------------------------------------------------------------------------------------------------------------------------------------------------------------------------
--------------------------------------------------------------------------------------------------------------------------------------------------------------------------------------------------------
--------------------------------------------------------------------------------------------------------------------------------------------------------------------------------------------------------
---------------------#--#----------------------------tt-------------------------------------------------------------------------------------------------------------------------------------------------
--------------------##--##---------------------------tt-------------------------------------------------------------------------------------------------------------------------------------------------
%%%%%%%%%%%%%--%%--###--###------------------------%%%%%%%-----------------------------------------------------------%%%%---%%%%---------#---#---%%%%%%%%F%%%%%%%%%%%%%%%%%%%%%%%%%%%%%%%%%%%%%%%%%%%%%%
|||||||||||||--||%%%%%--%%%%%--tt--tt--------------|||||||%%---%%%%%%%--%%%%%------------%%%%---%%%%%%%%%%%%%%---%%%%||||---||||--------##---##--||||||||X||||||||||||||||||||||||||||||||||||||||||||||
|||||||||||||--|||||||--|||||--tt--tt--------------|||||||||---|||||||--|||||------------||||---||||||||||||||---||||||||---||||%%--%%%%%%---%%%%||||||||X||||||||||||||||||||||||||||||||||||||||||||||
|||||||||||||--|||||||--|||||%%%%%%%%%%%%%%%--%%%%%|||||||||---|||||||--|||||%%%%%--%%%%%||||---||||||||||||||---||||||||---||||||--||||||---||||||||||||X||||||||||||||||||||||||||||||||||||||||||||||
