--------------------------------------------------------------------------------------------------------------------------------------------------------------------------------------------------------
--------------------------------------------------------------------------------------------------------------------------------------------------------------------------------------------------------
--------------------------------------------------------------------------------------------------------------------------------------------------------------------------------------------------------
--------------------------------------------------------------------------------------------------------------------------------------------------------------------------------------------------------
--------------------------------------------------------------------------------------------------------------------------------------------------------------------------------------------------------
--------------------------------------------------------------------------------------------------------------------------------------------------------------------------------------------------------
--------------------------------------------------------------------------------------------------------------------------------------------------------------------------------------------------------
--------------------------------------------------------------------------------------------------------------------------------------------------------------------------------------------------------
--------------------------------------------------------------------------------------------------------------------------------------------------------------------------------------------------------
--------------------------------------------------------------------------------------------------------------------------------------------------------------------------------------------------------
--------------------------------------------------------------------------------------------------------------------------------------------------------------------------------------------------------
--------------------------------------------------------------#--#--------------------------------------------------------------------------------------------------------------------------------------
---------------------------------------#---#----------------%%%--%%%------------------------------------------------------------------------------------------------------------------------------------
%%%%%%%%%%%%--------------------------##---##---%%--%%------|||--|||------%%%%---%%%%%%--%%-------------#--#--%%%---%%%---------------------------------------------------------------------------------
||||||||||||--#--#--%%%%%%%%%%%%%%%--###---###--||--||%%--%%|||--|||%%--%%||||---||||||--||-----------%%%--%%%|||---|||---------------%%%%---%%%%%%%%%%%%F%%%%%%%%%%%%%%%%%%%%%%%%%%%%%%%%%%%%%%%%%%%%%%
||||||||||||%%%--%%%|||||||||||||||%%%%%---%%%%%||--||||--|||||--|||||--||||||---||||||--||%%%%---%%%%|||--||||||---|||%%%%%%%---%%%%%||||---||||||||||||X||||||||||||||||||||||||||||||||||||||||||||||
