--------------------------------------------------------------------------------------------------------------------------------------------------------------------------------------------------------
--------------------------------------------------------------------------------------------------------------------------------------------------------------------------------------------------------
--------------------------------------------------------------------------------------------------------------------------------------------------------------------------------------------------------
--------------------------------------------------------------------------------------------------------------------------------------------------------------------------------------------------------
--------------------------------------------------------------------------------------------------------------------------------------------------------------------------------------------------------
--------------------------------------------------------------------------------------------------------------------------------------------------------------------------------------------------------
--------------------------------------------------------------------------------------------------------------------------------------------------------------------------------------------------------
--------------------------------------------------------------------------------------------------------------------------------------------------------------------------------------------------------
--------------------------------------------------------------------------------------------------------------------------------------------------------------------------------------------------------
--------------------------------------------------------------------------------------------------------------------------------------------------------------------------------------------------------
-----------------------------------------------------------------------------------------------------#---#----------------------------------------------------------------------------------------------
------------------------------------#--#------------------------------------------------------------##---##---------------------------------------------------------------------------------------------
-----------------------------------##--##-------------------------------------%%--%%%%%%%---%%%%%--###---###--------------%%%%%--%%%%%%%%%--------------------------------------------------------------
%%%%%%%%%%%%%--------------------%%%%--%%%%%%%%--%%%%-------------------------||--|||||||---|||||%%%%%---%%%%%------------|||||--|||||||||--------------------------------------------------------------
|||||||||||||-------%%%%%---%%%%%||||--||||||||--||||%%%%%---%%%%%------------||--|||||||---||||||||||---|||||------------|||||--|||||||||%%%%%%%%F%%%%%%%%%%%%%%%%%%%%%%%%%%%%%%%%%%%%%%%%%%%%%%%%%%%%%
|||||||||||||%%---%%|||||---|||||||||--||||||||--|||||||||---|||||%%%%%--%%%%%||--|||||||---||||||||||---|||||%%%%%--%%%%%|||||--|||||||||||||||||X|||||||||||||||||||||||||||||||||||||||||||||||||||||
