--------------------------------------------------------------------------------------------------------------------------------------------------------------------------------------------------------
--------------------------------------------------------------------------------------------------------------------------------------------------------------------------------------------------------
--------------------------------------------------------------------------------------------------------------------------------------------------------------------------------------------------------
--------------------------------------------------------------------------------------------------------------------------------------------------------------------------------------------------------
--------------------------------------------------------------------------------------------------------------------------------------------------------------------------------------------------------
--------------------------------------------------------------------------------------------------------------------------------------------------------------------------------------------------------
--------------------------------------------------------------------------------------------------------------------------------------------------------------------------------------------------------
--------------------------------------------------------------------------------------------------------------------------------------------------------------------------------------------------------
--------------------------------------------------------------------------------------------------------------------------------------------------------------------------------------------------------
--------------------------------------------------------------------------------------------------------------------------------------------------------------------------------------------------------
--------------------------------------------------------------------------------------------------------------------------------------------------------------------------------------------------------
--------------#--#--------------------------------------------------------------------------------------------------------------------------------------------------------------------------------------
-------------##--##------#---#-------------------------%%%---%%%----------------------------------------------------------------------------tt--tt------------------------------------------------------
-----------%%%%--%%%%---##---##---%%%%--%%%%--Tt-------|||---|||----------------------------------------%%%%--%%%%-----------------------tt-tt--tt------------------------------------------------------
-----------||||--||||--###---###--||||--||||--tt-%%--%%|||---|||------------%%--%%%%%%%--%%%%%----------||||--||||-----------------------tt-tt--tt-%%%%%%%%F%%%%%%%%%%%%%%%%%%%%%%%%%%%%%%%%%%%%%%%%%%%%
XXXXXXXXXXX||||--||||XXXXX---XXXXX||||--||||XXXXX||--|||||---|||XXXXX--XXXXX||--|||||||--|||||XXXX--XXXX||||--||||XXXXX--XXXXXXX---XXXXXXXXXXXXXXXX||||||||X||||||||||||||||||||||||||||||||||||||||||||
