--------------------------------------------------------------------------------------------------------------------------------------------------------------------------------------------------------
--------------------------------------------------------------------------------------------------------------------------------------------------------------------------------------------------------
--------------------------------------------------------------------------------------------------------------------------------------------------------------------------------------------------------
--------------------------------------------------------------------------------------------------------------------------------------------------------------------------------------------------------
-----------------------------------------------------------------------------------------------------------------------CCS------------------------------------------------------------------------------
--------------------------------------------------------------------------------------------------------------------------------------------------------------------------------------------------------
--------------------------------------------------------------------------------------------------------------------------------------------------------------------------------------------------------
----------------------------------------------------------------------------------------------------------------------g---r-----------------------------------------------------------------------------
----------------------------------------------------------------------------------------------------------------------%%%%%-----------------------------------------------------------------------------
------------------------------------------------------------------------Y---------------------------------------------|||||-----------------------------------------------------------------------------
----------------------------------------------------------------------%%%%%%-------------------------------SSS--------|||||-----------------------------------------------------------------------------
--------------------------rgr----------------------#---#--------------||||||------------------------------------------g||||-----------------------------------------------------------------------------
-----------------------%%%%%%%-------------------%%%---%%%----------%%%%%%%%%%----------#--#--------------------%%%%%%%%%%%%%-----------%%%%%%%%F%%%%%%%%%%%%%%%%%%%%%%%%%%%%%%%%%%%%%%%%%%%%%%%%%%%%%%%
-----------------------|||||||------g------------|||---|||%%%%%%----||||||||||--------%%%--%%%--#---#------y----|||||||||||||%%--%%%%%%%||||||||%|||||||||||||||||||||||||||||||||||||||||||||||||||||||
------------%%%%%%%---k|||||||----%%%%%%%--#--#--|||---|||||||||%%%%||||||||||%%%--%%%|||--|||%%%---%%%---%%%%%%|||||||||||||||--|||||||||||||||||||||||||||||||||||||||||||||||||||||||||||||||||||||||
XXXXXXXXXXXX|||||||XXXXXXXXXXXXXXX|||||||XXX--XXX|||---||||||||||||||||||||||||||--||||||--||||||---|||XXX|||||||||||||||||||||--|||||||||||||||||||||||||||||||||||||||||||||||||||||||||||||||||||||||
