--------------------------------------------------------------------------------------------------------------------------------------------------------------------------------------------------------
--------------------------------------------------------------------------------------------------------------------------------------------------------------------------------------------------------
--------------------------------------------------------------------------------------------------------------------------------------------------------------------------------------------------------
--------------------------------------------------------------------------------------------------------------------------------------------------------------------------------------------------------
--------------------------------------------------------------------------------------------------------------------------------------------------------------------------------------------------------
--------------------------------------------------------------------------------------------------------------------------------------------------------------------------------------------------------
--------------------------------------------------------------------------------------------------------------------------------------------------------------------------------------------------------
--------------------------------------------------------------------------------------------------------------------------------------------------------------------------------------------------------
--------------------------------------------------------------------------------------------------------------------------------------------------------------------------------------------------------
--------------------------------------------------------------------------------------------Yy----------------------------------------------------------------------------------------------------------
-----------------------------------------------------------------------------------------%%%%%%---------------------------------------------------------------------------------------------------------
----------------------------------------------#---#--------------------------------------|||||y---------------------------------------------------------------------------------------------------------
%%%%%%%%%%%%%%%%--%%%%-------------------k--%%%---%%%-------------------------%%%---%%%%%%%%%%%%%%%%%%%%%------------%%---%%----------------------------------------------------------------------------
||||||||||||||||--||||--------%%--%%%%%%%%%%|||---|||-------------------------|||---|||||||||||||||||||||%%--%%%%--%%||---||----------------------------------------------------------------------------
||||||||||||||||--||||--------||--|||||||||||||---|||%%%---%%%%%%%--%%%%------|||---|||||||||||||||||||||||--||||--||||---||%%%%%---%%%%%---------------------------------------------------------------
||||||||||||||||--||||XXX--XXX||--|||||||||||||---||||||---|||||||--||||XX--XX|||---|||||||||||||||||||||||--||||--||||---|||||||---|||||XXXXXXXXFXXXXXXXXXXXXXXXXXXXXXXXXXXXXXXXXXXXXXXXXXXXXXXXXXXXXXX
