--------------------------------------------------------------------------------------------------------------------------------------------------------------------------------------------------------
--------------------------------------------------------------------------------------------------------------------------------------------------------------------------------------------------------
--------------------------------------------------------------------------------------------------------------------------------------------------------------------------------------------------------
--------------------------------------------------------------------------------------------------------------------------------------------------------------------------------------------------------
--------------------------------------------------------------------------------------------------------------------------------------------------------------------------------------------------------
--------------------------------------------------------------------------------------------------------------------------------------------------------------------------------------------------------
--------------------------------------------------------------------------------------------------------------------------------------------------------------------------------------------------------
-------------------------------BBU2BB-------------------------------------------------------------------------------------------------------------------------------------------------------------------
--------------------------------------------------------------------------------------------------------------------------------------------------------------------------------------------------------
--------------------------------------------------------------------------------------------------------------------------------------------------------------------------------------------------------
--------------------------------r--g--------------------------------------------------------------------------------------------------------------------------------------------------------------------
-------------------------------%%%%%%--------------------#--#-----------------Tt-Tt---------------------------------------------------------------------------------------------------------------------
%%%%%%%%%%%%---%%%%%%---%%%%---||||||------------------%%%--%%%%%%%%--%%%%%---tt-tt------------------------------------------%%%%--%%%%-----------------------------------------------------------------
||||||||||||---||||||---||||---||||||------------------|||--||||||||--|||||%%%%%%%%%%%%%%----------%%%%%---%%%%%-------------||||--||||-----------------------------------------------------------------
||||||||||||---||||||---||||%%%%%%%%%%%%%%%------------|||--||||||||--|||||||||||||||||||----------|||||---|||||-------------||||--||||%%%%%%%%%--------------------------------------------------------
||||||||||||---||||||---|||||||||||||||||||%%%%%--%%%%%|||--||||||||--|||||||||||||||||||%%%%--%%%%|||||---|||||%%%%%---%%%%%||||--|||||||||||||%%%%%%%%F%%%%%%%%%%%%%%%%%%%%%%%%%%%%%%%%%%%%%%%%%%%%%%%
