--------------------------------------------------------------------------------------------------------------------------------------------------------------------------------------------------------
--------------------------------------------------------------------------------------------------------------------------------------------------------------------------------------------------------
--------------------------------------------------------------------------------------------------------------------------------------------------------------------------------------------------------
--------------------------------------------------------------------------------------------------------------------------------------------------------------------------------------------------------
--------------------------------------------------------------------------------------------------------------------------------------------------------------------------------------------------------
--------------------------------------------------------------------------------------------------------------------------------------------------------------------------------------------------------
--------------------------------------------------------------------------------------------------------------------------------------------------------------------------------------------------------
--------------------------------------------------------------------------------------------------------------------------------------------------------------------------------------------------------
----------------------------------------------------------------------------------------------%%%%%%----------------------------------------------------------------------------------------------------
---------------#--#---------------------------------------------------------------------------||||||----------------------------------------------------------------------------------------------------
--------------##--##--------------------------------------------------------------------------||||||-------BC22-B---------------------------------------------------------------------------------------
-------------###--###--------------------------------------------------------------#---#------|||||r----------------------------------------------------------------------------------------------------
-----------%%%%%--%%%%%%%%--%%%--------------%%%%---%%%%%%%%--%%%%----%%%---%%%---##---##---%%%%%%%%%%%--------X--------%%%%---%%%%-----------%%%%%%%%F%%%%%%%%%%%%%%%%%%%%%%%%%%%%%%%%%%%%%%%%%%%%%%%%%
-----------|||||--||||||||--|||%%%--%%%%%--%%||||---||||||||--||||----|||---|||--###---###--|||||||||||---------k-%%--%%||||---||||-----------||||||||X|||||||||||||||||||||||||||||||||||||||||||||||||
%%%%%%%%%%%|||||--||||||||--||||||--|||||--||||||---||||||||--||||%%%%|||---|||%%%%%---%%%%%|||||||||||%%%%%%%%%%%||--||||||---||||%%%%%%%%%%%||||||||X|||||||||||||||||||||||||||||||||||||||||||||||||
||||||||||||||||--||||||||--||||||--|||||--||||||---||||||||--|||||||||||---||||||||---|||||||||||||||||||||||||||||--||||||---|||||||||||||||||||||||X|||||||||||||||||||||||||||||||||||||||||||||||||
