--------------------------------------------------------------------------------------------------------------------------------------------------------------------------------------------------------
--------------------------------------------------------------------------------------------------------------------------------------------------------------------------------------------------------
--------------------------------------------------------------------------------------------------------------------------------------------------------------------------------------------------------
--------------------------------------------------------------------------------------------------------------------------------------------------------------------------------------------------------
------------------------------------#--#---------------------C------------------------------------------------------------------------------------------------------------------------------------------
---------------%%D----------------DDD--DDD--DDD--DDD-------------------------------------SS------*------------------------------------------------------------------------------------------------------
-------------y-||---------------------------------------------------------------C----------------*--tt--#-----------------------------------------------------------------------------------------------
------D--2S%%%%||%-U------y-C---g-----------------------g---------SSSSS22SS-----------r----------*--Tt--#--%%%%%%---------------C-----------------------------------------------------------------------
-----------|||||||---C--%%%%---------------tt---tt-----------SSS-------------------%%%%%%--------*--tt--#--||||||--------------------------------------------C---------------------*--------------------
SSSSS------|||||||------||||----------tt---Tt---Tt---------------------------------||||||%%%%--%%%%%%%DDDDD||||||------------------------------------------------------------------*--------------------
---------D-|DDD|||---r--|k||k---------tt---tt---tt--------g------g--------------%%%||||||||||--|||||||--D--||||||-----------------------------------------SS-------%%%%----%%------*--tt----------------
-----------|||||||%%%%%%||||%%---%%%%%%%%%%%%%%%%%%%%%---%%%%%%%%%%%%%%%%%%%%---|||||||||||||--|||||||-----||||||-------%%%%---%%%%--------------------------------||||----||------*--Tt----------------
%%%%-------|||||||||||||||||||---|||||||||||||||||||||---||||||||||||||||||||---|||||||||||||--|||||||--%%%%|||tt-------||||---||||---tt-----SSS---SS2SS-tt--%%%%%%||||%---||---%%%%%%%%%%%%------------
||||%%--%%%|||||||||||||||||||---|||||||||||||||||||||---||||||||||||||||||||---|||||||||||||--|||||||--|||||||tt-------||||---||||---tt------g------g---tt--|||||||||||---||---||||||||||||---%%F%%%%%%
||||||--||||||||||||||||||||||---|||||||||||||||||||||---||||||||||||||||||||---|||||||||||||--|||||||--|||||||tt---%%%%||||%%%||||%%%%%%%---%%%---%%%%%%%%%%|||||||||||---||---||||||||||||---||%||||||
||||||--||||||||||||||||||||||---|||||||||||||||||||||---||||||||||||||||||||---|||||||||||||--|||||||XX||||XXXXXXXX||||||||||||||||||||||---|||---|||||||||||||||||||||---||---||||||||||||---|||||||||
