--------------------------------------------------------------------------------------------------------------------------------------------------------------------------------------------------------
--------------------------------------------------------------------------------------------------------------------------------------------------------------------------------------------------------
--------------------------------------------------------------------------------------------------------------------------------------------------------------------------------------------------------
--B---------------------------------------------------------------------------------#--------------------------------------------------------------------------------------C----------------------------
--------------BB--------------------------------------------------------%%%%--------#-------------------------------------------------------------------------------------------------------------------
-----------------------------------------------------------D------------||||--------#K-------------------------------------------------------------------------------------------BBCB-------------------
-----------g-------------------------------------D-B2BCBCDDD---DD---%%%%||||--------#---BBBBB---r-------------------------------------------------------------------------------------------------------
-%%%%-D-B2BB2BBBBBB2B--------D-----------------------------D----2BB-||||||||%%%%--%%%%%--------%%%%-----------------%%%%-------U---#---------------------------------------B---------g------g-----------
-||||--------------------------------------r-k----------------------||||||||||||--|||||--------||||------------tt---||||---tt------#-----------------tt----------------tt--------%%%%%%%---%%%%%%%%-----
-||||--------------------------------B----%%%%---tt-D-tt------------||||||||||||--|||||B2BB----||||------------Tt---||||---Tt------#--------%%%%%----tt---tt-----------tt--------|||||||---||||||||-----
---||----D--U--BBBBBBBBB-----tt-D---------||||---Tt---tt---D---%%---||||||||||||--|||||--%%%%%%||||%%%--%%%%%%%%%%%%||||%%%%%%%%---%%%---%%%|||||----tt---tt-----%%%%%%%%%%%%%---|||||||---||||||||-----
---||------------------------Tt------r----||||---tt---tt-------||%%%||||||||||||--|||||--|||||||||||||--||||||||||||||||||||||||---|||---||||||||%%%%%%%%%%%%%---|||||||||||||---|||||||----------------
%%%|--------r-------g--------tt---%%%%%%%%||||%%%%%%%%%%%%%%---|||||||||||||||||--|||||--------|||||||--||||||||||||||||||||||||---|||---|||||||||||||||||||||---|||||||||||||---|||||||----------------
||||%%--%%%%%%%%%%%%%%%%--%%%%%%%%||||||||||||||||||||||||||---||||||||||-------------|%%%%%---|||||||--||||||||||||||||||||||||---|||---|||||||||||||||||||||---|||||||||||||---|||||||---%%%%%%F%%%%%%
||||||--||||||||||||||||--||||||||||||||||||||||||||||||||||---||||||||||-------------||||||---|||||||--||||||||||||||||||||||||---|||---|||||||||||||||||||||---|||||||||||||-------------||||||X||||||
||||||--||||||||||||||||--||||||||||||||||||||||||||||||||||---||||||||||-------------||||||---|||||||--||||||||||||||||||||||||---|||---|||||||||||||||||||||---|||||||||||||-------------||||||X||||||
