--------------------------------------------------------------------------------------------------------------------------------------------------------------------------------------------------------
--------------------------------------------------------------------------------------------------------------------------------------------------------------------------------------------------------
--------------------------C-----------------------------------------------------------------------------------------------------------------------------------------------------------------------------
--------------------------------------------------------------------------------------------------------------------------------------------------------B-B-------------#---------------#--#------------
----------------------------------------------B------------------------------------tt----#----------------------------------------------------------------------DDD---%%%----%%%%%%---DDD--%%%%%%-------
---------------------------r-k----------------y-B--tt------------------------------Tt---###-----g-----------------------------------------------------------BBB-------|||----||||||--------||||||-------
-BC---------g-------------%%%%---tt--BBB%%%%%------tt---------------------------%%%%%%%%%%%%%%%BB2BB---------------------------------------------------------%%%%%%---|||----||||||--------||||||-------
------D-B2BBB2B---2B------||||---Tt-----|||||------tt------------------------BB-|||||||||||||||------------------------------------------C--------------DDDDD||||||------------------------||||||-------
-----------------------r--||||---tt-----|g|||%%%DDD%%DDDDD----------------------|||||||||||||||---g---B-------------------------------------------BBB--------||||||------------------------||||||-------
BBBBB-------B-------D---%%||||%%%DDDD%%%||||||||---||------------------------------||-----U---BBBBBB-----------%%%%--------------%%%------%%%%---------------||||||---DDDD---DDDDDD---DDDDD||||||-------
---------D----------D---|||||||||----|||||||||||---||----g------------------BBBB-------------------------------||||--------------|||------||||--------g---%%%|----g-------------------------------------
--------------D---DDD---||||||-------|||||||||||-------%%%%--BBC----BBBBC--------D-D--B------------------------||||---%%%%--%%---|||---%%%||||---%%%%---%%||||-%%%%%%-----------------------------------
%%%%----------------D---||||||-D%%%---#-|||||----------||||------------------------------%%%%%%%%%%%%%----%%%%%||||%%%||||%%||---|||---|||||||---||||---||||||-||||||--------------tt--#----------------
||||%%--%%%%%%%---------B2||||--|||---#-DDDD|%%--------|k||k-----g------g-------------r--|||||||||||||----||||||||||||||||||||---|||---|||||||---||||---||||||-||||||--------%%----tt--#--%%%%%%%F%%%%%%
||||||--|||||||-----------||||%%|||---#-XXXX|||----%%%%||||%%%%%---%%%%%%%%%%%%%%%%%%%%%%|||||||||||||----||||||||||||||||||||---|||---|||||||---||||---||||||-||||||--------||----tt--#--|||||||X||||||
||||||--|||||||-----------|||||||||%%%%%|XXX|||%%%%|||||||||||||---|||||||||||||||||||||||||||||||||||----||||||||||||||||||||---|||---|||||||---||||---||||||%||||||%%%%%---||%%%%%%%%%%%|||||||X||||||
