--------------------------------------------------------------------------------------------------------------------------------------------------------------------------------------------------------
--------------------------------------------------------------------------------------------------------------------------------------------------------------------------------------------------------
-----------------------------------------------------------------------------------------------------------#--------------------------------------------------------------------------------------------
------C---------------------------------------------------------------------------#-U----------------------#--------------------------------------------------------------------------------------------
----------------------------------------------------------------------------------#----tt---------#----tt--#K-------------------------------------------------------------------------------------------
--------------------------------------------------------------------------%%------#-r--tt--#--#--###---tt--#---#--#-----D----y--------------------------------------------------------------------------
-----------------%%%%%-------------------C--------------------------------||---%%%%%%%%%%%%%--%%%%%%%%%%%%%%%%%%--%%%---D-%%%%%%----SSSS----------------------------------------------------------------
------D%%%%%-SSC-|||||--------------------------------------------G---D---||---|||||||||||||--||||||||||||||||||--|||---D-||||||--------------tt---tt-----S----tt---------------------------------------
-------|||||-----|||||------DDDDDDD--%%%-------------D-------------D--D---||---|||||||||||||--||||||||||||||||||--|||---D-||D|||--------------tt---Tt----------tt---------------------------------------
-S2SS--|||||--r--|||||---------------|||---------------------------D--D---||---|||||||||||||--||||||||||||||||||--|||-----||-|||%-------------tt---tt------g---tt---%%%%----g-----g---------------------
-------||D||-%%%%|SSSSC--------------|||-SS----SSS---C-------------D--D---||---|||||||||||||--||||||||||||||||||--|||---%%||%||||-SSCSC%%--%%%%%%%%%%%%---%%%%%%%%%%||||-%%%%%%%%%%%%%%%%%%%------------
-------||-||-|||||-------r--%%%%%---C|C|----------------D-----------------||---|||||||||||||--||||||||||||||||||--|||---|||||||||------||--||||||||||||---||||||||||||||-|||||||||||||||||||------------
%%%%---||-||-||||k--%%%---%%|||||----|-|--------------------tt---%%%%%%---||---|||||||||||||--||||||||||||||||||--|||---|||||||||------||--||||||||||||---||||||||||||||-||||||||tt||D||||||------------
||||%%%%%%%%%||||%%%|||---|||||||---r|-|--------------------tt---||||||---||---|||||||||||||--||||||||||||||||||--|||---|||||||||------||--||||||||||||---||||||||||||||-||||||||tt||-||||||%%%%%F%%%%%%
|||||||||||||||||||||||---|||||||%%%%%%%%%%%%--%%%%%%%%%%%%%%%%%%||||||---||---|||||||||||||--||||||||||||||||||--|||---|||||||||------||--||||||||||||---||||||||||||||%||||||||%%||%|||||||||||%||||||
|||||||||||||||||||||||---|||||||||||||||||||--||||||||||||||||||||||||---||---|||||||||||||--||||||||||||||||||--|||---|||||||||------||--||||||||||||---||||||||||||||||||||||||||||||||||||||||||||||
