--------------------------------------------------------------------------------------------------------------------------------------------------------------------------------------------------------
--------------------------------------------------------------------------------------------------------------------------------------------------------------------------------------------------------
-----------------------------------------------#-C------------------------------------------------------------------------------------------------------------------------------------------------------
---------C-------------------------------------#--------------------------------------------------------------------------------#--------------#--#-----------------------------------------------------
--#--------------------------------------------#----------------------------------BBB--------B2BB-#--------------------%%%%-----%%%-----DD---%%%--%%%%%%%-----------------------------------------------
--#--------------------------------------------#--------------------------------------------------#-------------D------||||-----|||BB--------|||--|||||||-----------------------------------------------
--#-----------------------------D---D-------%%%%%%----%%%--%%%%%----------------------------------#-----------------------------|||----------|||--|||||||-----------------------------------------------
BB%%%-D-BB2BBCB----BB%%---------------------||||||2BB-|||--|||||----------------------------------#-----------------------------------------------||||||------------------------------------------------
--|||-----------U----||--B---B---------------------------rg|||||------------------DDDDD--------%%%%%%---DDDDDD----%%%--%%%%-----------------------||||||--------------------------B---------------------
--|||----------------||---------tt-D---D----BBBD--------%%%%||||-----------U------B------------||||||---------BBB-|||--||||---BBDDD-----DD---DDD--||||||--------g----------------------%%%%-------------
--|||----D------r--%%||%--------tt-----------------tt---||||||||%%%%-C--------B-----------2BB----------r----------|||--||||-----------------------------------%%%%---tt---tt-----------||||---DDDDD-----
--|||--------%%%%%%|||||--------tt-------------g---tt---||||k|||||||--------------------------BBC---D-%%%%---tt-D----------------------------#----------------||||---tt---tt---%%%%%---||||-------------
%%||---------|||||||||||%%---%%%%%%%%--%%---%%%%%%%%%%%%||||||||||||-r--%%%%%-------------------------||||---Tt-------tt-B2---BBBBBB---------#-------U-#------||||---tt---tt---|||||---||||-------------
||||%%--%%%%%|||||||||||||---||||||||--||---||||||||||||||||||||||||%%%%|||||-----%%%%%-----------g---||||k--tt-------Tt---------------------#---------#--%%%%||||%%%%%%%%%%%%%|||||---||||---%%%F%%%%%%
||||||--||||||||||||||||||---||||||||--||---|||||||||||||||||||||||||||||||||%%---|||||%%%%%%%%%%%%%%%||||%%%%%%%%%%%%%%%DD----------g-------#---------#--||||||||||||||||||||||||||---||||---|||X||||||
||||||--||||||||||||||||||---||||||||--||---|||||||||||||||||||||||||||||||||||---|||||||||||||||||||||||||||||||||||||||-----BB%%%%%---%%%%%%%%%--%%%%%%%||||||||||||||||||||||||||---||||---|||X||||||
