--------------------------------------------------------------------------------------------------------------------------------------------------------------------------------------------------------
--------------------------------------------------------------------------------------------------------------------------------------------------------------------------------------------------------
--------------------------------------------------------------------------C--------------------------------------------------------------------------------------#--------------------------------------
-----------------------------------------------------------------------------------------------------------------------------------------------C-----------------#--------------------------------------
----------------------------DDDDD----------------------------------------------------------C----------D---------------C---------------r-k-C-------------#----tt--#------------CB---BBBBB----------------
-----------------------------------------B2BB--------U-------------------------------------------------------------------------------%%%%--------------###---Tt--#--%%%%%-------------------------------
-BB-------------------------BB-----------------------------------tt-------C-C-#------------------------------------------------------||||-----%%%%--%%%%%%%%%%%%%%%%|||||-------g------g----------------
------D%%%%--%%----------------------BBCB-------------------tt---tt---tt------#----------------tt--#--tt-D------tt------r------%%----||||k----||||--|||||||||||||||||||||%%---%%%%%%%%%%%%%%%%%---------
-------||||--||--------%%%%-------------------r-------------Tt---tt---Tt--r---#----%%%----tt---tt--#--tt--------Tt---%%---%%---||%%%%||||%%---||||--|||||||||||||||||||||||---|||||||||||||||||---------
BBBBB------------------||||--------------g---------%%%%%%%%%%%%%%%%%%%%%%%%%%%%%---|||----tt---tt--#--tt--------tt---||---||---||||||||||||---||||--|||||||||||||||||||||||---|||||||||||||||||---------
---------D-------------|k|g---%%%---%%%%%%%%%---%%%|||||||||||||||||||||||||||||---|||%%%%%%%%%%%%%%%%%%%%%--%%%%%%%%||---||---||||||||||||---||||--|||||||||||||||||||||||---|||||||||||||||||---------
---------------------%%||||%%%|||---|||||||||---||||||||||||||||||||||||||||||||---||||||||||||||||||||||||--||||||||||---||---||||||||||||---||||--|||||||||||||||||||||||---|||||||||||||||||---------
%%%%-----------------||||||||||||---|||||||||---|||--------|||||||||||||||||||||---||||||||||||||||||||||||--||||||||||---||---||||||||||||---||||-------------------||||||---|||||||||||||||||---------
||||%%--%%%%%%%%%%---||||||||||||---|||||||||---|||--------|||||||||||||||||||||---||||||||||||||||||||||||--||||||||||---||---||||||||||||---|||--------------------------------------||||||||%%F%%%%%%
||||||--||||||||||---||||||||||||---|||||||||---|||--------|||||||||||||||||||||---||||||||||||||||||||||||--||||||||----------------||||----------------------------------------------||||||||||X||||||
||||||--||||||||||---||||||||||||---||||||||----|||--%%--%%||||--------------------||||||||||||||||||||||||--||||||||----------------||||----------------------------------------------||||||||||X||||||
