--------------------------------------------------------------------------------------------------------------------------------------------------------------------------------------------------------
--------------------------------------------------------------------------------------------------------------------------------------------------------------------------------------------------------
----------------------------------------------------------------------------------------------------------------------------C--------------------------------------------------C------------------------
--------------------------------------------------------------------------------------------------------------------------------------------------------------------------------------------------------
-----------#-----------------#--SSSSSS-SSS-C-------------------C----------------------------------------------------------------------------------------------------------------------------------------
-----------#---S2SS------rg--#-------------------------D------------------------------------------------------------------------------------------------------------------------------------------------
-SS--------#------------%%%%-#-tt--#----------------------------------S2S---SS------------------------%%%-------------------%%%%---tt--------tt---tt---%%%%---tt---%%%%--------tt--------tt-------------
------D%%%%%%%%%--------||||---tt--#---r----------------------%%%%%-C-----------------------%%--------|||-----tt---%%-------||||---tt---tt---tt---Tt---||||---Tt---||||---tt---Tt---tt---tt-------------
-------|||||||||--------||||k--tt--#--%%%%%%----DD-----%%---DD|||||----------------D--------||---%%---|||-----Tt---||-------||||---tt---tt---tt---tt---||||---tt---||||---tt---tt---Tt---tt-------------
SSSSS--|||||||||------DDDDDDDDDDDDDDDD||||||-----------||---D-|||||-r---g----------D-%%%%%%%||---||---|||---%%%%%%%||---%%%%||||%%%%%%%%%%%%%%%%%%%%%%%||||%%%%%%%%||||%%%%%%%%%%%%%%%%%%%%%%%%%%%------
-------||D|D|tt|-SS-----||||-------D--||||||#----------||--g--|||||DDD%%%---%%%%---D-|||||||||---||---|||---|||||||||---||||||||||||||||||||||||||||||||||||||||||||||||||||||||||||||||||||||||||------
-------||-|-|tt|--------||||----------||||||#----------|D---2SS||||---|||---||||---D-|||tt||||---||---|||---|||||||||---||||||||||||||||||||||||||||||||||||||||||||||||||||||||||||||||||||||||||------
%%%%---||-|-|tt|--------||||-------%%%%%%|||#---%%---SC|D------||||---|||---||||-----|||tt||||---||---|||---|||||||||---||||||||||||||||||||||||||||||||||||||||||||||||||||||||||||||||||||||||||------
||||%%-|%%%%%%%%%%%---%%||||%%--%%%||||||DDDD---||-----|-------||||DDD|||---||||---%%|||%%||||---||---|||---|||||||||---||||||||||||||||||||||||||||||||||||||||||||||||||||||||||||||||||||%%%%%F%%%%%%
||||||-||||||||||||---||||||||--|||||||||---D---||---%%%S---SSSSC||---|||---||||---|||||||||||---||---|||---|||||||||---|||||||||||||||||||||||||||||||||||||||||||||||||||||||||||||||||||||||||%||||||
||||||-||||||||||||---||||||||--|||||||||-------||---|||---------||---|||---||||---|||||||||||---||---|||---|||||||||---||||||||||||||||||||||||||||||||||||||||||||||||||||||||||||||||||||||||||||||||
