--------------------------------------------------------------------------------------------------------------------------------------------------------------------------------------------------------
--------------------------------------------------------------------------------------------------------------------------------------------------------------------------------------------------------
----------------------------------------------------------------------------------------------------------------------------------------------#---------------------------------------------------------
---------------------------------------------------------------------------------------------------g---------g----------------C---------------#-C-----------------------#----------------#--------------
----------------------------------------------------------------------------------DDDDDDD--%%%%%%%%%%%-*-SSSSS2S----------------------C-------#----tt-----%%%%---#--#--##----#----#--#--###-------------
-------------------------------------------------------------------------------------------|||||||||||-*---------tt----#--------tt------------#----Tt-----||||%%%%--DDDDD---%%---%%--%%%%%%%---%%-------
------------------------------g-----------------------------------------------------r-k----r|k||||||||-*---------Tt---###-------Tt-------%%---%%%%%%%%%---||||||||----------||---||--|||||||---||-------
------D-------------------D--SSS---------------------------------------C-----------%%%%---%||%||||||||%%%%%%%%%%%%%%%%%%%%%%%%%%%%%%%%%%%||---|||||||||---||||||||----------||---||--|||||||---||-------
-------------------------------------------------CD-----------------------tt-------||||---|||||||||||||||||||||||||||||||||||||||||||||||||---|||||||||---||||D%%%----------||---||--|||||||---||-------
-S2SS----------------r-k---C--------SS------------D-U---------------------Tt-------||||---|||||||||||||||||||||||||||||||||g|||||||||||||||---|||||||||---2SC|-|||----------||---||--|||||||---||-------
---------D-----tt---%%%%-----D---------S---S------------------------------tt---%%%%||||%%%||||||||||||||||||||||||||||#||||-|||||||||||||||---|||||||||------|-|||----------||---||--|||||||---||-------
---------------Tt---||||-------%%%%%----------------r-------%%---%%%%%%%%%%%%%%|||||||||||||||||||||||||||||||%%%%%|||#||||-|||U|||||||||||---|||||||||------|-|||%%%%%%%---||---||--|||||||---||-------
%%%%-----------tt---||||-------|||||-------------%%%%%%--%%%||---|||||||||||||||||||||||||||||||||||||||||||||||||||||#||%%%%%|-|||||||||||---|||||||||------|-||||||||||---||---||--|||||||---||-------
||||%%%%%%%%%%%%%%%%||||%%%%%%%|||||%%%%--------%||||||%-|||||---||||||||||||||||||||||||||||||||||||||%%%%%%%|||||%%%%%%||||||-|||||||||||---|||||||||------|-||||||||||---||---||--||||%%%---%%F%%%%%%
||||||||||||||||||||||||||||||||||||||||---%%---||||||||-|||||---|||||||||||||||||||||||||||||||||||||||||||||||||||||||||||||%%%%%%%||||||---|||||||||------|-||||||||||---||---||--|||||||---||%||||||
||||||||||||||||||||||||||||||||||||||||---||---||||||||-|||||---||||||||||||||||||||||||||||||||||||||||||||||||||||||||||||||||||||||||||---|||||||||------|-||||||||||---||---||--|||||||---|||||||||
