--------------------------------------------------------------------------------------------------------------------------------------------------------------------------------------------------------
--------------------------------------------------------------------------------------------------------------------------------------------------------------------------------------------------------
--------------------------------------------------------------------------------------------------------------------------------------------------------------------------------------------------------
-----------#----------------------------------------------------------------------------------S------------------C-------------------g--#--#---g-----------g--------------------------------------------
-----------#------------------------------------------g----------------2SSSSSSSSSSSSS------------%%%%%%----%%%%%--DDDDDD---------%%%%%%%%--%%%%%%%%%%%%%%%%%%%-*----------------------------------------
-----------#-------------------------------------------2S----------------------------------------||||||%%%%|||||---------------SS||||||||--|||||||||||||||||||-*--tt-----%%-----------------------------
-----------#------------------------------------------------------------------------DDDDD---DDDDD|||||||||||||||%%%%%%%S2SSSS----||||||||--|||||||||||||||||||-*--Tt-----||---%%---%%---%%%%%%----------
------D-%%%%%%--D---------DDDDDDD-----DDD-------------------------------------------------S------||||||||||||||||||||||----------||||||||--|||||||||||||DDD|||%%%%%%%%---||---||---||---||||||----------
--------||||||-------------------------S2S----U----S---S----------------------S-----DDDDD--------|||||||||U||||||||||||----------||||||||--||%||%|||||||||||||||||||||---||---||---||---||||||----------
SSSSS---||||||-------------C----------------------------------------------------SSC-----tt--C----|||tt||C|-||||D||tt|D|--------%%|||||||tt-|||||||||tt||||||||||||||||---||---||---||---||||||----------
--------|D|||tt--#-----tt--------D--------------------------S----g---C------------------tt-----tt|||Tt||-|-||||-||Tt|-|%%%%%%%%|||||||||tt-|||||||||Tt||||||||||||||||---||---||---||---||||||----------
--------|-|||Tt--#-----tt-----tt-------------%%%%%-S-----------%%%%-----tt----------g---tt--r--tt|||tt||r|-||||-||tt|-|||||||||||||||||%%%%%%|||||||%%|||||||||D||||||---||---||---||---||||||----------
%%%%----|-|||tt--#-----tt-----tt-------%%%---|||||-----%%------||||-----tt---%%%%%%%%%%%%%%%%%%%%%%%%%%%%%%%%||%%%%%%%%||||||||||||||||||||||||||||||||||||||||-||||||---||---||---||---||||||----------
||||%%--%%%%%%%%%%---%%%%%%%%%%%%%%---%|||---|||||-r---||------|k||-----tt---||||||||||||||||||||||||||||||||||||||||||||||||||||||||||||||||||||||||||||||||||%%||%%%---||---||---||---%%%%%%%%%F%%%%%%
||||||--||||||||||---||||||||||||||---||||---|||||%%---||---%%%||||%%%%%%%%%%|||||||||||||||||||||||||||||||||||||||||||||||||||||||||||||||||||||||||||||||||||||||||---||---||---||---|||||||||%||||||
||||||--||||||||||---||||||||||||||---||||---|||||||---||---||||||||||||||||||||||||||||||||||||||||||||||||||||||||||||||||||||||||||||||||||||||||||||||||||||||||||---||---||---||---||||||||||||||||
