--------------------------------------------------------------------------------------------------------------------------------------------------------------------------------------------------------
--------------------------------------------------------------------------------------------------------------------------------------------------------------------------------------------------------
---------------------------------------------------------------------------------------------------------------#----------------------------------------------------------------------------------------
------------C--------------S-----------------------------------------------------------------------------------#----------------------------------------------------------------------------------------
---------------------------------------------C-------------------#----------------%%%%-----#-----#----tt---tt--#K--%%-----------------------------------------------------------------------------------
---------------------%%%%%------------S2SS-----SS--D------------###---%%%%----y---||||----###---###---tt---Tt--#---||---%%%%----------------------------------------------------------------------------
-S2S----------------%|||||----%%%%%-C--------------------%%-----%%%---||||-%%%%%%%||||%%%%%%%%%%%%%%%%%%%%%%%%%%---||---||||----------------------------------------------------------------------------
------D--SCSCSSSS---||||||%%%%|||||----------------g-----||-----|||---||||-|||||||||||||||||||||||||||||||||||||---||---||||--------g------g-----g------------------------------------------------------
--------------------|||||||||||||||-r-------%%%%%%%%%%---||-----|||---||||-|||tt||||||||||||||||||||||||||||||||---||---||||------%%%%---%%%%--SS-----#--tt-----SS------------------#-------------------
SSSSSC----------S---|||||||||||||||DDDD--%%%||||||||||---||G#---|||---||||-|||Tt||||||||||||||||||||||||||||||||---||---||||------||||---||||---------#--Tt---------tt--#-----------#-------------------
---------D--SSS-----||||D||||||||||------|||||||||||||---||-#---|||---||||%|||%%||||||||||||||||||||||||||||||||---||---||||------|k||k--||||------g--#--tt---------Tt--#--tt---tt--#-------------------
--------------------||||-||||||||||------||||||g||||||---|D-#---|||---||||||||||||||||||||||||||||||||||||||||||---D|---||||%%%%%%||||%%%||||%%%%---%%%%%%%%%---%%--tt--#--tt---Tt--#-------------------
%%%%------------g---DDDDDDDDD||||||--#--#|||||SS2SS|||---|------|||---||||||||||||||||||||||||||||||||||||||||||----|---|||||||||||||||||||||||||---|||||||||---||%%%%%%%%%%%%%%%%%%%%%%%%%-------------
||||%%--%%%%%%%%%-------D----%%%%%%%%%--DDDDDDD----|||-r-|------|||---%%||||||||||||||||||||||||||||||||||||||||----|---|||||||||||||||||||||||||---|||||||||---|||||||||||||||||||||||||||---%%%F%%%%%%
||||||--|||||||||-------D----|||||||||-------------DDD---%%%%---%%%---||||||||||||||||||||||||||||||||||||||||||----|---|||||||||||||||||||||||||---|||||||||---|||||||||||||||||||||||||||---|||%||||||
||||||--|||||||||------------|||||||||-----S2SSSSS-------||||---|||---||||||||||||||||||||||||||||||||||||||||||----|---|||||||||||||||||||||||||---|||||||||---|||||||||||||||||||||||||||---||||||||||
