--------------------------------------------------------------------------------------------------------------------------------------------------------------------------------------------------------
--------------------------------------------------------------------------------------------------------------------------------------------------------------------------------------------------------
--------------------------------------------------------------------------------------------------------------------------------------------------------------------------------------------------------
---------------------------------------#-----C----S-S--------S------U-------------S-S---------S---------------------------------------------------------------------------------------------------------
-----------------------------tt-----D--#--------------C--tt-----------SS--------------------------#----%%%%%%----%%%%----g--------------DDDDDD---DDDDDG#---------2SS------------------------------------
---------------------%%%-----tt--------#K-tt-------------Tt-----tt------------tt-------%%--------##----||||||%%%%||||-%%%%SSSS--SS---SSCU------S---SS--#------------------------------------------------
-S2S-------g--g--g---|||--r--tt--------#--Tt--r-------r--tt-----Tt--------g---tt-------||---%%%%%%%---%||||||||||||||-||||-----------------------------#------------------------------------------------
------D--%%%%%%%%%%%%|||---%%%%%%--%%%%%%%%%%%---%%%%%DDD%%%%%%%%%%%%%%%---%%%%%%%%%%%%||---|||||||---|||||||||||||||-||||#----tt---tt-------tt---tt---------------------------G#-----------------------
---------|||||||||||||||---||||||--|||||||||||---|||||---|||||||||||||||---||||||||||||||---|||||||---|||||||||||||||-||||##---tt---Tt-------tt---tt-------------DDDDD----------#-----------------------
SSSSS----|||||||||||||||---||||||--|||||||||||---|||||---|||||||||||||||---||||||||||||||---||S||||---%%%||||||||||||D||||%%%%%%%%%%%%%%%DDDDDDDDD%%DDDDDDD---------------------#---------C-------------
---------|||||||||||||||---S|||||--k||||||DDDD---|D||%%%%|||D||S|D||D||D---D|D|D|D|||D|D|---||-|S2S---|||||||||||||||-|||||||||||||||||||---------||----------G-------------------S2SS-S----------------
---------|||||||||||||||----|C||%%%%||SSS|-------|-|||||||||-||-|D||-||-----|-|-|-|||-|-|---||-|------|||||||||||||||-|||||||||||||||||||---------||----S---------SSC----S------------------------------
%%%%-----||||||||||||%%%----|-||||||||---|-------|-|||||||||-||-|-||-||-----|-|-|-|||-|-|---|%%%%%----|||%%%%|%%%%||*-||||||#||D||||D|||D---------||-tt---tt-D----------------%%%%----------------------
||||%%--%|||||||||||||||----|r|||k||||---|g------|%%%||||%%|-%%%%%%%%|%%---%%%%%%%%%|-%%%---%|||||----||||||||||||||*-||||||#||-||||-|||----%%%%%-||-tt---tt----------g-------||||DD------%%%---%F%%%%%%
||||||--||||||||||||||||---%%%%%||||%%%%%%%%%%---%||||||||||-|||||||||||---||||||||||-|||---||||||----||||||||||||||*-||||||#||-||||-|||----|||||-||-tt---tt-----%%%%%---%%---||||--%%%%%%|||---|%||||||
||||||--||||||||||||||||---|||||||||||||||||||---|||||||||||-|||||||||||---||||||||||-|||---||||||X---|||XXXXX||||XXXX||||XXXXXXXX|XXXXXXXXX|||||XXXXXXXXXXXXX---|||||---||---XXXXXX|||||||||---||||||||
