--------------------------------------------------------------------------------------------------------------------------------------------------------------------------------------------------------
--------------------------------------------------------------------------------------------------------------------------------------------------------------------------------------------------------
---------------------------------------------------------------------------------------------------------------------------C----------------------------------#--------------------#--------------------
------------------#--------------------#--#--------g------------------------------------------------------------------------------------------------------#---#--------------------#--------------------
--------%%%%%----###-----------------DDD--%%SCSCSS---SS-----------------------------------------------------------------------------------%%%%%------#---###--#--%%%%%-------------#--------------------
----SSS-|||||%%%%%%%%%%--%%%--SSSCSS------||----------------------------------------------------------------------------------------g-----|||||%%%---%%%%%%%%%%%%|||||---#--#------#----%%%-------------
--------|||||||||||||||--|||--------------||-----------------------------------------------------------------------------D%%%%%%%%%%%%%%%%||||||||---|||||||||||||||||%%%%--%%%--%%%%---|||-------------
------D-|||||||||||||||-y|||---y-----2SSSSSSSSSSSS-----------------------SSC---------C------------------------------------||||||||||||||||||||||||---|||||||||||||||||||||--|||--||||---|||-------------
--------||||||||||||||%%%%||-%%%%-D----------------------------------------------tt------------------S--------------------||||||||||||||||||||||||---|||||||||||||||||||||--|||--||||---|||%%%%%%%%-----
-S2SS---|||||||SSS||||||||||-||||--------------------------------tt----------g---tt-----%%%%%---------------------tt--#---||||tt|||||||DDD||||||||---|||||||||||||||||||||--|||--||||---|||||||||||-----
--------|D||SS2S--|||r|k||k|-|k||k-------------------------------tt---%%%%%%%%%%%%%%%%%%|||||-----------tt---tt---Tt--#--tt|||Tt||||||||||||||||||---|||||||||||||||||||||--|||--||||---|||||||||||-----
--------|-||------||%%||||%%%||||%%--D-#--------%%---------------tt---|||||||||||||||||||||||-----------tt---Tt---tt--#--Tt|||tt|||||||||D||||||||---|||||||||||||||||||||--|||--||||---|||||||||||-----
%%%%----|-||----g-|||||||||||||||||----#--------||---%%---%%--%%%%%%%%|||||||||||||||||||||||%%%%--%%%%%%%%%%%%%%%%%%%%%%%%|||%%||||||||||||||||||---|||||||||||||||||||||--|||--||||---|||||||||||-----
||||%%--%%%%%%%%%%%%|||||||||||||||----#--%%%%%%||---||---||--|||||||||||||||||||||||||||||||||||--|||||||||||||||||||||||||||||||||||||||||||||||---|||||||||||||||||||||--|||--||||---%%%%%%%%%F%%%%%%
||||||--|||||||||||||||||||||||||%%--%%%%%||||||||---||---||--|||||||||||||||||||||||||||||||||||--|||||||||||||||||||||||||||||||||||||||||||||||---|||||||||||||||||||||--|||--||||---|||||||||%||||||
||||||--||||||||||||||||||||2||||||--|||||||||||||---||---||--|||||||||||||||||||||||||||||||||||--|||||||||||||||||||||||||||||||||||||||||||||||---|||||||||||||||||||||--|||--||||---||||||||||||||||
