--------------------------------------------------------------------------------------------------------------------------------------------------------------------------------------------------------
--------------------------------------------------------------------------------------------------------------------------------------------------------------------------------------------------------
--------------------------------------------------------------------------------------------------------------------------------------------------------------------------------------------------------
-------------------------------------------------------------------------------------------------#--------------------------------------------------------------------------------------#--#------------
----------------------------------------------------------------------------------%%%%%---------###--------------------------------------------------------------------------%%%%%%---%%%--%%%%%%%------
--------------------------------------------------------------------------------C-|||||DDDD--%%%%%%%---D---------------------------------------------------------------------||||||---|||--|||||||------
-S2S------------------------------------DDDDDDD---------------------D-------------|||||------|||||||---D---------------------------------------------------------------------||||||---|||--|||||||------
------D--------------S----------DDDDDDD----------------------------------------C--|||||------|||||||---------------D2SS-------------C----------------------------------------||||||---|||--|||||||------
--------------------------------------------------------------------------SS------|||||-----tt||||||-----C----SC-------------------------------------------------------------||||||---|||--|||||||------
SSSSSC----------SS----------------SS-------------%%%%--SS---D-D--U-----D----------|||||-----tt|||%%%----------------------%%%-----------------------------------------------DDDDDDD---DDDDDDD|||||------
---------D--SSC--------------tt------*--tt-------||||---------------tt---tt---%%%%%%|||-----tt||||||-----r-------g--------|||----------------------------------------------------------------|||||------
---------------------%%------tt------*--tt-------|k||k-----g-----r--tt---tt---||||||%%%%%%%%%%%%%|||---%%%%---DD---DDDD---|||-----%%%%%-----------------C---------------------------rg-------|||||------
%%%%------------g----||------tt------*--tt---%%%%||||%%%%---%%%%%%%%%%%%%%%%%%||||||||||||||||||||||---||||---------------|||---%%|||||--------tt---tt-----------------------------%%%%------|||||------
||||%%--%%%%%%%%%%---||---%%%%%%%%%%%%%%%%%%%||||||||||||---||||||||||||||||||||||||||||||||||||||||---||||---------------|||---|||||||--------Tt---Tt--r--%%%%%----tt---tt---tt---||||--%%%%%%%%F%%%%%%
||||||--||||||||||---||---|||||||||||||||||||||||||||||||---||||||||||||||||||||||||||||||||||||||||---|||#---------#-----|||---|||||||%---%%%%%%%%%%%%%%%%|||||----tt---tt---Tt---||||k-||||||||%||||||
||||||--||||||||||---||---|||||||||||||||||||||||||||||||---||||||||||||||||||||||||||||||||||||||||---XXXX---XX---XX-----XXX---||||||||---|||||||||||||||||||||XXXXXXXXXXXXXXXXXXX||||XX|||||||||||||||
