--------------------------------------------------------------------------------------------------------------------------------------------------------------------------------------------------------
--------------------------------------------------------------------------------------------------------------------------------------------------------------------------------------------------------
-------------------------------------------------------------------------------------------------------------------------------------------#------------------------------------------------------------
-------------------------------------------------------------------------------------------------------------------------------------------#-------------------------------------------#----------------
-----------#----------#---------------------------------------------------------BBBBB---------B2BBBBB-------------------------------C---g--#-----D----g----------------------%%%-----%%%---%%%%%--------
-----------#----------#----------------------------------------------------------------------------------------------------#--%%%%-------2%%%%---D-%%%%%%--------------------|||-----|||---|||||--------
--BB-------#-------y--#--------------------------D-------------------------------------------------------------------------#--||||--------||||---D-||||||--------------------|||-----|||---|||||--------
------D%%%%%%%----%%%%%%%----------------------------------B---------------------------------------------------------------#--||||---------|||---D-||||||----------------------------------|||||--------
-------|||||||----|||||||---------B-----------------------------------------------%%%-----DDD-D-DDDDDDD-----DDD------DDDDDDDDDDDDDDDDD-----|||-----|||||DDDDDDD----------------------------|||||--------
BBBBB------------U|||||||-B---ry--------%%%%--BB2--------------CC2BB-B---BB-------|||-------------------2------------------D--XXXX---------|||---%%|||||X--------------------DDD-----DDD---|||||--------
---------D-D-tt---|||--------%%%%-------||||------------%%%%------------------------------------------------------B--------D--XXXX---------|||---|||||||X-----------------------------------------------
-------------tt---|||--------||||-------|k||k-----g-----||||------------tt-B2BBB--BCB------U--tt-D-tt----------------%%%%-----XXXXB---------B------|||||X--------------BBB-------g----#-----------------
%%%%---------tt---|||--------||||k----%%||||%%%%%%%%---%||||------------tt--------------------tt---tt----------------||||--D%%|||X-----------------|D|||X---%%%%--B-BBB------U-B---BB-#-----------------
||||%%--%%%%%%%%%%|||%--%%%%%||||%%---||||||||||||||---|||||---%%--%%%%%%%DDDDDD--------------tt---tt----------------||||---|||||X-------%%------BB|X|||X---||||----------------------#----%%%%%%F%%%%%%
||||||--||||||||||||||--|||||||||||---||||||||||||||---|||||---||--|||||||--------------%%%%%D%%%%%%%%%%----%%%%%%%%%||||%%%||||||%%%%---||%%%---%%|X|||X---||||--------g----------g--#----||||||X||||||
||||||--||||||||||||||--|||||||||||---||||||||||||||---|||||---||--|||||||%%%%%%%%%%%---|||||-||||||||||----||||||||||||||||||||||||||---|||||---|||X||||%%%||||%%%%%%%%%%---%%%---%%%%%---||||||X||||||
