--------------------------------------------------------------------------------------------------------------------------------------------------------------------------------------------------------
--------------------------------------------------------------------------------------------------------------------------------------------------------------------------------------------------------
--------------------------------------------------------------------------------------------------------------------------------------------------------------------------------------------------------
---------C----S----------------------g------------------------------------------------------------------------------------------------------------------------------------------------------------------
------------S-----------------------SS2S------#--#----------------------------------------------------------------------------#-------------------------------------------------------------------------
-------------------K-%%%%----------------DDDDDD--DDD--%%%------------------------------SSSSS-S-------2SS-----------S2SS---SS--#--------------------------#----------------------------------------------
S2SS--------r--------||||-%%%%%%----------------------|||-------------------SSS--U--------g--------------S--------------------#--------------------------#----------------------------------------------
------D--S2%%%%%---%%||||-||||||--2SSSS-----k---------|||-2-----g------g--------------D-SSS-------------------DD-----------------------------------------#----------------------------------------------
-----------|||||---||||||-||D|||---------%%%%---------|||-----SSS----SSS2-------------------------%%%%%%---------------------------------S---%%%--DDD--DDDDD-D------------------------------------------
SSSSS------|||||---||||||-||-|||%--------||||---tt---tt||---------------------------------%%%%%---||||||DDD----------------DDDDDDS-S---------|||---------D-----------S--%%%%---tt-------#---------------
---------D-|U|||---|D||||%||%||||--------|k||---tt---tt||---------g----------%%%%%----%%%D|||||---||||||------D--%%%%----------------U-------|||---------D*-------------||||---Tt---tt--#---------------
-----------|-|||---|-||||||||||||-----%%%||||%%%%%%%%%%%%%----%%%---%%%%%---%|||||---%|||-|||||---||||||---------||||----------tt-------%%%%%|||---D-----D*--tt-D-------||||---tt---Tt--#---------------
%%%%-------|-|||---|-|||||||y||||-g---||||||||||||||||||||----|||---|||||---||||||---||||-|||||---||||||------#--||||------g---Tt-------||||||||------tt--*--tt-----%%%%||||%%%%%%%%%%%%%%%%------------
||||%%--%%%%%%%%---|%%%%%%%|||||%%%%%%||||||||||||||||||||----|||---|||||---||||||---||||-|||||---||||||-DD---%%%||||%%---%%%%%%%%%%%%%%||||||||------Tt--*--tt-----||||||||||||||||||||||||%%%%%F%%%%%%
||||||--||||||||---|||||||||||||||||||||||||||||||||||||||----|||---|||||---||||||---||||-S2SSS---SSSSSS------|||||||||---|||||||||||||||||||%%%%--%%%%%%%%%%%%%%%%%|||||||||||||||||||||||||||||%||||||
||||||--||||||||---|||||||||||||||||||||||||||||||||||||||----|||---|||||---||||||---||||---------------------|||||||||---|||||||||||||||||||||||--|||||||||||||||||||||||||||||||||||||||||||||||||||||
