--------------------------------------------------------------------------------------------------------------------------------------------------------------------------------------------------------
--------------------------------------------------------------------------------------------------------------------------------------------------------------------------------------------------------
--------------------------------------------------------------------------------------------------------------------------------------------------------------------------------------------------------
----------------------------------C---------------------------------#--#--------------------------------------------------------------------------------------------------------------------------------
--------------------------------D---------------------------DDD---%%%--%%---D---------------------------------------------------------------------------------------------------------------------------
--------------------------------------------------------2SC-------|||--||---D---------------------------------------------------------------------------------------------------------------------------
-SCS--------------------------------------------------------------|||--||---D---------------------------------------------------------------------------------------------------------------------------
------DDDDD--DDDDDD-----DDDDDD--%%%%------------------------------|||--||---D--------------------------------------------------------------------------------------------------------S-%%%%-------------
--------------------------------||||-----------------G------------|||--||---D----------------------------------------------------------------------------------------------------------||||-------------
SSSSS------SSSSS--------S-------||||----SS---------------CDDDDD---DDDDD||---D----------------------------g-------------------------SSCS--------------------------tt--#--%%%%-----------||||-------------
---------D---------r-----------SSS||----------C------------------------||----S-------------------------%%%%--------------------C-------------tt---tt---tt---tt---Tt--#--||||--------%%%|||DDDDDDDD------
------------------%%%------tt-----||-------------tt---------------k----C|------------------SSSS2S------||||---%%-----------------------g-----tt---tt---Tt---Tt---tt--#--||||--------|||||||-------------
%%%%--------------|||------Tt-----|g----------r--tt-----%%%----%%%%-----|---------tt-------------------||||---||-------%%%------%%%%%%%%---%%%%%%%%%%%%%%%%%%%%%%%%%%%%%||||%%%--%%%|||||||-------------
||||%%--%%%%%--%%%|||---%%%%%%%%%%%%---%%%---%%%%%%%%---|||----||||-----|---------Tt-----------g---%%%%||||%%%||-------|||------||||||||---||||||||||||||||||||||||||||||||||||--||||||||||%%%%%%F%%%%%%
||||||--|||||--||||||---||||||||||||---|||---||||||||---|||----|k||---%%%---%%%%%%%%%%%--%%%%%%%%%%|||||||||||||---%%%%|||---%%%||||||||---||||||||||||||||||||||||||||||||||||--||||||||||||||||%||||||
||||||--|||||--||||||---||||||||||||---|||---||||||||---|||XXXX||||XXX|||---|||||||||||--|||||||||||||||||||||||---|||||||---|||||||||||---||||||||||||||||||||||||||||||||||||--|||||||||||||||||||||||
