--------------------------------------------------------------------------------------------------------------------------------------------------------------------------------------------------------
--------------------------------------------------------------------------------------------------------------------------------------------------------------------------------------------------------
------------------------------------------#-------------------------------------------------------------------------------------------------------------------------------------------------------------
--------------------------#---------------#------------------------------g--y------------------------#--#----------#-------#--#-------------#--#--------------------------------------------------------
--------------------------#---------------#-----------------G#--BCBCBB%%%%%%%%%%%%------g----DD----%%%--%%----%%---%%%---DD---%%%---%%%---%%%--%%%------------------------------------------------------
--------------------------#----%%---%%%%%%%%%---DD-BB2BB--B--#--------||||||||||||-BBCBBB2BC-D-----|||%%||----||---|||---D-%%%|||---|||---|||--|||------------------------------------------------------
--BB----------------------#----||---|||||||||----------------#--------||||||||||||-----------D-----|||||||----||---|||---D-||||||---|||---|||-----------------------------------------------------------
---------------------D-DDDDD---||---|||-----B-------------------2BBBBB||||||||||||%%%%-------D-------|||||---------------D-||||||---|||---------%%%%----------------------------------%%%%--------------
------G#-D----------------D-------------U-C-#-------------------------||||||||||||||||---------------|||||-------------B---||||||---|||-----BBB-||||----------------------------------||||--------------
BBBBB--#------G#----------D----BB-----------#------tt---%%%%%%%%DD----||||||||||||||||DDDDDDDDD----DD|||||----DD---DDD---DD||||||---|||---DDDDDD||||-----------------------D--2BB-%%%%||||%%%-----------
-------#-------#----2---D---------------r---#------Tt---||||||||------||||k|||||||||||-----------------------------------------------------------|||%%%%%%------------------------|||||||||||-----------
------------D-------------%%---------%%%%%%%%---%%%%%DDD||||----B-----|%||%|||||||||||--------#---U----------------------------------------------|||||||||----------g---B---------|||||||||||-----------
%%%%------------------g---||---------||||||||---|||||-----------------||||||||||||------------#-----B--------------%%%%%%-------tt---#-----------|||--------------%%%%--------D---||||||||--------------
||||%%---------%%---%%%%%%||---%%---%|||-||||---|||||-----------------||k|||||||||%%%%--DDDD--#K-------------------||||||-------tt---#--tt--------------tt---tt---||||----------%%||||||||%%%%%%%F%%%%%%
||||||--%%--%%%||---||||||||---||---||||-||||---|||||--#--#--------%%%||||||||||||||||--------#-----r--------%%%------|||-------tt---#--tt----%%%%%%----Tt---tt---||||----------|||||||--||||||||X||||||
||||||--||--|||||---||||||||---||---||||-||||---|||||%%%--%%%%%%%%%|||||||||||||||||||---%%%%%%---%%%%%%%%---|||---%%%|||%%%%%%%%%%%%%%%%%%%%%||||||%%%%%%%%%%%%%%||||%%%%%--%%%||||||---||||||||X||||||
