--------------------------------------------------------------------------------------------------------------------------------------------------------------------------------------------------------
--------------------------------------------------------------------------------------------------------------------------------------------------------------------------------------------------------
--------------------------------------------------------------------------------------------------------------------------------------------------------------------------------------------------------
-----------------------------------#--#---------------#--#-----------------------------------------------------------------------------------C----------------------------------------------------------
-----------#-----D----SS2--------%%%--DD----DD------%%%--%%---D------------------------------------------------------------------------------------------------------DDDDDD-----------------------------
-----------#-------------------S-|||--D-----D-------|||--||---D------------------------------------------------------------------------C----------------------------------------------------------------
-----------#---------------------|||--D-----D-------|||--||---D--------------------------------------------------------------k----------------------------------------rg--------------------------------
------DDDDDDDD%%%%%---D----------|||--D-----D-------|||--||---D-----------------------------------------------------------%%%%------------%%%%%--------%%%%%----tt-D-%%%%---tt-D------------------------
-----------D--|||||---D---------G#||----------------|||--||---D------------------------------------------g----------------||||---%%%%-----|||||%%%%%%%%|||||----tt---||||---Tt----------tt--------------
SSSSS------D--|||||--------C-----#||CDDD----DD---DD-DDDDD||---D---------------------------------SS2S---SSS2SS----tt-------|k||k--||||-%%%%||||||||||||||||||----tt---||||---tt----------tt--------------
---------D-D-tt||SS-----C---------||---------------------||------------------------------------------------------tt---%%%%||DDD%%||||-||||||||||||||||||||||%%%%%%%%%||||%%%%%%%%%%--%%%%%%%------------
-------------tt||-----------------||-------------S-C-----||----------------------SCS----------------g------g-----tt---||||||||-||||||-|||||||||||||||||||||||||||||||||||||||||||||--|||||||------------
%%%%---------tt||----g-----------%%%%%---------------#---||-----S--tt---tt----------------%%--%%%%%%%%%%%%%%%%%%%%%%%%||||||||-||||||-|||||||||||||||||||||||||||||||||||||||||||||--|||||||------------
||||%%--%%%%%%%%%%%---%%%%%%---%%|||||---------------#--%%%--------Tt---Tt----------g-----||--||||||||||||||||||||||||||||||||-||||||%||||%||||||||||||||||||||||||||||||||||||||||--|||||||%---%F%%%%%%
||||||--|||||||||||---||||||---|||||||---r-----------#--|||-----r--tt---tt-------%%%%%%---||--||||||||||||||||||||||||||||||||-||||||||||||||||||||||||||||||||||||||||||||||||||||--||||||||---|%||||||
||||||--|||||||||||---||||||---|||||||XX---------XXXXXXX|||---XXXXXXXXXXXXXXXX---||||||---||--||||||||||||||||||||||||||||||||-||||||||||||||||||||||||||||||||||||||||||||||||||||--||||||||---||||||||
