--------------------------------------------------------------------------------------------------------------------------------------------------------------------------------------------------------
--------------------------------------------------------------------------------------------------------------------------------------------------------------------------------------------------------
---------------------------------------#----------------------------------------------------------------------------------------------------------------------------------------------------------------
------------------#--------------------#--------------------------------------------------------------CS----C--------------------#------------S-#-S-----------------------------------------------------
---------------D--#----D---------------#K--------------------------S2SS------------D%%%%------------------------------%%%%%%-----##---%%%%%-----#-------------------------------------------------------
------------------#K---------%%%-------#--------------------------------------------||||---------U--------------#--#--||||||%%---%%%%%|||||-----#------D---%%--DDD--------D-----------------------------
-SS2---------g----#----------|||%%---%%%%%---D----%%%%%%%%%%%%----------------------||||----k--------------%%%%%%--%%%||||||||---||||||||||---%%%%%%%-SD---||-------------------------------------------
------D--SSDSS2SSDDDD--DDD---|||||---|||||---D----||||||||||||-------------S-----SSC||D|-%%%%------%%%%%---||||||--|||||||||||---||||||||||---|||||||--D---||-------------------------------------------
-----------D------D----------|||||---|||||---D-S-C|S|||||||||SSS-C----%%%%----------||-|-||||---%%%|||||---||||||--|||||||||||---||||||||||---|||||||------S|-tt---tt--SS2---D--------------------------
SSSSS------D------D----------||||D---|||||--------|-||||||SSS-----g---||||----------|g-|-|k||k--||||||||---|||||S--|SS|||r||||---|||SS|||||---|||||||%%%----|-tt---tt-----------------------------------
---------D-----#--#--%%%%%---||||----|||||--------|-||tt||--------%%%%||||------%%%%%%%%%||||%%%||||||||---||D||---|--||%%%%||---|||--|||||---||||||||||----|-tt---tt------g-----%%%-U--%%%%------------
-----------DDDDD--%%%|||||---%%%%%---|||||--------|-||Tt||----g---||||||||%%%---||||||||||||||||||||||||---||-||---tt-||||||||---||tt-||%%%---%%||%%%|||---%%%%%%%%%%%%%%%%%%%---|||----||||------------
%%%%--------------||||||||---|||||---%%||D---%%%%%%%%%%%%%%%%%%%%%|||||||||||---||||||||||||||||||||||||---||-||---Tt-||||||||---||Tt-|||||---||||||||||---|||||||||||||||||||---|||----||||------------
||||%%--%%%%%%%---||||||||---|||||---||||D---||||||||||||||||||||||||||||||||---||||||||||||||||||||||||---%%%%%%%%%%%%%||||%%---%%%%%%%|||---||||||||||---|||||||||||||||||||---|||%%%%||||%%%%%F%%%%%%
||||||--|||||||---||||||||---|||||---||||D---||||||||||||||||||||||||||||||||---||||||||||||||||||||2SS|---|||||||||||||||||||---||||||||||---||||||||||---|||||||||||||||||||---||||||||||||||||%||||||
||||||--|||||||---||||||||---|||||---||||----||||||||||||||||||||||||||||||||---||||||||||||||||||||---|---|||||||||||||||||||---||||||||||---||||||||||---|||||||||||||||||||---|||||||||||||||||||||||
