--------------------------------------------------------------------------------------------------------------------------------------------------------------------------------------------------------
--------------------------------------------------------------------------------------------------------------------------------------------------------------------------------------------------------
--------------------------------------------------------------------------------------------------------------------------------------------------------------------------------------------------------
---------------------C-------------------------------------------------------------------------------------------------------------------------C-----------U------#-------------------------------------
------------------------tt----------SSC----------------------------------------------------------------------------------------DDD---D------------tt--------------#-------------------------------------
C-----------------------tt------------------%%%%%%----%%%%----y---------------------------------------C---C------------------C--------------------tt----------tt--#--D---D---------tt----#--------------
------------------------tt--r-----------g---||||||%%%%||||-%%%%%2S---g--------------------U--tt---tt--------tt---tt--#---------------------r------tt----------tt--#----------------Tt---###-------------
------D--SCSSS---%%--%%%%%%%---%%%%%%%%%%%DD||||||||||||||-|||||---SSS2S---%%%%---tt---------tt---tt---tt---Tt---Tt--#---------g-----%%--%%---%%%%%%%%%--%%%%%%%%%%%%%---%%%%%--%%%%%%%%%%%%%%%---------
-----------------||--|||||||---|||||||||||--||||||||||||||-|||||-----------||||---Tt------r--tt---tt---Tt---tt---tt--#--%%---%%%%%---||--||---|||||||||--|||||||||||||---|||||--|||||||||||||||---------
SSSSS------------||--|||||||---|||||||||||--||||SSS|||||||-|||||#----------|k||k--tt---%%%%%%%%%%%%%%%%%%%%%%%%%%%%%%%%%||---|||||---||--||---|||||||||--|||||||||||||---|||||--|||||||||||||||---------
---------D-------||--|||||||---|||||||||||--||||---|||||||%|||||%%%%%%%%%%%||||%%%%%%%%|||||||||||||||||||||||||||||||||||---|||||---||--||---|||||||||--|||||||||||||---|||||--|||||||||||||||---------
--------------r--||--|||||||---%%%||||||||tt||||---|||||||||||||||||||||||||||||||||||||||||||||||||||||||||||||||||||||||---|||||---||--||---|||||||||--|||||||||||||---|||||--|||||||||||||||---------
%%%%-------------%%%%|||||||---|||||||||||tt||||---|||||||||||||||||||||||||||||||||||||||||||||||||||||||||||||||||||||||---|||||---||--||---|||||||||--|||||||||||||---|||||--|||||||||||||||---------
||||%%--%%%%%%---||||||||||%---|||%%%%%%%%%%%%%%%%%%%%%%||||||||||||||||||||||||||||||||||||||||||||||||||||||||||||||||||---|||||---||--||---|||||||||--|||||||||||||---|||||--|||||||||||||||%%F%%%%%%
||||||--||||||---|||||||||||---|||||||||||||||||||||||||||||||||||||||||||||||||||||||||||||||||||||||||||||||||||||||||||---|||||---||--||---|||||||||--|||||||||||||---|||||--|||||||||||||||||%||||||
||||||--||||||---|||||||||||---|||||||||||||||||||||||||||||||||||||||||||||||||||||||||||||||||||||||||||||||||||||||||||---|||||---||--||---|||||||||--|||||||||||||---|||||--||||||||||||||||||||||||
