--------------------------------------------------------------------------------------------------------------------------------------------------------------------------------------------------------
--------------------------------------------------------------------------------------------------------------------------------------------------------------------------------------------------------
--------------------------------------------------------------------------------------------------------------------------------------------------------------------------------------------------------
--------------U-----------------------------------------------------------------------------------------------------------------------------------------------------------------------------------------
--------------------------------------------------------------------------------------------------------------------------------------------------------------------------------------------------------
--------------r-----------------------------------------------------------------------------------------------------------------------------------------------------------------------------------------
-BBBB-------DDDDD-D-------------------------------------------------------------------------------------------------------------------------------------------------------------------------------------
------D-BBB---------------------------------------------------------------------------------------------------------------------------------------------------------------------------------------------
---------------------------BB------------------------------------------------------------------------------------------------------------C--------------------------------------------------------------
BBBBB-------C-----C--D------------------C-C-B2BB----------------------r-k-------------------------------------rg-----g--------------%%%%----------------------------------------------------------------
---------D------------------------%%%--------------------------------%%%%------------------%%--------BB2B----%%%%--BBB2BCB----------||||----------------------------------------------------------------
------------------r-----r---------|||-------------%%%%%--------------||||---%%-------------||----tt----------||||----------tt-------||||---%%%%--------------------------------------C--#---------------
%%%%-----------%%%%%%%%---D-----%%|||-------------|||||----%%%%%%----||||---||---%%%%%%%---||----Tt------g---||||------g---Tt-----%%||||%%%||||---------tt-------------------tt---tt--U-#---------------
||||%%--%%%%%%%||||||||---D-----|||||---%%%%%--%%%|||||%%%%||||||%%%%||||%%%||---|||||||---||%%%%%%%%%%%%%%%%||||%%%%%%%%%%%%%%---|||||||||||||---------Tt-----%%%%%----tt---Tt---tt----#--%%%%%%F%%%%%%
||||||--|||||||||||||||---D-----|||||---|||||--|||||||||||||||||||||||||||||||---|||||||---||||||||||||||||||||||||||||||||||||---|||||||||||||---%%%%%%%%%%---|||||----tt---tt---tt----#--||||||X||||||
||||||--|||||||||||||||---------|||||---|||||--|||||||||||||||||||||||||||||||---|||||||---||||||||||||||||||||||||||||||||||||---|||||||||||||---||||||||||---|||||%%%%%%%%%%%%%%%%%%%%%%-||||||X||||||
