--------------------------------------------------------------------------------------------------------------------------------------------------------------------------------------------------------
--------------------------------------------------------------------------------------------------------------------------------------------------------------------------------------------------------
--------------------------------------------------------------------------------------------------------------------------------------------------------------------------------------------------------
-----------#----------------------------------------------------------------------------------B------------------C-------------------g--#--#---g-----------g--------------------------------------------
-----------#------------------------------------------g----------------2BBBBBBBBBBBBB------------%%%%%%----%%%%%--DDDDDD---------%%%%%%%%--%%%%%%%%%%%%%%%%%%%-*----------------------------------------
-----------#-------------------------------------------2B----------------------------------------||||||%%%%|||||---------------BB||||||||--|||||||||||||||||||-*--tt-----%%-----------------------------
-----------#------------------------------------------------------------------------DDDDD---DDDDD|||||||||||||||%%%%%%%B2BBBB----||||||||--|||||||||||||||||||-*--Tt-----||---%%---%%---%%%%%%----------
------D-%%%%%%--D---------DDDDDDD-----DDD-------------------------------------------------B-------|||||||||||||||||||||----------||||||----|||||||||||||DDD|||%%%%%%%%---||---||---||---||||||----------
--------||||||-------------------------B2B----U----B---B----------------------B-----DDDDD-----------------U----------------------||||||----||%||%|||||||XXX|||||||||||---||---||---||---||||||----------
BBBBB----------------------C----------------------------------------------------BBC-----tt--C-------tt--C------D--tt-D---------%%||||||-tt-|||||||||tt||XXX|||||||||||---||---||---||---||||||----------
---------D---tt--#-----tt--------D--------------------------B----g---C------------------tt-----tt---Tt------------Tt---%%%%%%%%||||||||-tt---|||||||Tt||XXX|||-----|||---||---||---||---||||||----------
-------------Tt--#-----tt-----tt-------------%%%%%-B-----------%%%%-----tt----------g---tt--r--tt---tt--r---------tt---||||||||||||||||%%%%%%|||||||%%||||||||-D---|||---||---||---||---||||||----------
%%%%---------tt--#-----tt-----tt-------%%%---|||||-----%%------||||-----tt---%%%%%%%%%%%%%%%%%%%%%%%%%%%%%%%%--%%%%%%%%|||||||||||||||||||||||||||||||||||||||------------------------------------------
||||%%--%%%%%%%%%%---%%%%%%%%%%%%%%---%|||---|||||-r---||------|k||-----tt---||||||||||||||||||||||||||||||||--|||||||||||||||||||||||||||||||||||||||||||||||-%%--%%%------------------%%%%%%%%%F%%%%%%
||||||--||||||||||---||||||||||||||---||||---|||||%%---||---%%%||||%%%%%%%%%%||||||||||||||||||||||||||||||||--|||||||||||||||||||||||||||||||||||||||||||||||-||--|||------------------|||||||||X||||||
||||||--||||||||||---||||||||||||||---||||---|||||||---||---|||||||||||||||||||||||||||||||||||||||||||||||||--|||||||||||||||||||||||||||||||||||||||||||||||-||--|||------------------|||||||||X||||||
