--------------------------------------------------------------------------------------------------------------------------------------------------------------------------------------------------------
--------------------------------------------------------------------------------------------------------------------------------------------------------------------------------------------------------
--------------------------------------------------------------------------------------------------------------------------------------------------------------------------------------------------------
-----------------------------------S--------------------------------------------------------------------------------------------------------------------------------------------------------------------
---------------------------------S------D--------G#-----------2SS-----------------------------------------------------------------------------------------------------C---g-----------------------------
--------------------------S2SS------------S----S--#--------------------------S---S-------------------------------------g----------------D-------------------------------%%%%--#----------SS-------------
--S2---------------------g------------------------#-------------------------------------------------------------S-----SSSSS-SSS----------------S------------------------||||--#--%%%--------------------
------D-SSSSS-----SSS2S2SS2S----%%%%%----------------------------------------------------------G#--------DDSS-------------------S---------------------------SSS---------||||--#--|||---------g----------
--------------2SS---------------|||||-----------------------DDDDDDD------SS-SS---S-S--SSS---rg--#-----SS-----------S----------------S-SSS---------------------------%%%%||||%%%%%|||---%%%%%%%%%%%------
SSSSS-------------U----------%%%|||||---------%%%%----y------------------------------------%%%%-#---------------%%---SSSSS--------------------%%%%%%------------g---||||||||||||||||---|||||||||||------
---------D-----------S2SSSSS-||||||||---D-----||||-%%%%%%%S--------SS----------------------||||----------g------||-----------%%%%%%-------g---||||||%%%%--%%%%%---%%||||||||||||||||---|||||||||||------
------------------r----------||||||||---D-----||||-|||||||-----D------S-SSSSS--------------||||-------%%%%%%%---||-----------||||||%%%%%%%---%||||||||||--|||||---||||||||||||||||||---|||||||||||------
%%%%-------------%%%%%-------||||||||---------||||-|||||||--------tt-------------%%%%%--%%%||||%%%%---|||||||---||%%%%%%%%%%%|||||||||||||---|||||||||||--|||||---||||||||||||||||||---|||||||||||------
||||%%--%%%%%%%%%|||||SSSSSS2S|||||||---%%%---||||-|||||||--------Tt--r-----g----|||||--|||||||||||---|||||||---||||||||||||||||||||||||||---|||||||||||--|||||---||||||||||||||||||---|||||%%%%%F%%%%%%
||||||--||||||||||||||--------|||||||---|||---||||%|||||||%%%--%%%%%%%%%%%%%%%---|||||%%|||||||||||---|||||||---||||||||||||||||||||||||||---|||||||||||--|||||---||||||||||||||||||---||||||||||%||||||
||||||--||||||||||||||--------|||||||---|||---|||||||||||||||--|||||||||||||||---||||||||||||||||||---|||||||---||XXXX||||||||||||||||||||---|||||||||||--|||||---||||||||||||||||||---|||||||||||||||||
