--------------------------------------------------------------------------------------------------------------------------------------------------------------------------------------------------------
--------------------------------------------------------------------------------------------------------------------------------------------------------------------------------------------------------
--------------------------------------------------------------------------------------------------------------------------------------------------------------------------------------------------------
----------------------------#---------------------------------------------------------------------------------------------------------------------------------------------------------------------------
------------------------#---#-----------------------------------%%%%%---#--#--------g-------------------------------------------------------------------------------------------------------------------
---------------#--#----###--#--#----#--#------------%%%%----g---|||||DDDD--%%%--D----2SS----r-k-------------------------------------------------------------------------------------------DDDDDD--------
-------------DDD--%%%%%%%%%%%%%%---%%--%%%--%%%--%%%||||-%%%%%%%|||||------|||-------------%%%%-------C-SS----D-----S2-------------------------------------------------------D---%%--%%---D-------------
------D--2SS------||||||||||||||---||--|||--|||--|||||||-||||||||||||------|||-C-----------||||---tt---------------------------%%%%----g--g------------G#--------------------D---||--||---D-------------
------------------||||||||||||||---||--|||--|||--|||||||-||||||||||||-----C|||---C---------||||---Tt--r-----g----------g-------||||-%%%%%%%%%%%SC---r---#-------S------------D---||--||---D-------------
SSSSS-------------||||||||||||||---||tt|||--|||--|||||||-|||||||%*|||------|||---------%%%%|||D%%%%%%%%%%%---%%%%---%%---%%---%||||-|||||||||||----%%%%-#-----U----tt--#--tt-D---||--||---D-------------
---------D--S-----||||tt||||||||---||tt|||--|||--|||||||%||||||||*|U|------|||---------|||||||||||||||||||---||||---||---||---|||||-||||D||||||----||||------------Tt--#--tt-----||--||---D-------------
---------------tt-||||Tt|||%%%%%---||tt|||%%%%%--||||||||||||||||*|-|-SS---||DDDDD---%%|||||||||||||||||||---||||---||---||---|||||-||||-||||||----||||------------tt--#--tt-----%%%%||-----------------
%%%%--------r--tt-||||tt||||||||---%%%%%%%|||||--||||||||||||||||*|r|----SSC|--------|||||||||||||||||||||---||||---||---||---|||||%||||%||||||%%%%||||%%%---%%%%%%%%%%%%%%%%%---||||%%-----------------
||||%%----%%%%%%%%%%%%%%%%%|||||---||||||||||||%%%%%|||||||||||DDDDDDDD-----|--------|||||||||||||||||||||---||||---||---||---||||||||||||||||||||||||||||---|||||||||||||||||---||||||----%%%%%%F%%%%%%
||||||----||||||||||||||||||||||---|||||||||||||||||SSSSS|||||||-D----------|g-------|||||||||||||||||||||---||||---||---||---||||||||||||||||||||||||||||---|||||||||||||||||---||||||----||||||%||||||
||||||----||||||||||||||||||||||---|||||||||||||||||-----|||||||------XXXXXXXXXXX----|||||||||||||||||||||---||||---||---||---||||||||||||||||||||||||||||---|||||||||||||||||---||||||----|||||||||||||
