--------------------------------------------------------------------------------------------------------------------------------------------------------------------------------------------------------
--------------------------------------------------------------------------------------------------------------------------------------------------------------------------------------------------------
--------------------------------------------------------------------------------------------------------------------------------------------------------------------------------------------------------
-------------------------------B--B-----C----------------------#----------------#--#------------------------------C-B---------C-------------------------------------------------------------------------
-------------BBBCB-----------------------------%%%%%%---#--#--###-------------%%%--%%BBB2B2BB---BC%%-*------B-#-BB-----D-----------D-------tt---tt--------------------%%%-------------------------------
-------------------------%%%%------------%%%---||||||%%%%--%%%%%%%%----BBBBBB-|||--||-------------||-*--tt----#-------------#---------tt---tt---Tt----------%%----g---|||-------B----%%%%---------------
-BBB-----------------g---||||----%%----g-|||---||||||||||--||||||||----------------||-------------||-*--tt----#-----g------###--------Tt---tt---tt----------||-%%%%%%%|||-BB---------||||---------------
------D-BBBBBBBBBBC%%%%%%||||%%%%||---BB2B-----||||||||||--||||||||----B-B---------BB-BBB-BBB---BB||%%%%%%%%%%%%%%%%%%%%---%%%%%%--%%%%%%%%%%%%%%%DDD--%%---||-|||||||||-------------||||---------------
-------------------||||||||||||||||------------||||||------||||||||--------%%%%-------------------||||||||||||||||||||||---||||||--|||||||||||||||-----||---||-|||||||||-------%%%%%%||||%%-------------
BBBBB--------------||||||||||----||------B---------BB---r-k------BB--------||||---tt--------------||||||||||||||||||||||---||||||--|||||||||||||||-----||---||-|||||||---------||||||||||||-------------
---------D---------||||||-------D----------------------%%%%--BBC-----------|k||---Tt--------------||----||-D----------B----||||||--|||||||------#------||---||%|||||||%%%%%%---||||||||||||-------------
-----------------%%||||||-------------------------tt---||||-----------%%%%%||||%%%%%%%%%%%%%%----%||%%%%||-D---------------||||||--|||||||------#--%%%%||---||||||||||||||||---||||||||||||-------------
%%%%-------------||||||||----------r----%%%%------tt---||||------g----|||||||||||||||||||||||----|||||||-------------------||||||--|||||||------#--||||||---||-|||||||||||||---||||||||||||-------------
||||%%--%%%%%%%%%||||||r|-%%%%%--%%---%%||||---%%%%%%%%||||%%%%%%%%---|||||||||||||||||||||||-----||-|||%%%%%%%%%%%%%%%%-------------|||--%%--%%%%%||||-----||%|||||||||||||---||||||||||||---%%%F%%%%%%
||||||--|||||||||||||||||%|||||%%||---||||||---||||||||||||||||||||---|||||||||||||||||||||||-----||-|||||||||||||||||||---D---------|||--||--|||||||||-----||||||||||||||||---||||--||||||---|||X||||||
||||||--|||||||||||||||||||||||||||---||||||---||||||||||||||||||||---|||||||||||||||||||||||-----||-|||||||||||||||||||-------------|||--||--|||||||||-----||||||||||||||||---||||--||||||---|||X||||||
