--------------------------------------------------------------------------------------------------------------------------------------------------------------------------------------------------------
--------------------------------------------------------------------------------------------------------------------------------------------------------------------------------------------------------
--------------------------------------------------------------------------------------------------------------------------------------------------------------------------------------------------------
--------------------------------------------------------------------------------------------------------------------------------------------------------------------------------------------------------
--#--------BB2BB-----------------------------------------------#-B-----------%%%--------#--------------------------------------------------------------------C----B2BBBBBBBBB---------------------------
--#----------------------------------------------U-#--tt---tt--#--------B2BB-|||-----D--#----D-----------B2BBBBBB---------------------------------------------------------------------g--g--------------
--#-----------------------------------------C------#--Tt---tt--#K----%%%%%%D-|||--------#K-------------------------------------------------------------------------------------tt--BCBB2BB--------------
DDDDD-D-B2BBBBB---------------D------------------r-#--tt---tt--#-----||||||--|||--------#--------------------------------------------------------------------------------------Tt-----------------------
--D--------------------------------------------%%%%%%%%%%%%%%%%%%%---|||-----|||%---DDDDDDDDDDD---D--------------------------B-------------------B------tt--BBB--------------DD%%DDD--------------------
--D------------BBB-B-------------------------r-|||||||||||||||||||---|||-----||||-------------------------------DD---DD---------------------------------tt----------%%%%-------||-----------------------
--D------D--------------------tt-D---%%%%%BC%%%|||||||||||||||||||---|||-------||---DDDDDD------------------BBB-----------------tt---tt----------r------tt------g---||||-%%%%---------------------------
-------------------------tt---Tt---tt|||||--||||||||||||||||||||||---|||-------||-------Dtt-------------tt-----------#----------Tt---Tt---%%%%DDD%%%%%%%%%%%%%%---%%||||-||||--------tt-----------------
%%%%---------------------Tt---tt---tt|||||%%||||||||||||||||||||||---|||-------||-------DTt---D---%%----tt------g----##---%%%%%%%%D%%%%%%%||||---||||||||||||||---||||||-||||%%%%----tt-----------------
||||%%--%%%%%%%--%%%---%%%%%%%%%%%%%%|||||||||||||||||||||||||||||---|||-------||--------tt-------||%%%%%%%%%%%%%%---%%---||||||||-|||||||||||---||||||||||||||---||||||-||||||||----tt------%%%%F%%%%%%
||||||--|||||||--|||---|||||||||||||||||||||||||||||||------------------------------%%%%%%%%%%%---||||||||||||||||---||---||||||||-|||||||||||---||||||||||||||---||||||%||||||||%%%%%%%%%---||||X||||||
||||||--|||||||--|||---|||||||||||||||||||||||||------------------------------------|||||||||||---||||||||||||||||---||---||||||||-|||||||||||---||||||||||||||---||||||||||||||||||||||||---||||X||||||
