--------------------------------------------------------------------------------------------------------------------------------------------------------------------------------------------------------
--------------------------------------------------------------------------------------------------------------------------------------------------------------------------------------------------------
-----C--------------------------------------------------------------------------------------------------------------------------------------------------------------------------------------------------
--------------------------------------------------------------------------------------------------------------------------------------------------------------------------------------------------------
------------------------------------------------------------------------------------------------------------------------------------------------------------C-------------------------------------------
----------------------------------------------------C-------------------------------C-------------------------------------------------------------------------------------------------------------------
%%%%%%%------------------------------------------------------------------------------------r-k----------------------------------------------------------------SSS---C------------C----------------------
|||||||----------------------------------------------------------------------------------%%%%%-------------tt-----S---------------------------%%-------------------------------C------------------------
||||||G#-D---------------------------------------------------C---r-k---------------------|||||-------------tt-----------------tt--------------||----tt----SS2SS------------tt-------tt------------------
|||||||#-----------------------------------------C-SSSS----tt---%%%%---tt--#-------tt----|||||---%%%%------tt------g----------Tt-----%%%%%%---||----tt---------------------Tt-------Tt------------------
|||||||#-----------------r---------------------------------Tt---||||---tt--#--tt---Tt---%|||||%DD||||---%%%%%%%---%%---%%--%%%%%%%%%%||||||---||%%%%%%%%%--%%%--D---%%--%%%%%%%%%%%%%%%%%%--------------
|||||||-----D-----------%%%%---------------------------g---tt---||||---tt--#--Tt---tt---|||||||--||||---|||||||---||---||--||||||||||||||||---|||||||||||--|||--D---||--||||||||||||||||||--------------
|||||||------------tt---||||---tt---tt------------%%%%%%%%%%%%%%||||%%%%%%%%%%%%%%%%%%%%|||||||--||||---|||||||---||---||--||||||||||||||||---|||||||||||--|||--D---||--||||||||||||||||||--------------
|||||||--#--#------tt---|k||k--Tt---tt-----%%%%%%%|||||||||||||||||||||||||||||||||||||||||||||--||||---|||||||---||---||--||||||||||||||||---|||||||||||--|||--D---||--||||||||||||||||||---%%%%F%%%%%%
|||||||-%%--%%%%%%%%%%%%||||%%%%%%%%%%%%%%%||||||||||||||||||||||||||||||||||||||||||||||||||||--||||---|||||||---||---||--||||||||||||||||---|||||||||||--|||--D---||--||||||||||||||||||---||||%||||||
|||||||-||--|||||||||||||||||||||||||||||||||||||||||||||||||||||||||||||||||||||||||||||||||||--||||---|||||||---||---||--||||||||||||||||---|||||||||||--|||------||--||||||||||||||||||---|||||||||||
