--------------------------------------------------------------------------------------------------------------------------------------------------------------------------------------------------------
--------------------------------------------------------------------------------------------------------------------------------------------------------------------------------------------------------
--------------#-----------------------------------------------------------------------------------------------------------------------------------------------------------------------------------------
--------------#--------------------------C--------------------------------------C-------------------------------------------------------C---------------------------------------------------------------
--------------#K-tt----------#--------------C---------------------SS2--D-------------------C----SS----------------SSS------%%---------------------------------------------------------------------------
--------------#--Tt--#--#----#---------------------D-SSS-S----------------tt------------------------tt---tt-----------SS---||---------------------------------------------------------------------------
--SCS-------%%%%%%%%%%--%%---#----------------------------------------g---Tt---%%%%-----------------Tt---tt---%%%%%--------||---%%----------------------------------------------------------------------
------D-SSS-||||||||||-%||---%%%---------S-----k----------------DDDDDDD%%%%%%%%||||-----------------tt---tt---|||||-------g||---||-%%%%%%%%%------------------------------------------------------------
------------||||||||||-|||---|||------------%%%%------D-----SSS--------||||||||||||---DD---DD----DDDDDDDDDDDDD|||||DDDDD---DD---||-|||||||||------------------------------------------------------------
SSSSS-------|||S|||U|SSS|S---|||-S----------||||---tt---%%%%%%D--------||||||||||||---------------------------|||||-------------||-||D||||||------------------------------------------------------------
---------D--|||-|||-|---|----#||---C--------|k||---tt---||||||---------|||#||||#|||---------------------------|||||-------------||-||-|||||DDDDDDD-g----------------------------------------------------
------------|tt-|||-|---|----#||--------%%%%||||%%%%%%%%||||||---U---%%|||#||||#|||---------#----------#--#--%%%%%%-------------||%||%||||||-----SSS2SS--%%%%---%%%%--U-------tt--#---------------------
%%%%--------|tt-||%%%%%%|--r-#||---r----||||||||||||||||||||||D---%%%|||||#||||#|||---%%---%%---%%%%%%%%--%%%||||||%%%%----SC---|||||||||||*-------------||||---||||-----tt---tt--#---------------------
||||%%--%%%%%%%%%%||||||%%---%%%%%%%%---||||||||||||||||||||||----|||||D%%%%%%%%%%%---||---||---||||||||--|||||||||||||---------|||||||||||*-------------||||---||||-----Tt---tt--#-------%%---%%F%%%%%%
||||||--||||||||||||||||||---||||||||---||||||||%%%|||#||#||||----|||||-|||||||||||---||---||---||||||||--|||||||||||||---------%%%||||||||*--%%%%%%%%%%%||||%%%||||%%%%%%%%%%%%%%%%%---%%||---||%||||||
||||||--||||||||||||||||||---||||||||---|||||||||||XXXX||XXXXXXXXXXXX||-|||||||||||---||---||---||||||||--|||||||||||||---------|||||||||||XXX|||||||||||||||||||||||||||||||||||||||---||||---|||||||||
