--------------------------------------------------------------------------------------------------------------------------------------------------------------------------------------------------------
--------------------------------------------------------------------------------------------------------------------------------------------------------------------------------------------------------
--------------------------------------------------------------------------------------------------------------------------------------------------------------------------------------------------------
----------------------------U------#-C-------------------------------g----------------------------------------#----------#------------------------------------------------------------------------------
-------------------------------tt--#-----#-----------------------D-BBB2B---------------------------C--------DDD----D---DDD----D-------------------------------------------------------------------------
------------%%%%%----%%%%%%-r--tt--#-r--###---------------------------------------%%%------%%%%------D--BBC--------D---D------DG#-----------------------------------------------------------------------
------------|||||%%%%||||||%%%%%%%%%%%%%%%%%%%------------------------------------|||------||||--------------------D---D------D-#-------BB--------------C-----------------------------------------------
------D%%%%%||||||||||||||||||||||||||||||||||--------------%%---%%%%%%%-----D---D|||------||||---%%%%%----------------D------D-#-----------tt---tt--------------------------------------G#-------------
-------|||||||||||-------------||------------------k--C-----||---|||||||----------|||---DDDD|||%%%|||||%%%%%%%%%--------------D--------tt---Tt---Tt---tt--------%%%%----g-----------------#-------------
-B2BB--|||||---------D-------D-----D--D---D---D-%%%%-----%%%||--------------------|||------X||||||||||||||||||||---D---DD%%------------Tt---tt---tt---tt--------||||-%%%%%-----g----------#-------------
-------|||||--------------tt-------tt-----------||||-----|||||---BCB--------C--------------g|||----------------------B---||---%%%%---%%%%%%%%%%%%%%%%%%%%%%----D||||-|||||---%%%%-----------------------
-------|||||--------------Tt-------Tt-----------|k||-----|||||-------------------%%%-----BBX|||-------BB-----------------||---||||---||||||||||||||||||||||-----||||-|||tt---||||-----------------------
%%%%---|||||-%%%%%%--%%%%%%%%%%%%%%%%%%%%%%%%%%%||||%%%%%|||----------%%----r----|||-------X|||-----------%%%%-----------||---||||---||||||||||--||-------------||||-|||tt---||||-----%%%%%%------------
||||%%-|||||%||||||--|||||||||||||||||||||||||||||||||||||||BB---BBBB-||---%%%---|||-------X|g|--%%%%%----||||-----%%%%--||------#----------||---||--%%%%%%-----||||%|||%%%%%||||%%---||||||%---%F%%%%%%
||||||-||||||||||||--|||||||||||||||||||||||||||||||||||||||----------||---|||---|||%---%%%||||%%|||||----||||-----||||---#-----##----%%%%%%||-#--#--||||||%---%|||||||||||||||||||---|||||||---|X||||||
||||||-||||||||||||--|||||||||||||||||||||||||||||||||||||||----------||---|||---||||---||||||||||||||%%%%||||%%---||||%%%%---%%%%---%||||||||%%--%%%|||||||---||||||||||||||||||||---|||||||---|X||||||
