--------------------------------------------------------------------------------------------------------------------------------------------------------------------------------------------------------
--------------------------------------------------------------------------------------------------------------------------------------------------------------------------------------------------------
--------------------------------------------------------------------------------------------------------------------------------------------------------------------------------------------------------
--------------------------------------------------------------------------------------------------------------#-----------------------------------------------------------------------------------------
-----------C--------------------------C--------------y-----------------------------2SS---U--------%%---D----DDD---D------g-------------------------------------------------#----------------------------
----DDDDDDD------DDDDDDD--DDD-D---------%%%-----D-%%%%%%%%%%%S2S-----r------g--------------DDDD---||SS-D---SD-----D-SSSSSS2SC%%%%%%%%%%%%----D-------------------------tt--#--%%%%-------#--------------
-SS-------------------------------------|||-------|||||||||||----S--%%%%--SSSS2---------------G#--||---D----D-----D----------||||||||||||----------%%%---------%%------Tt--#--||||---tt--#--------------
----------------SS--------------------g-|||-S---SS|||||g|||||S------||||-----------------------#--||---D----D----------------||||||||||||----------|||---------||------tt--#--||||---tt--#--------------
------G#-D-SSC----%%%-*-------tt-D%%%%%%%||-------|||%||%||||-------|k||-----------------%%-S--#--||-------------------------|DDDDDDD||||%%%%%%---%|||---%%%---||%---%%%%%%%%%||||%%%%%%%%%-------------
SSSSS--#----------|||-*--tt---tt--|||||||||-------|||||||||||---%%%%||||%%%%%%%---%%%%---||--DDDDDDD---D----DDD---D----------||||||||||||||||||---||||---|||---|||---||||||||||||||||||||||-------------
-------#-------SSS|||-*--Tt---tt--|||||||||---r---|||||||k|||---|||||||||||||||---||||---||------------------------S2SS------|||||||||*||||||||---||||---|||---|||---||||||||||||||||||||||-------------
---------#--D-----|||%%%%%%%%%%%%%D||||||DDDD---DDDDDDDDDDDDDDDD|||||||||||||||---||||---||DDDDDS--------g---------------tt--|||%||%||*||||||SS---||||---|||---|||---||||||||||||||||||||||-------------
%%%%-----#--------|||||||||||||||||||||||---------|||||||||||---|||||||||||||||---|D||---||--------tt--S---SS------------Tt--D||||||||*||tt||-----|||D---D|S---|||---||||||||||||||||||||||-------------
||||%%---#--------|||||||||||||||||||||||---------|||||||||||---|||||||||||||||---|-||---||--------tt-------------%%%----tt---||||||||*||tt||----g|||----D|----|||---||||||||||||||||||||||%%---%F%%%%%%
||||||-%%%%%%%%%%%DDDDDD|||%%%%%|||||||||-------#-|||||||||||---||||||||||#||||---|-||---||--------tt-------------|||%%%%%%%%%||||||||%||%%%%%%---%%%%----|----|||---||||||||||||||||||||||||---|%||||||
||||||-||||||||||||||-S2SS||||||XX|||||||--XX---XX|||||||||||XXXX||X||||||XXXXX---|-||---XXX--XXXXXXXXXX---XXXX---|||||||||||||||||||||||||||||---||||---XXX---XX|---||||||||||||||||||||||||---||||||||
