--------------------------------------------------------------------------------------------------------------------------------------------------------------------------------------------------------
--------------------------------------------------------------------------------------------------------------------------------------------------------------------------------------------------------
--------------------------------------------------------------------------------------------------------------------------------------------------------------------------------------------------------
--------------------------S-----------------------------------#--#-------#--#-------#--#----------------------------------------------------------------------------------------------g-----------------
-----------SCS--------------#--D-D---tt--S------------------DDD--%%%---DD---%%%----DD--%%%----DDD------------------------------------------------------------------------------------SSSSS--------------
---------------------%%%%---#--------Tt----------S2SSSSSSSS------|||---D-%%%|||--------|||SSS---------------------------------------------------------------C-------------------------------------------
---------------------||||---#--------tt--r-----SS----------------|||---D-||||||--------|||---------------------------------------------------D--SS----SSS-----------------------------------------------
------D-SSSSSSSCSS---||||%%%%%%%%%%%%%%%%%%%%%-------------------|||---D-||||||--------|||----------S----------------------------------------------------------------------------D-SSSSS----------------
---------------------|||||||||||||||||||||||||-------------------|||-----||||||--------|||------tt------------------------------------------------------------------------------------------------------
-S2SS----------------|||||||||||||||||||||||||SSSS----g-----SSDDDDDD---DD||||||----DDDDDD|------tt--r--------------------S-------%%%%-----D-----D-----SSS---S-------------------------------------------
---------D-----------%%||||||||||||||||||||S||------%%%%-----------------||||||----------%%%%%%DDDDDDDD------------C--------tt---||||--------tt---D---%%%------SS2S---------tt---tt-D-------------------
-----------SSSSSSS---||||SSSD||g|||||||||||-|S------||||---tt------------||||||----------||||||-----------------CS-------r--Tt---||||--------tt-------|||-------------------Tt---tt---%%%%%%DD----------
%%%%-----------------||||----SSS2SCS|||D|||-|-------||||k--tt---SSSSS----||||||-------tt-||||||--------------------------%%%%%%%%||||%%%--%%%%%%%%%---|||----#-----g--------tt---tt---||||||------------
||||%%--DDDDDDDD-----||DDDDD--------|||-|||-|r--%%%%||||%%%%%DDDDD-------|tt|||D---DDDtt-||%%%%%%----%%-----------g------|||||||||||||||--|||||||||---||%----%%%%%%%%%%--%%%%%%%%%%%%%||||||%%%%%F%%%%%%
||||||---------------||----------g--|||-||%%%%%%|||||||||||||---------g--|Tt|||-------tt-||||||||%%%%||---%%%---%%%%%%---|||||||||||||||--|||||||||---|||----||||||||||--||||||||||||||||||||||||%||||||
||||||-----XXXXXXX---||----XXXXXXXXXX||XXX|||||||||||||||||||XXXXXXXXXXXXXXXXXXX---XXXXXXXX||||||||||||---|||---||||||---|||||||||||||||--|||||||||---|||----||||||||||--|||||||||||||||||||||||||||||||
