--------------------------------------------------------------------------------------------------------------------------------------------------------------------------------------------------------
--------------------------------------------------------------------------------------------------------------------------------------------------------------------------------------------------------
--------------------------------------------------C-----C-----------------------------------------------------------------------------------------------------------------------------------------------
------------------------#-------------------------------------------------------------------------------------------------------------------------------------------------------------------------------
--------------------tt--#------#------------------------------------------------------DDD---DDDDD-------------------------------------------------------------------------------------------------------
--------------#--#--tt--#------#-----------------------------------------C--------BBC---BBC-------------------------------------------------------------------------------------------------------------
-BC---------%%%--%%%%%%%%%%----#------BBB---DDDDDDD-----%%%%%%------------------B-----------------------------------------------------------------------------------------------------------------------
------D-BBB-|||--||||||||||BBBDDDDD---------------------||||||---------------#--------------------------------------------------------------------------------------------------------------------------
------------|||--|||||||||-----D-------------BB-----------B------B---U-----k-#--------------------------------------------------------------------------------------------------------------------------
BBBBB-------|||2BB--||B--------D-----------------------------tt---------%%%%-#-----DDDDDD---DDDD--------------------------------------------------------------------------------D-BBCBBBC---------------
---------D--B-----------D------D--------D---D----------------Tt---------||||---%%%%----g-------2B--------------------------------r-k--------------------------------------------------------------------
--------------------tt---%%%%%%------------------%%%---------tt---------|k||---||||-%%%%%--B------------------------------------%%%%--------------------------------------------------------------------
%%%%--------r-------tt---||||||%%-----%%%---%%%%%|||---%%%%%%%%%%%%%%%%%||||%%%||||-|||||---------------------B-----------------||||---%%%%----------tt-----------------U--tt---tt-D--------------------
||||%%--%%%%%%%--%%%%%%%%||||||||-----|||---||||||||---||||||||||||||||||||||||||||-|||tt---------------------------------------||||---||||-----tt---Tt---tt---------------tt---tt---%%%%--%%%%%%F%%%%%%
||||||--|||||||--||||||||||||||||-----|||---||||||||---||||||||||||||||||||||||||||-|||Tt-----------%%%%-------g-----------%%%%%||||%%%||||-----Tt---tt---Tt---%%%%%%---r--tt---tt---||||--||||||X||||||
||||||--|||||||--||||||||||||||||-----|||---||||||||---||||||||||||||||||||||||||||%|||%%%%%%%%%%---||||%%%---%%%%%--%%%---||||||||||||||||---%%%%%%%%%%%%%%%%%||||||%%%%%%%%%%%%%%%%||||--||||||X||||||
