--------------------------------------------------------------------------------------------------------------------------------------------------------------------------------------------------------
--------------------------------------------------------------------------------------------------------------------------------------------------------------------------------------------------------
--------------------------------------------------------------------------#-----------------------------------------------------------------------------------------------------------------------------
---------C-------------------------------------------------C--------------#-----------------------------------------------------------------------------------------------------------------------------
------------------tt---%%%%%----%%%%-----tt------SSS----------------------#K-tt-------------------------------------------------------C----------------D------------------------------------------------
------------------tt---|||||----||||-----tt---tt-------------%%%%%%-------#--Tt--------------------------------------------U-------tt-------------------------------------------------------------------
-------------DDDDDD%%%%|||||%%%%||||-----tt---Tt---%%%%%%----||||||%%---%%%%%%%%%--------------------------------------------------Tt---------------r-k-----------------------------g-------------------
------D--2SC-------|||||||||||||||||---%%%%%%%%%%%%||||||%%%%||||||||---|||||||||---------------------------S2SSSS---------r-------tt---%%%%----C--%%%%-----D------tt-------------SSS-------------------
-------------------|||||||||||||||||---||||||||||||||||||||||||||||||---|||||||||---------------C------------------------%%%%%--%%%%%%%%||||-------||||------------Tt---------tt------------------------
SSSSS--------------|||||||U|||||||||---||||||||||||||||||||||||||||||---|||||||||--------SSC---------------------------g-|||||--||||||||||||----r--||||------------tt---------tt----------%%%%%%%%------
---------D--C------|||||||-|||||||||---||||||||||||||||||||||||||||||---|||||||||----------------tt---tt---tt--------%%%%|||||%-||||||||||||---%%%%||||%%---%%--%%%%%%%%---%%%%%%%%%%---%%||||||||------
-------------------|||||||-|||||||||---||||||||||||||||||||||||||||||---|||||||||------------gr--tt---tt---Tt---%%%%%%%D|||||||-||||||||||||---||||||||||---||--||||||||---||||||||||---||||||||||------
%%%%--------r------|||||||-|||||||||---||||||||||||||||||||||||||||||---|||||||||---%%%%%%%%%%%%%%%%%%%%%%%%%%%%|||||||||||||||-||||||||||||---||||||||||---||--||||||||---||||||||||---||||||||||------
||||%%--%%%%%%%--%%%||%%%%%%%%%%||||---||||||||||||||||||||||||||||||---|||||||||---|||||||||||||||||||||||||||||||||||||||||||-||||||||||||---||||||||||---||--||||||||---||||||||||---||||%%%%%F%%%%%%
||||||--|||||||--|||||||||||||||||||---||||||||||||||||||||||||||||||---|||||||||---|||||||||||||||||||||||||||||||||||||||||||-||||||||||||---||||||||||---||--||||||||---||||||||||---|||||||||%||||||
||||||--|||||||--|||||||||||||||||||---||||||||||||||||||||||||||||||---|||||||||---|||||||||||||||||||||||||||||||||||||||||||-||||||||||||---||||||||||---||--||||||||---||||||||||---||||||||||||||||
