--------------------------------------------------------------------------------------------------------------------------------------------------------------------------------------------------------
--------------------------------------------------------------------------------------------------------------------------------------------------------------------------------------------------------
--------------------------------------------------------------------------------------------------------------------------------------------------------------------------------------------------------
----------------------------------------------B---B-----------------------------------#----------#--#----------------------#--------------------------------------C-------------------------------------
-------------BBB--------U-B----BBB----------C------------%%%%----y--------------%%%%%%%----D---DDD--%%%-----DDDDDDD---%%---%%%-----------------------------------------B-------tt-----------------------
---------2BB-----BBBB------------------------------------||||-%%%%%%----#-------|||||||----D---D----|||---------------||---|||--------------------------------#----tt----------Tt---tt---tt-------------
-------------------------------------------------%%%%%%%%||||-||||||-D--#--D-D--|||||||----D---D----|||---------------||---|||---C---------------------------###---tt------g---tt---tt---Tt-------------
---------------------g----------g----------%%%%%%||||||||||||-||||||----#K-----------------D---D----|||------%%%%%%--------|||--------------------%%%%%%--%%%%%%%%%%%%%%---%%%%%%%%%%%%%%%%%%---D-------
------G#-------%%%%%%---%%%%---%%%%%-----%%||||||||||||||||||-||||||%%%-#------------------D--------|||------||||||--------|||------%%%%%%--------||||||--||||||||||||||---||||||||||||||||||---D-------
-B2BB--#-BBC%%%||||||---||||---|||||-----||||||||||||||||||||%|||||||||%%%%%%%%DDDDDDDD----D---DDDDD|||------||||||---DD---|||------||||||%---%%%%||||||%%||||||||||||||---||||||||||||||||||---D-------
-------#----|||||||||---||||---|||||-----||||||||||||||||||||||||||||||||||||||---------------------------DD------------------DDD%%%|||||||---||||||||||||------||||||||---||||||||||||||||||---D-------
------------|||||||||---||||-------------|||||---------B------|||||||||-----------rg--------------BBB--------BBB-D--B------------||||||||||---||||||--#---------||||||||---||||||||||||||||||---D-------
%%%%----BBBB2--||||||---||||---------------------%%%%%-------D||||||----DBBB2BB--%%%%--B------B-U-----------------------------------------------------#--%%%%--------------|||||||||--|||||||-----------
||||%%---------||||||---||||---------------------|||||---2BB--||||||----D--------||||-----------------------#--------------%%%%-------------------tt--#--||||--------------------------||||||---%F%%%%%%
||||||-------------------------%%%%%%%----%%%%%%%|||||---%%%%%||||||---------g---||||k-----g--r----%%%%-----%%%%-%%%%%%%---||||---------%%%-------Tt--#--||||--------------------------||||||---|X||||||
||||||-BBBBBBB2B---------------|||||||----||||||||||||%%%|||||||||||%--%%%%%%%%%%||||%%%---%%%%%%%%||||----%||||%|||||||---||||%%%%--%%%|||---%%%%%%%%%%%||||%%%--%%%%%%---------------||||||---|X||||||
