--------------------------------------------------------------------------------------------------------------------------------------------------------------------------------------------------------
--------------------------------------------------------------------------------------------------------------------------------------------------------------------------------------------------------
--------------------------------------------------------------------------------------------------------------------------------------------------------------------------------------------------------
--------------------------------------------------------------------------------------------------------------------------------------------------------------------------------------------------------
--------------------------------------------------------------------------------------------------------------------------------------------------------------------------------------------------------
-----------------------------------------------------------------------------------------------------------------------------------------------------------------------B2B-----------C-----DD---DD------
------------------------------------------------------------------------------------------------------------------------------------------------------------------BBB----#-------------BBB--------------
-------------------------------------------------------------------------------------------------------------------------------------------------------------------------#------------------------------
------G#---------------------------------------------------------------------------------------------------------------------U--BB2B-------------tt-------------------g--#--%%%%%----------g------------
-B2BB--#-BB2B--------------k-------------C------------------------------------------------------------------------------%%--------------tt-------tt---tt---%%%---%%%%%%%%%%%|||||---%%%%%%%%%---%%%-----
-------#----------------%%%%---------------------------------------------------------------------------g----------------||----------g---Tt-------tt---Tt---|||---||||||||||||||||---|||||||||---|||-----
------------------------||||------------------------r-----------------------------%%%%--------%%%%-BBBBB-------------%%%||%%%%%%%%%%%%%%%%%%%%%%%%%%%%%%%%%|||---||||||||||||||||---||||||||------------
%%%%----BBBB2-----------|k||--------------%%%%%----%%%%--C------------------------||||--------||||---------#----%%%%%%%%||||||||||||||||||||||||||||||||||||||---||||||||||||||||---||||||||------------
||||%%-------BBC---BB%%%||||%%%%%%%%%--%%%|||||----||||-----tt---D---%%-----------||||--------||||--#--#---##---||||||||||||||||||||||||||||||||||||||||||||||---||||||||||||||||---||||||||%---%F%%%%%%
||||||-----------g---||||||||||||||||--||||||||----|k||-----Tt-------||%%%%--%%%%%||||%%%--%%%||||%%%--D---%%%%%||||||||||||||||||||||||||||||||||||||||||||||---||||||||||||||||---|||||||||---|X||||||
||||||--B2BBBBBB---B-||||||||||||||||--||||||||%%%%||||%%%%%%%%%%%---||||||--||||||||||||--||||||||||------|||||||||||||||||||||||||||||||||||||||||||||||||||----------------------------|||---|X||||||
