--------------------------------------------------------------------------------------------------------------------------------------------------------------------------------------------------------
--------------------------------------------------------------------------------------------------------------------------------------------------------------------------------------------------------
-----------------------------------------------------------------------------------------------------------------------------------------------#--------#-----------------------------------------------
-------------------------------C-----------------------------g-----y----------------C----------------------------------------------------------#--------#-----------------------------------------------
----------------------------D----------------------%%%%%%%%%%%%%%%%%%%%%--------------------------------------2S-------------------#-----------#--------#-----------------------------------------------
---------------------------------------------------|||||||||||||||||||||--S-S-------------------SSS-------------------------%%%%---DDD--DD---DDDDD--DDDDDDD---------------------------------------------
-SC-------------------------------------------S---SS||||||||||||||||||||-------tt--------%%%------------S-C-----g----SS-----||||---------SSS---D--------D-----------------------------------------------
------D%%%%-D----------%%%--DDDD--------------------|SSS||||||||||||||||-------tt---D---%|||------------------SSS2S---------||||---------------D-SS-----D---------------------------------#-------------
-------||||------------|||--------------------------|---||||||||||||||||-------tt-------||||----SS-S----------------tt------|||C---------------D----SSS-----tt--------SS-------------#-U--#-------------
SSSSS--||||--------g---|||-------S---r-k------S-----|---|g||||||||||||||%%%%%%%%%%%%D---||||------------------------tt------%%|----------------Dtt----------tt-----------------%%%%--#----#-------------
-------||D|----D-SSS2S-||tt--#-U----%%%%------------%%%%%||DDDDDD|||||||||||||||||||----|S||-----------%%DD---DDDDDDDDDDD---|||----%%%%%--------tt------g---tt---%%-------tt---||||--#------------------
-------||-|------------||Tt--#------||||---tt-------||||||||||||||||||||||||||||||||----|-||-----------||-------------------||DD---|||||%%%%%%%%%%%%%%%%%%%%%%%%%||-------Tt---||||--#------------------
%%%%---||-|----------g-||tt--#-r----||||---tt-------|||||||||||||||||||||||||D||S|#|----|-||------%%---||-------------------||-D---||||||||||||||||||||||||||||||||---%%%%%%%%%||||%%%%%%---------------
||||%%-|%%%%%--%%%%%%%%%%%%%%%%%%%%%||||%%%%%%%---%%DDD||||||||||||||||tt||||-||-|#|----%%%%---%%-||---||-----%%%%%%--------||-----||||||||||||||||||||||||||||||||---|||||||||||||||||||%%---%%%F%%%%%%
||||||-||||||--||||||||||||||||||||||||||||||||---||---||||||||||||||||Tt||#|-#|r|#|----||||---||-||---||-----||||||%%%%----SC2S---||||||||||||||||||||||||||||||||---|||||||||||||||||||||---|||%||||||
||||||-||||||--||||||||||||||||||||||||||||||||---||XXXXX||||||||||||||XXXXX|-XXXXXXX---||||---||-||---XXXX---||||||||||-----------||||||||||||||||||||||||||||||||---|||||||||||||||||||||---||||||||||
