--------------------------------------------------------------------------------------------------------------------------------------------------------------------------------------------------------
--------------------------------------------------------------------------------------------------------------------------------------------------------------------------------------------------------
--------------------------------------------------------------------------------------------------------------------------------------------------------------------------------------------------------
------------------------------------------------------------------------------------#----------------------------------------------------------------------#--#-----------------------------------------
--------------------------------------------------------------------tt--B-----------#---BB2B-------------------------------------------------DDD---D---g-%%%--%%----------------------------------------
----------------------------------------------D---D-----------------Tt-----tt-------#K--------%%%%%----tt---tt----------------------2BBBBBBC---BBB-----B2|||--||-BBBBBB---------------------------------
-------------------------------------g----g-------------------------tt--r--tt-------#-----g---|||||----Tt---Tt---%%%%%--------------------%%%%%%---D-----|||--||--------#-------%%%%---D----------------
------D-------------------------D-B2BB2B2BB2%%%---%%%----%%%%---%%%%%%%%%%%%%%%%--%%%---%%%%%%|||||%%%%%%%%%%%%%%|||||--------------------||||||---D--------------------#-------||||--------------------
--------------------------------------------|||---|||----||||---||||||||||||||||--|||---||||||||||||||||||||||||||||||--------------------||||||---D--------------------#-------||||--------------------
-BBBB------------------k------BB------------|||---|||----||||---||||||||||||||||--|||---||||||||||||||||||||||||||||||%---%%--------------||||||---D-----DDDDDDD-----%%%%%%--%%%||||%%%%%%%%%%%---------
---------D-------U--%%%%---------D-D-----BBB|||----------||||---||||||||||||||||--|||---|||||||||||||||||||||||||||||||---||-----------------------------------------||||||--||||||||||||||||||---------
-------------tt-----||||---tt---------------|||----------B------||||||||||||||||--|||---|||||||||||||||||||||||||||||||---||----------r--------------------------------------|||||||--------------------
%%%%---------Tt--r--|k||k--tt----------------g----%%%-----------||||||||||||||||--|||---|||||||||||||||||||||||||||||||---||---2-----%%%%--BBC%%-D-------tt-------------D-tt----||||--------------------
||||%%--%%%%%%%%%%%%||||%%%%%%%%%%%%%--%%%%%%%%---|||-------------------------------------------------------------|||||---||---------||||-----||---------tt----------tt-D-tt---%||||%------%%%%%%F%%%%%%
||||||--|||||||||||||||||||||||||||||--||||||||---|||-----------%%%%-------------------------------------------------------------g---||||-----|g---------tt----------tt---tt---||||||%%%%%%||||||X||||||
||||||--|||||||||||||||||||||||||||||--||||||||---|||---%%%%%---||||------------------------------------------------------%%---%%%%%%||||%%%%%||%%%%---%%%%%%%%%--%%%%%%%%%%%%%||||||||||||||||||X||||||
