--------------------------------------------------------------------------------------------------------------------------------------------------------------------------------------------------------
--------------------------------------------------------------------------------------------------------------------------------------------------------------------------------------------------------
------------------------------C----------------------------------------------------------------------------------------------------------------------------C--------------------------------------------
---------------------------------------------------------------------------------------------------------------------------------------------------------------------------------C----------------------
-------------------------#----------------------------------------g-------------------------SSSSSS-------S2SSSSSSS-----------D-----------------------------------SS2------------D-----------------------
-------------------------#---------------------------------2SSSSSSS2S------------------------------S------------------------------------SS--------U--------#-------------tt---------tt------------------
-SCS------%%%%%%%SS------#---SSSSS----------------------------------------------------------------------------------------------------------tt--#----%%%%--#---------g---tt---------tt------------------
------D---|||||||-----%%%%%%-----------S---------DDDDS--------------------------------------------------------------------------D-----------tt--#----||||--#----%%%%%%%%%%%%%%%%%%%%%%%%---%%%%---------
----------G#|||||-----||||||-----G#--------SSS----------tt------------------------SSS-S-------DDDDDDDD-------DDDDD--------------------------tt--#----||||--#----||||||||||||||||||||||||---||||---------
SSSSS-----|#|||||SS---||||||--r---#----------------tt---tt---tt---%%%%----y--g--g---------------------------------------------------D---%%%%%%%DDDD%%||||%%%%---||||||||||||||||||||||||---||||---------
---------D|#|||||-----|||||D-%%%%-#------------g---tt---tt---Tt---||||-%%%%%%%%%%%%%%------C-------------------------S-----DDSS-DDDDD---|||||||-D--||||||||||---|||S||||||||||g|||||g|||---||||---------
----------|||||||-----|||||--||||-----%%---%%%---%%%%%%%%%%%%%%%%%||||-||||||||||||||-r-------%%%%--------%%%%--SS-----SSS--------------|||||||-D--||||||||||---|||-||||||||%%%%||SSS2SS---||||---------
%%%%------|||||||-----|||||--||||-----||---|||---|||||||||||||||||||||-||||||||||||||%%%------||||---tt---||||--------------------------|#|||||----|||||tt|||---|||-||||||||||||||---------||||---------
||||%%--%%|||||||%%---%%||%%%||||%%---||---|||---|||||||||||||||||||||-|||||||||||||||||------||||---Tt---||||------g------g------#-----###|||%%%%%%||||Tt||#---||%%%%%%||||||||||---------%%%%%%F%%%%%%
||||||--|||||||||||---|||||||||||||---||---|||---|||||||||||||||||||||%|||||||||||||||||---%%%||||%%%%%%%%||||%%%%---%%%%%%%%%%%%%%-----%%%%%%||||||%|||%%%%%---%%||||||%%%%||||%%%%%%%%---||||||%||||||
||||||--|||||||||||---|||||||||||||---||---|||---|||||||||||||||||||||||||||||||||||||||---|||||||||||||||||||||||---||||||||||||||-----|||||||||||||||||||||---||||||||||||||||||||||||---|||||||||||||
