--------------------------------------------------------------------------------------------------------------------------------------------------------------------------------------------------------
--------------------------------------------------------------------------------------------------------------------------------------------------------------------------------------------------------
--------------------------------------------------------------------------------------------------------------------------------------------------------------------------------------------------------
-----------------------------------#-------------------------------------------------------------------------------------------------#--#----------------#--#-------------------------------------------
-----------------------------------#----------------------------------------------C------------------------------------------------%%%--%%%---DDDD-----DDD--DDD-----D---DDD-----------------------------
-----------------------------------#--------BB-BCB-----------------------------------DDD---------------D-BBBBC%%---DDDDDDD-----BBB-|||--|||BB-D--2BBBB--------BBB---BBB---------------------------------
-B2---------%%%%%%-----D%%------%%%%%%------------------------------------------------------------------------||G#-----------------|||--|||---D---------------------------------------------------------
------------||||||------||------||||||-------------------------B2BB------------B---g--------------------------||-#--------B2BBBB---B----|||---D---------------------------------BB2-----%%%%------------
------G#-D--||||||----k------U--------BB----BBBBBB-B-----B-----------------B-----BBB2BB----D--%%%%--B-----D-tt||-#----tt----------------|||---------------------------------------------||||------------
BBBBB--#--------B--%%%%---------D-----------------------------B-------------------------------||||-----tt---Tt||------tt----------------|||---DDDD--%%%----DDDD-----D---DD%%%%%-----g---||||------------
-------#-----------||||-----------------------------------------------------------------------||||-----Tt---tt--#--#--tt----------%%%%--------------|||-------------------|||||%%%%---%%||||%%%%--------
---------B--D------|k||-----------%%%%%%----%%%%%%----%%%%%------%%%%%----%%---%%%%%%%%%%--%%%||||%%%%%%%%%%%%%%%--%%%%%%%%--%%%%%||||-%%%%%%-----------------BB---g------|||||||||---||||||||||--------
%%%%-----------%%%%||||%%%---%%%%%||||||%---||||||%%%%|||||------|||||-r--||---||||||||||--||||||||||||||||||||||--||||||||--|||||||||-||||||-tt--------tt----------2B--#-----|||||---||||||||||--------
||||%%---r-----|||||||||||---||||||||||||---|||||||||||||||---%%%|||||%---||---||-|||||||--||||||||||||||||||||||--||||||||--|||||||||-||||||-tt---tt---tt---tt---------#---------------D|||||||%F%%%%%%
||||||--%%%%%%%|||||||||||---||||||||||||---|||||||||||||||---|||||||||---||---||-|||||||--||||||||||||||||||||||--||||||||--|||||||||-||||||-tt---tt---tt---tt---------#------%%%%------||||||||X||||||
||||||--||||||||||||||||||---||||||||||||---|||||||||||||||---|||||||||---||---||-|||||||--||||||||||||||||||||||--||||||||--|||||||||%||||||%%%%%%%%%%%%%%%%%%%%---%%%%%%%%%%%||||---%%%||||||||X||||||
