--------------------------------------------------------------------------------------------------------------------------------------------------------------------------------------------------------
--------------------------------------------------------------------------------------------------------------------------------------------------------------------------------------------------------
--------------------------------------------------------------------------------------------------------------------------------------------------------------------------------------------------------
------------------------------------------------------------------------------------------------------------------------------------------------------------------------------------#--#----------------
-------------------%%%%%%%----------------------------------------------------------------------------------------------------------------------------------------------DD---DD---DDD--%%%%%%%----------
-------------------|||||||------------------------------------BC-----------------------------------------------------------------------------------------------------------------------|||||||----------
--B2B-----------DDD||||---------------------------------------------------rg------B----------------------------------------------------------------------------------------------------|||||||----------
------D%%%%--BB-------------------------------------------k----------DDDD%%%%-------%%%-D-------------------------------------------------------------------------D------D---%%--------||||||-----------
-------||||------------------G#---BB---g---------------%%%%--BBBBB-------||||---tt--|||----------------------------------------------------------------------------------D---||--------||||||-----------
BBBBB----------------C----B---#--------B2BB------------||||--------------||||---tt--|||--------------------------r-----------g-------------g----------------CU-----------D---||---DDD--||||||-----------
---------D--BBBBC--C---C----------------------%%%------|k||------g---%%%D||||%%%%%%%|||%---D--------------------%%%%---tt--BBB2B---%%%%%%%%%----------------------tt-D----------------------------------
-----------------------------------------g----|||---%%%||||%%%%%%%---|||-|||||||||||||||------------------------||||---tt----------|||||||||----------------------tt-----------C------------------------
%%%%------------g--r---r------%%%%%%---%%%%---|||---||||||||||||||---|||-||||||||||||||------------------%%%----||||---tt----------|||||||||%%%-------------------tt---%%%------------------------------
||||%%--%%%%%%%%%%%%%%%%%%%---||||||---||||---|||---||||||||||||||---|||-||||||||||||||%%%%%%%%---%%%%---|||%%%%||||%%%%%%%%%%%%%%%||||||||||||-----%%%%%--%%%%%%%%%%%%|||----------------%%%%%%%F%%%%%%
||||||--|||||||||||||||||||---||||||---||||---|||---||||||||||||||---|||-||||||||||||||||||||||---||||---||||||||||||||||||||||||||||||||||||||-----|||||--|||||||||||||||----------------|||||||X||||||
||||||--|||||||||||||||||||---||||||---||||---|||---||||||||||||||---|||-||||||||||||||||||||||---||||---||||||||||||||||||||||||||||||||||||||%%---|||||--|||||||||||||||---%%%%%%%%%%%%%|||||||X||||||
