--------------------------------------------------------------------------------------------------------------------------------------------------------------------------------------------------------
--------------------------------------------------------------------------------------------------------------------------------------------------------------------------------------------------------
--------------------------------------------------------------------------------------------------------------------------------------------------------------------------------------------------------
---------C-----------S-S--------------------------------------------------------------g-----------------------------------------------------------------------------------------#--#--------------------
--------------D----D--------------------------K-------------DDDDDD--DDDD--D------D---SS2SDDDD---------------S---------%%%------%%%%%%---#--#----------------------------DDDG#-%%%--%%%%%%%--------------
-----------------------------------------------------------------------------------------------------------g----S2S---|||---DDD||||||%%%%--DDD----------D------SSSSSSSS-----#-|||--|||||||--------------
-SS2S--------------------------------------D-----DD--S---S-----k-------------------------S------S-----S---------------|||------||||||||||-------------------S---------------#-|||--|||||||--------------
------DDDDD--------%%%%%%S2SS--S2%%--2SSSS------------------%%%%---%%%%--U-----SSS----------tt------------------------|||------||||||||||-------------------------------------|||--D||||||--------------
----------SSSS-----||||||--------||-----------------S-------||||---||||----------------tt---Tt-------------%%---------||S------||S||||SSS------%%%%--SS2----------------------|||--D||||||--------------
SSSSS--------------||||||--------||-------g----%%%%-----g---|k||---|k||------------g---tt---tt-------------||---------D|----%%%%|-||||---------||||----------------------%%%--DDDD-D||||||--------------
---------D--S-S---2||D||tt----r--||%%%%%%%%%---||||------2%%||||%%%||DDDDDD---%%%%---%%%%%%%%%%%%%%%%%%%---||---D%%----|----|||||-||tt---------||||------g---%%%%--------|||--------||%%%%%%%%----------
-------------------||-||tt---%%%%|||||||||||---||||-------|||||||||||||-------||||---|||||||||||||||||||---||----||---DDD---|||||-||Tt-----%%%%||||%%%%%%---%||||-%%%%%%%|||DDDD---SSS||||||||----------
%%%%--------r------|g-||tt---|||||||||||||||---||||%%%----|||||||||||||-#-----||||---|||||||||||||||||||---||----||---D-----||||D%%%%%%%%%%||||||||||||||---|||||-||||||||||--D--S----||||||||----------
||||%%%%%%%%%%%---%%%%%%%%%%%|||||||||||||||---|||||||----||D||tt|||tt|-#-----||||---|D|||#|||||||||tt||---||----||---------||||-||||||||||||||||||||||||---|||||-||||||||||--D-------||||||||%%%F%%%%%%
|||||||||||||||---||||||||||||||||||||||||||---|||||||----||-||tt|||tt|-#-----|||#---|-||###||#||#||Tt||---|D---DDD---------||||-||||||||||||||||||||||||---|||||-||||||||||----------|||||||||||%||||||
|||||||||||||||---||||||||||||||||||||||||||---||||XXX----XXX||XXXX|XX|XXXX---XXXX---XXXXXXXXXX||XXXXXXX---|----------XXX---||||XXXX||XX|||||||||||||||||---|||||X||||||||||XXXXXXXXXX||||||||||||||||||
