--------------------------------------------------------------------------------------------------------------------------------------------------------------------------------------------------------
--------------------------------------------------------------------------------------------------------------------------------------------------------------------------------------------------------
--------------------------------------------------------------------------------------------------------------------------------------------------------------------------------------------------------
------------C-------------------------------------------------------------------------------------------------------------------------------------------------------------------------------------------
--------------------------------------------------------SSSSSSSS---------------------------------------------------DSSS----------S----------------U-----------------------C-----------------------------
-------------------------------S2SSSSS---ryk----------------------------------------------------------------#-SS---------------C------------%%%%-----tt--------tt--#--------%%%%---%%%%-----------------
----------------------------------------%%%%----------%%%%%--------------------------------------S----------#---------tt---tt---------------||||-----tt---tt---tt--#--------||||---||||-----------------
------DDDDDDD----D----------------------||||---tt---tt|||||-------------------------------------------------#-----g---Tt---Tt---------------||||-----tt---tt---tt--#----#---||||---||||------g----------
----------------------------------------||||k--Tt---tt|||||%%--%%%-----------------g----------------%%%%--%%%%%%---%%%%%%%%%%%%%%%%%%%---%%%||||%%%%%%%%%%%%%%%%%%%%%---%%%%||||%%%||||%%---%%%%%%%%%---
-S2SS--------------SSS---------------%%%||||%%%%%%%%%%|||||||%%|||-------------C-SSS----------------||||--||||||---|||||||||||||||||||---||||||||||||||||||||||||||||---|||||||||||||||||---|||||||||---
---------D--S-----------------g------|||||||||||||||||||||||||||||------S2S--------------%%%%--%%%%%||||--||||||---|||||||||||||||||||---||||||||||||||||||||||||||||---|||||||||||||||||---|||||||||---
-------------------tt-SSSS---SS2S2%%%|||||||||||||||||||||||||||||----S--------------g---||||--|||||||||--||||||---|||||||||||||||||||---||||||||||||||||||||||||||||---|||||||||||||||||---|||||||||---
%%%%--------r------tt-------------||||||||||||D|||D|D||||D||||||||------------%%%%%%---%%||||%%|||||||||--||||||---|||||||||||||||||||---||||||||||||||||||||||||||||---|||||||||||||||||---|||||||||---
||||%%--%%%%%%---%%%%DDDD---------||||||||||||-|||-|-||||D||||||||------------||||||---|||||||||||||||||--||||||---|||||||||||||||||||---||||||||||||||||||||||||||||---|||||||||||||||||---%%%%%F%%%%%%
||||||--||||||---||||---SS---SS2S-||||||||||||-|||-|-||||-||%%%%%%---%%%%-----||||||---|||||||||||||||||--||||||---|||||||||||||||||||---||||||||||||||||||||||||||||---|||||||||||||||||---|||||%||||||
||||||--||||||---||||-------------|||||X||||XXXXX|-XXX|||X|X||||||---||||-----||||||---|||||||||||||||||--||||||---|||||||||||||||||||---||||||||||||||||||||||||||||---|||||||||||||||||---||||||||||||
