--------------------------------------------------------------------------------------------------------------------------------------------------------------------------------------------------------
--------------------------------------------------------------------------------------------------------------------------------------------------------------------------------------------------------
----------C-------C-------------------------------------------------------------------------------------------------------------------------------------------------------------------------------------
-------------#------------------------------------------------------------------------------------------------------------------------------------------------------------------------------------------
-------------#-----------------------------------SSSSSSSSSSSSSS---S------U-C--------r-------g-----------SSS---------------------------------------------------------------------------------------------
-------------#----------------%%----------------------------------------------tt-D-%%%%---%%%%-----D-SSC------------------------------------------C-----------------------------------------------------
SSS------DDDDD---DDD--DDDDD---||-------------------------------------tt-------tt---||||---||||-------------DDDDDD---------------------------------------------------------------------------------------
-------------D----------------||---SS-S---SS--------SS---------------Tt-------tt---||||---||||-----------g----------------------------------------------------------------------D-----------------------
------G#-D---D----------------|S------------------------g----DD---DDD%%DDDDDDDDDDD%||||%%%||||%%%--DDDDDDDDDDDD------------C---S-------------------g----------C-----------------------------------------
SSSSS--#-----D----S-----------|----------tt--------tt-SSS2SS---------||-----------|||||||||||||||-------------tt-D-%%%%--S-----------------------SSS2S---%%%%-------------------------------------------
-------#-#---D-------------r--|----g-----Tt--------Tt----------------||-------#---|||||||||||||||-------------Tt---||||-----------U----------------------||||---%%%%%----SCS----tt-D-tt---%%%%----------
---------#--D-----r-----------%%---%%%%%%%%%%%---%%%%%DDDDDD---------||---tt--#---||||||||||||%%|-------------tt---||||--------%%----%%%%%---------------||||---|||||-----------tt---Tt---||||----------
%%%%-----#K------%%%%--%%%%---||---|||||||||||---|||||----#--#----%%%%|---tt--#---|||||#||||||||%%%%--%%%--%%%%%%%%||||%%%%%---||----|||||----%%%%%DDDD%%||||%%%|||||-------g---tt---tt---||||----------
||||%%---#-------||||--||||---||---|||||||||||---|||||%%%%%--%%---||||%%%%%%%%%%%%%||||%%%||||||||||--|||--|||||||||||||||||---||%%%%|||||---%|||||----||||||||||||||%---%%%%%%%%%%%%%%%%%||||%%%F%%%%%%
||||||--%%%%%%---||||--||||---||---|||||||||||---||||||||||--||---||||||||||||||||||||||||||||||||||--|||--|||||||||||||||||---|||||||||||---||||||----|||||||||||||||---||||||||||||||||||||||||%||||||
||||||--||||||---||||--||||---||---|||||||||||---||||||||||--||---||||||||||||||||||||||||||||||||||--|||--|||||||||||||||||---|||||||||||---||||||----|||||||||||||||---|||||||||||||||||||||||||||||||
