--------------------------------------------------------------------------------------------------------------------------------------------------------------------------------------------------------
--------------------------------------------------------------------------------------------------------------------------------------------------------------------------------------------------------
--------------------------------------------------------------------------------------------------------------------------------------------------------------------------------------------------------
--------------------------------------------------------------------------------------------------------------------------------------------------------------------------------------------------------
------------------------------------------------------------------------------------------------------------------------------------------------------------------------------C-------------------------
----------------------------------------------------------%%%%%------------------------------------------------------C----C-----------------------------------------------------------------------------
----------------------------------------------------g-----|||||----%%%%----g------------------------------------------------------------------C-------------------------------------------C-------------
------D-------------------------g----------------%%%%---%%|||||----||||-%%%%%%%%%%---k--C--------------S------------------------------------------------------------------------------SS----------------
----------------------------SSSSS2S--------------||||---|||||||%%%%||||-||||||||||%%%%--------%%%%-------*--------U----------%%%%%---------------%%%%-------------C-U--tt--C--tt------------------------
SSSSS----------------DDDD-----------D-----%%%%---||||---|||||||||||||||-|||||tt|||||||--------||||---tt--*----tt-----%%---%%%|||||------%%%%-----||||---------tt-------tt-----Tt----------g-------------
---------D-------SSC------r---------------||||---||||---|||||||||||||||-|||||tt||||k||--------|k||k--Tt--*----Tt--r--||---||||||||%%%%%%||||-%%%%||||---------Tt--r----tt-----tt------%%%%%%------------
-------------tt-------------%%%%%%%%%---%%||||---||||---|||||||||||||||%|||||%%|||||||%%%--%%%||||%%%%%%%%%%%%%%%%%%%||---||||||||||||||||||-||||||||%%%%--%%%%%%%%%%%%%%%%%%%%%%%%---||||||------------
%%%%---------tt------g------|||||||||---||||||---||||---|||||||||||||||||||||||||||||||||--||||||||||||||||||||||||||||---||||||||||||||||||-||||||||||||--||||||||||||||||||||||||---||||||------------
||||%%--%%%%%%%%%%%%%%%%%---|||||||||---||||||---||||---|||||||||||||||||||||||||||||||||--||||||||||||||||||||||||||||---||||||||||||||||||-||||||||||||--||||||||||||||||||||||||---||||||---%%F%%%%%%
||||||--|||||||||||||||||---|||||||||---||||||---||||---|||||||||||||||||||||||||||||||||--||||||||||||||||||||||||||||---||||||||||||||||||%||||||||||||--||||||||||||||||||||||||---||||||---||%||||||
||||||--|||||||||||||||||---|||||||||---||||||---||||---|||||||||||||||||||||||||||||||||--||||||||||||||||||||||||||||---|||||||||||||||||||||||||||||||--||||||||||||||||||||||||---||||||---|||||||||
