--------------------------------------------------------------------------------------------------------------------------------------------------------------------------------------------------------
--------------------------------------------------------------------------------------------------------------------------------------------------------------------------------------------------------
--------------------------------------------------------------------------------------------------------------------------------------------------------------------------------------------------------
--------------------------------------------------------------------------------------------------------------------------------------------------------------------------------------------------------
------------------------------------------------------------------------------DDD-%%%%%%---2S2S--------------C----------------------------------------------------g----------SS-------%%%%%-------------
--g----------------------------------------------G#---------------------k---------||||||------------------------------------------------------------------------%%%%---tt-------------|||||%%%%%%%%-----
-SS2SS-------------------------------------2SSSS--#---2S-----------D-%%%%---------S|||||-------------------------*-----------C----------------------------------||||---tt---tt%%%%%%%%|||||||||||||-----
--------------------------------------------------#------------------||||-----%%%--|SSS|---SSSS2---tt------------*-----S----------------------------------------||||---tt---tt|||||||||||||||||||||-----
------G#-D-----D---D------S--SS--------------------------------------|k||-----|||--|---|-----------Tt---tt---tt--*-------------tt------%%%----%%%%%%--------%%%%||||%%%%%%%%%%|||||||||||||||||||||-----
SSSSS--#------------------------U----------------------------%%---DDDDDDDDD---|||--|---|g------g---tt---tt---tt--*---------g---Tt------|||%%%%||||||%%---%%%|||||||||||||||||||||||||||||||||||||||-----
-------#-S-------------------------%%%---------%%----------%%||------||||-----|||%%%%%%%---%%%%%%%%%%%%%%%%%%%%%%%%%%%%%---%%%%%%%%%---|||||||||||||||---||||||||||||||||||||||||||||||||||||||||||-----
------------D--tt-D---D---------r--|||-SS2SSSS-||-S---SS---||||------||||-----||||||||||---|||||||||||||||||||||||||||||---|||||||||---|||||||||||||||---||||||||||||||||||||||||||||||||||||||||||-----
%%%%-----------tt--------%%%%%%%%%%|||%%-------||----------||||------||||-----||||||||||---|||||||||||||||||||||||||||||---|||||||||---|||||||||||||||---||||||||||||||||||||||||||||||||||||||||||-----
||||%%---------tt--------|||||||||||||||-------||----------||%%---%%%||||%----%%%%||||||---|||||||||||||||||||||||||||||---|||||||||---|||||||||||||||---||||||||||||||||||||||||||||||%%%%%%%%%%F%%%%%%
||||||--%%%%%%%%%%%%--%%%|||||||||||||||-S2SSSSSSSS---SS---S|||---||||||||----||||||||||---|||||||||||||||||||||||||||||---|||||||||---|||||||||||||||---||||||||||||||||||||||||||||||||||||||||%||||||
||||||--||||||||||||--||||||||||||||||||--------------------|||---||||||||----||||||||||---|||||||||||||||||||||||||||||---|||||||||---|||||||||||||||---|||||||||||||||||||||||||||||||||||||||||||||||
