--------------------------------------------------------------------------------------------------------------------------------------------------------------------------------------------------------
--------------------------------------------------------------------------------------------------------------------------------------------------------------------------------------------------------
--------------------------------#------------------------------#----------------------------------------------------------------------------------------------------------------------------------------
--------------------------------#------------------------------#-----------------------C-------------------------C--------------------------------------------------------------------------------------
--------------------------------#------------------------------#--------------------------------------------D-------------------------------------------------------------------------------------------
-----------------------------%%%%%%-----DDD---D-----------DDDDDDDDDDD-----------------------------------------------------------------------------------------------------------------------------------
-----------------------------||||||----------------------------D----------------------------------------------------------------------------------------------------------------------------------------
------D----------------------||||||-U-----------------BB---r-k-D-----C----------------%%%%%%----------DDDD--%%%%%%%%--------------------------------------------------DDD------------%%---D-------------
-----------------------------||||||-----BBB-----tt-D------%%%%-D--------tt------------||||||----------------||||||||-----------------------------BBB------------------------------BB-||---D-------------
-B2BB----------y---------CC-BBB-----------------tt--------||||---tt-----tt---%%%%----g----------------DDDDDB||||||||---------------------------------B-BBB--D--------------BB--------||---D-------------
---------D---%%%%------D--------------------g---tt--------||||---tt-----tt---||||-%%%%%%--U------BB----------B-------BB-B-C---B---------------BB-----------------%%%%%---------g-----||---D-------------
-------------||||----r-----------%%%%%%%%%%---%%%%%%%--%%%||||%%%%%%%%%%%%%%%||||-||||||-----tt----------tt--------------------------BBC-------------------g-----|||||----tt-BBB2BBBBB------------------
%%%%---------|k||k----%%%--------||||||||||---|||||||--||||||||||||||||||||||||||-||D|||--r--tt------g---Tt-----%%%%%------------tt----------tt---%%%%%%%%%%%%---|||||----tt----------------------------
||||%%---%%%%||||%%---|||%%%%%%%%||||||||||---|||||||--||||||||||||||||||||||||||-||-|||%%%%%%%%%%%---%%%%%%%%%%|||||------------tt------g---Tt---||||||||||||---|||||%%%%%%%%%-----------%%%---%F%%%%%%
||||||---||||||||||---|||||||||||||||||||||---|||||||--||||||||||||||||||||||||||%||%||||||||||||||---|||||||||||||||%%%%%%---%%%%%%%%%%---%%%%%%%||||||||||||---||||||||||||||-2BBBBBB---|||---|X||||||
||||||---||||||||||---|||||||||||||||||||||---|||||||--||||||||||||||||||||||||||||||||||||||||||||---|||||||||||||||||||||---||||||||||---|||||||||||||||||||---||||||||||||||-----------|||---|X||||||
