--------------------------------------------------------------------------------------------------------------------------------------------------------------------------------------------------------
--------------------------------------------------------------------------------------------------------------------------------------------------------------------------------------------------------
--------------------------------------------------------------------------------------------------------------------------------------------------------------------------------------------------------
---------C-----------------------------------------------------------------------------------------------------------------#------------------------------------------------------------#---------------
----------------------------------------------------------------------------------------------C--tt--------------#---------#---B2BBB---2B-----------------------------------------------#---------------
---------------------------#--#------------------------------------------------------------------Tt---%%---------##--------#------------------------------------------------------------#---------------
--BC----------------DDD--DDD--DDDDDDD----------D-%%%%%%------------------------------------------tt---||---%%%---%%%%%---%%%--------------------------------------------------%%%%%%--%%%%%%------------
------DDDDD------BC------------------------------||||||----------------------------C--------%%%%%%%%%%||---|||---|||||---|||---2BBBB------------------------------------------||||||--||||||------------
----------------------------y-----r-------------------------BB---C-BB----------------g------||||||||||||-----------------|||-----------%%%%%%-U-B-------------------------------------||||||------------
BBBBB---------B-----------%%%%---%%%%---%%%%------D-tt--B--------------------U------%%%%%%%%||||||||||||-------------------------#-----||||||----------B--tt------------#-------BBB---||||||------------
---------D--U---BBBBC-----||||---||||---||||---tt---Tt------------tt------%%--------||||||||||||||||||||-------------------------#--------B--------tt-----tt--------tt--#--------------D----------------
-------------------------r||||k--||||k--|k||---Tt---tt------g-----tt------||------%%||||||||||||||D--------%%%---%%%-------------#-----%%----------tt-----tt--------Tt--#----#------g-------------------
%%%%--------r-------g---%%||||%%D||||%%%||||%%%%%%%%%%%%%---%%%%%%%%%%%---||------||||||||||---------------|||---|||-D---%%----%%%%%---||----%%%%%%%%%%%%%%%%%%--%%%%%%%%%---%%%%%%%%%%%%%%%------------
||||%%--%%%%%%%%%%%%%%%%||||||||-||||||||||||||||||||||||---|||||||||||---||%%%---||||||||||%-%%%%%%%%%%---|||---|||-D---||----|||||---||----||||||||||||||||||--|||||||||---|||||||||||||||%%%%%F%%%%%%
||||||--||||||||||||||||||||||||-||||||||||||||||||||||||---|||||||||||---|||||---|||||||||||-||||||||||---|||---|||-D---||----|||||---||%%%%||||||||||||||||||--|||||||||---||||||||||||||||||||X||||||
||||||--||||||||||||||||||||||||-||||||||||||||||||||||||---|||||||||||---|||||---|||||||||||-||||||||||---|||---|||-----||----|||||---||||||||||||||||||||||||--|||||||||---||||||||||||||||||||X||||||
