--------------------------------------------------------------------------------------------------------------------------------------------------------------------------------------------------------
--------------------------------------------------------------------------------------------------------------------------------------------------------------------------------------------------------
----------------------------------------------------------------------------------------------------------------------------------#---------------------------------------------------------------------
---------------------------------------------------------------------------------------------------------S------------------------#---------------------------#---g-------------------------------------
---------------S2------------------------------------------------SSSSS-----------g-----------------------------------%%%%---------#----------SS2S----tt---tt--#----#SS#SS-----%%%%%---------------------
-----------------------------------------------------------------------------#----2SS-U------------------------D-----||||----#----#--%%%%------------tt---Tt--#---------------|||||------#--------------
------------------------------------------------------------S------C---------#-----------tt---%%%%%%-----------D-%%%%||||%%%%%---%%%%||||--------g---tt---tt--#---------%%%---|||||%%----%%%%%%%--------
------D---------------------------------------------g----------tt------------#-----g-----tt---||||||%%%%%%%%---D-|||||||||||||---||||||||---%%%%%%%%%%%%%%%%%%%%---%%%%%|||---|||||||----|||||||--------
--------------------------------------tt--SSCS----%%%%------r--tt--r-------%%%%---%%%%%%%%%%%%||||||||||||||---D-|||||||||||||---||||||||---||||||||||||||||||||---||||||||---|||||||----|||||||--------
-S2SS------SSS2SS----SSSS2-----tt-----tt----------||||---%%%%%%%%%%%%%---%%||||---||||||||||||||||||||||||||-----|||||||||||||---||||||||---||||||||||||||||||||---||||||||---|||||||----|||||||--------
---------D---------------------tt-----tt------g---|k||k--|||||||||||||---||||||---||||||||||||||||||||||||||---%%||||%%%%|||||---||||||||---||||||||||||||||||||---||||||||---|||||||----|||||||--------
----------------------------%%%%%%%%%%%%%%%%%%%%%%||||%%%|||||||||||||---||||||---||||||||||||||||||||||||||---|||||||||||||||---||||||||---||||||||||||||||||||---||||||||---|||||||----|||||||--------
%%%%----------------SSSSSSS-||||||||||||||||||||||||||||||||||||||||||---||||||---||||||||||||||||||||||||||---|||||||||||||||---||||||||---||||||||||||||||||||---||||||||---|||||||----|||||||--------
||||%%--%%%%%%%%%-----------|||||||||||||||||||||||||||||||||||||#||#|---||||||---||||||||||||||||||||||||||---|||||||||||||||---||||||||---||||||||||||||||||||---||||||||---|||||||---%%%%%%%%%F%%%%%%
||||||--|||||||||-----------|||||||||||||||||||||||||||||||||||DDD||%%---%%%%%%---||||||||||||||||||||||||||---|||||||||||||||---||||||||---||||||||||||||||||||---||||||||---|||||||---|||||||||%||||||
||||||--|||||||||---SSS2SSSSSS||||||||||||||||||||||||SSSSSSSS|---||||---||||||---||||||||||||||||||||||||||---|||||||||||||||---||||||||---||||||||||||||||||||---||||||||---|||||||---||||||||||||||||
