--------------------------------------------------------------------------------------------------------------------------------------------------------------------------------------------------------
--------------------------------------------------------------------------------------------------------------------------------------------------------------------------------------------------------
-----------------------------------------------------------------------------#--------------------------------------------------------------------------------------------------------------------------
-------------------------------------------U-C-----------S-------------------#--------S-S-S---------------#-C-------------------------------------------------------------------------------------------
------------SS------------SS----------%%--------tt---------------------%%%---#--%%%%%-------U--tt--SSC----#-----------------------------------------------------------C---------------------------------
-------------------D-----------g------||---r-r--tt-------r-------------|||%%%%%%|||||----------tt---------#K-----S--------------------------------------------------------------------------------------
-SC-------------g--------tt-%%%%%%%%%%||---%%%%%%%%%%--%%%%%%---%%%%---||||||||||||||-------r--tt------g--#------------------------------------------------------------------------------G#-------------
------D-SS2%%%---%%%-----Tt-||||||||||||---||||||||||--||||||---||||---||||||||||||||DDDDDD%%%%%%%%%%%%---%%%D---DDDDD--%%%%-D------------------------------------------------------------#-------------
----------D|||---|||---%%%%%||||||||||||---||||||||||--||||||---||||---||||||||||||||------||||||||||||---|||-----------||||---S2SSSS------------------%%%%---tt---%%%%---tt---%%%%--#----#-------------
SSSSS------|||---|||---|||||||||||DDDD||---|||||||S||--|||C||---||||---D|||%%%|||||||------||||||||||||---|||----DDDDDDD||||---------------------------||||---tt---||||---tt---||||--#------------------
---------D-|||---|||---|||||||||||||||||---SSDDD||-||--|||-||---||||---D|||||||||||||------||||||||||||---|#|S----------|||SSC--D---------S2SS---------||||---tt---||||---tt---||||--#------------------
-----------|||---|||---|||||||||||||||||--------||-||--|||-||r--||||----||||||%%%%%%%%%%%%-||||||||||||---|#|----------tt||------------------------%%%%||||%%%%%%%%||||%%%%%%%%||||%%%---%%%------------
%%%%-------|||---D|S---|||||||||||||||||--------||-|%%%||%%%%---D||D---%%%%|||||||||||||||-||||||||||||---|#|----g-----Tt||----g---%%%%%-----------|||||||||||||||||||||||||||||||||||---|||------------
||||%%--%%%%%%---D|----|||||||||||||||||---%%%%%%%%%|||%%||||---D||D---|||||||||||||||||||-|||%%%||%%||---%%%%---%%%%%%%%%%%%%%%%%%|||||---------%%|||||||||||||||||||||||||||||||||||---|||%%%%%F%%%%%%
||||||--||||||----|r---%%%||||||||||||%%---||||||||||||||||||---D||D---|||||||||||||||||||-||||||||||||---||||---|||||||||||||||||||||||----%%---|||||||||||||||||||||||||||||||||||||---||||||||%||||||
||||||--||||||---XXX---|||XX||||||||||||---||||||||||||||||||----||----|||||||||||||||||||-||||||||||||---||||---|||||||||||||||||||||||XXXX||---|||||||||||||||||||||||||||||||||||||---|||||||||||||||
