--------------------------------------------------------------------------------------------------------------------------------------------------------------------------------------------------------
--------------------------------------------------------------------------------------------------------------------------------------------------------------------------------------------------------
------------#-------------------------------------------------------------------------------------------------------------------------------------------------------------------------------------------
------------#-------------------------------------------------------------------------------------------------------------------------------------------------------------------------------------------
------------#--------------------------------S----------------------------S2----------------------------------------------------------------------------------------------------------------------------
------DDDDDDDDD-SS--------k-----------------------------------------------------------------------------------------------------------------------------------------------------------------------------
------------D-----------%%%--SS------------------r-------------------------------------------------------------------C----------------------------------------------------------------------------------
------D-----D---U-------|||-----------r---------%%%%--------------------SSSSS---------------------------------------C---------------------------------------------------S---SS--------------------------
------------D-----------k||k-----g---------%%%%%||||DDD-----------------------S--SS-------------------------------------------------------------------------------------------------S2SS----------------
--2SS----------------%%%|||%%%%---%%%---%%%|||||||||----------------------------------------------tt------------------------------------------------------D---------------------------------------------
---------D-----------||||||||||---|||---||||||||||||---------------tt----------------g-----%%%----tt-----------------C-------------------------------------------------------------C--------------------
-------------%%%%%---||||||||||---|||---||||||||||||----------tt---Tt---tt---%%%%%%---%%---|||----tt---%%%%-----%%%%%----tt---------------------C--------C-------------------DD-------------------------
%%%%---------|||||---||||||||||---|||---||||||||||||----------Tt---tt---tt---||||||---||---|||%%%%%%%%%||||-----|||||----tt---%%%-----------tt----U-------tt-D---tt--SS2S-------------%%%%%%------------
||||%%--%%%%%|||||---||||||||||---|||---|||||||||||%%-----%%%%%%%%%%%%%%%%%%%||||||---||---||||||||||||||||---%%|||||----tt---|||------tt---Tt-------tt---Tt-----tt-------------------||||||%---%F%%%%%%
||||||--||||||||||---||||||||||---|||---|||||||||||||-----|||||||||||||||||||||||||---||---||||||||||||||||---|||||||%%%%%%%%%|||------Tt---tt----r--Tt---tt-----tt------g---%%%%--%%%|||||||---|%||||||
||||||--||||||||||---||||||||||---|||---|||||||||||||-----|||||||||||||||||||||||||---||---||||||||||||||||---|||||||||||||||||||---XXXXXXXXXXXXXXXXXXXXXXXXXXXXXXXXXXXXX---X||||XX||||||||||---||||||||
