--------------------------------------------------------------------------------------------------------------------------------------------------------------------------------------------------------
--------------------------------------------------------------------------------------------------------------------------------------------------------------------------------------------------------
--------------------------------------------------------------------------------------------------------------------------------------------------------------------------------------------------------
---------------------------B--C-----------g-------------------------------------------------------------------------------------------------------------------------------------------------------------
------------------------------------*-BBBBB2B-----------------------------------B2BBBBBBB--B2BB---------------------------------------------------------------------------------------------------------
----------------------%%%%----------*-----------------------------------------------------#----------------#-----------------------------------------------------------------------------%%%%-----------
--BB-----------y--y---||||-r--------*------------DDD-DDDDDD--DDD--------------------------#-----------2----#------------g----------------------------------------------------------------||||-----------
------D-BB2BC%%%%%%%%%||||DDDDD---%%%%%------------------------------------------D--------#----------------#-------BBBBBB2BBBB-----------------------------------------------------------||||-----------
-------------||||||||||||-----D---|||||---------------ry--------------------------------%%%%%-----D-----------------------------------------------------------------------------------DDD||||%%%%%%%----
BBBBB-------U||||||||||||-----D---|||||B2BB----------%%%%---tt---tt-------BBB-U---------|||||------------------------------tt-------------g----------------------------------------BB----|||||||||||----
---------D---||||||||||||-----#----------------------||||---tt---tt--------------tt-D---------B-----------DDDDD--BBBBB-----Tt-----------BB---B--%%%%-------------tt---%%%%%--------------|||||||||||----
-------------||||||||D--|%%%%%D---DDDDDD-------------||||---tt---tt-------D------Tt---%%%%%-------B-BBB----------------BBDDDDDDDDD--------------||||------%%%----tt---|||||-----------g--||||-----------
%%%%---------|r||||||---||||||-------------------%%%%||||%%%%%%%%%%%%%%----------tt---|||||-------------------------------------------------g---||||------|||%%%%%%%%%|||||--------%%%%%%||||-----------
||||%%--%%%%%||||||||%%%||||||%---%%--%%%%%%%%---||||||||||||||||||||||---%%%%%%%%%%%%|||||-------------g----------------------------%%%%%---%%%||||%%%---|||||||||||||||||%%%%%---||||||||||%%%%F%%%%%%
||||||--|||||||||||||||||||||||---||--||||||||---||||||||||||||||||||||---|||||||||||||||||%%%%---%%%%%---%%%%--%%%--%%%%%%%%%%%%%%%%|||||---||||||||||---||||||||||||||||||||||---||||||||||||||X||||||
||||||--|||||||||||||||||||||||---||--||||||||---||||||||||||||||||||||---|||||||||||||||||||||---|||||---||||--|||--|||||||||||||||||||||---||||||||||---||||||||||||||||||||||---||||||||||||||X||||||
