--------------------------------------------------------------------------------------------------------------------------------------------------------------------------------------------------------
--------------------------------------------------------------------------------------------------------------------------------------------------------------------------------------------------------
--------------------------------------------------------------------------------------------------------------------------------------------------------------------------------------------------------
-----------------------------C--------------------------------------------------------------------------------------------------------------------------------------------------------------------------
--#------------------------------#-----------------------------------2SSSSS--C------------------------------------------------------------------------------------------------------------g-------------
--#--------------------#-----r--###-----------------------------------------#-------------------------------------------------------------------------------------------------DDDDDD-D%%%%%%%%----------
--#--------------------#D---DD%%%%%%%%--------------------------------------#---------------------------------------------------------------------------------------------------------||||||||----------
DDDDD-D-SSC------------#K-----||||||||--------------------------------------#-----------------------D---------------------------------------------------------------------------------||||||||----------
--D--------------------#------||||||||------------SS---------------------DDDDDD--------C---------------------------------------------------------------------------------------%%%%--#||||||||----------
--D--------SSSSS-----DDDD----C||||||D|-----C--------------------------------D----------------------k-----------------------------------------------------------------g---------||||--#||||||||----------
--D------D-------S-----D------||||||-|-----------tt--SS----------*----------D-------C---%%%%----%%%%---D------------D----------------------------------------------SSS2S-------||||--#||||||||----------
-----------------------D------||||||-|-------g---tt----------tt--*-------tt-D-----------||||----||||-----%%%---%%---D-%%%%--------C----------------------------tt----------%%%%||||%%%||||||||----------
%%%%-----------------g--------||%%%%%%%%---%%%%%%%%DDDD------Tt--*-------Tt-D-tt----%%%%||||----|k||k----|||---||---D-||||----%%%%---tt--------%%%%------------Tt----------|||||||||||||||||||----------
||||%%--%%%%%--%%%---%%%%---%%%%||||||||---||||||||----------tt--*-------tt---tt----||||||||%%%%||||%%%%%|||---||---D-|||tt---||||---tt---tt---||||-----%%--%%%%%%%%%%%%---|||||||||||||||||||%%%F%%%%%%
||||||--|||||--|||---||||---||||||||||||---||||||||%%%%---%%%%%%%%----%%%%%%%%%%%%%%||||||||||||||||||||||||---||-----|||Tt---||||---tt---tt---||||-----||--||||||||||||---||||||||||||||||||||||%||||||
||||||--|||||--|||---||||---||||||||||||---||||||||||||---||||||||----||||||||||||||||||||||||||||||||||||||---||---XX|||XXXXX||||XXXXXXXXXXXXX||||XX---||XX||||||||||||---|||||||||||||||||||||||||||||
