--------------------------------------------------------------------------------------------------------------------------------------------------------------------------------------------------------
--------------------------------------------------------------------------------------------------------------------------------------------------------------------------------------------------------
--------------------------------------------------------------------------------------------------------------------------------------------------------------------------------------------------------
--------------------------------------------------------------------------------------------------------U-----------------------------------------------------------------------------------------------
---------------------------------------#--#-------------------------------------------------------------------------------------------------------------------------------------------------------------
----------------------------DDDDDDD--%%%--%%%-----------------------DDD----------------------------------------------------g----------------------------------------------------------------------------
-BB-----------------g----------------|||--|||-----------------BBBBCC------2BB---------------------------------------------------------------------------------------------------------------------------
------D%%%%-----BBBBB2BB------r-k----|||--|||B2BB-----BB-C------------------------------------------DDDDDDD---------------------------------------------------------------------------------------------
-------||||------------------%%%%-----------------B-----------------------------------------------------------------B-----------------------------------------------------------------------------------
BBBBB------------------------||||---tt---tt-----------BC------------%%%-------r-------------------DDDDDD------B---------2---BB-----------g--------------------------------------C-----------------------
---------D------*-------U----||||---tt---tt-----------g-------%%%%%%|||---------D----g---------B-------------------------------BB2B----%%%%---tt--------------------------------------------------------
----------------*---#------%%||||%%%%%%%%%%%%%--%%%---%%%%%---|||||||||---%%%---D-%%%%%BB-----------------tt---------------------------||||---tt--------------------------------------------------------
%%%%------------*--###--r--|||||||||||||||||||--|||---|||||---|||||||||---|||---D-|||||-----------g-------tt-------%%%%%-----------g---|k||---tt------%%---------tt--#--tt--#-------%%%%----------------
||||%%--%%%%--%%%%%%%%%%%%%|||||||||||||||||||--|||---|||||---|||||||||---|||---D-|||||----D---%%%%%%%%%%%%%%%%%---|||||----%%%%%%%%%%%||||%%%%%%%%---||----tt---Tt--#--tt--#--tt---||||--%%%---%F%%%%%%
||||||--||||--||||||||||||||||||||||||||||||||--|||---|||||---|||||||||---|||-----|||||#-------|||||||||||||||||---|||||-r--|||||||||||||||||||||||---||----Tt---tt--#--tt--#--Tt---||||--|||---|X||||||
||||||--||||--||||||||||||||||||||||||||||||||--|||---|||||---|||||||||---|||---%%|||||%%%%%---|||||||||||||||||---|||||%---||||---||||||||||||||||---||%%%%%%%%%%%%%%%%%%%%%%%%%%%%||||%%|||---|X||||||
