--------------------------------------------------------------------------------------------------------------------------------------------------------------------------------------------------------
--------------------------------------------------------------------------------------------------------------------------------------------------------------------------------------------------------
--------------------------------------------------------------#-----------------------------------------------------------------------------------------------------------------------------------------
--------------------------------------------------------------#-----------------------------------------------------------------------------------------------------------------------------------------
------------------tt----------DDD-----------------------------#K------tt--------------------------------------------------------------------------------------------------------------------------------
--C---------------tt------2SS---------------------------------#-------Tt------%%-------------------g----------------------------------------------------------------------------------------------------
------------DDDDD%%%%%%-------------------------------%%----%%%%%--%%%%%%%%---||-------------------S2S------------tt------------C-----------------------------------------------------------------------
------D%%%%%-----||||||-----------SSS2S-----D---------||----|||||--||||||||---||%---%%D------------------tt-------tt---tt---tt--------------------------C-----------------tt---tt---%%%%----------------
-------|||||-----||||||----k------------------%%%%%%%%||----|||||--||||||||---|||---||---tt--------------tt-------tt---Tt---tt-------%%%----tt--#-------------------------Tt---Tt---||||----------------
SSSSS--|||||--r-k||||||-%%%%----r-----g-------||||||||||---%%%%||--||||||||---|||---||---tt---%%---%%%%%%%%%%%%%%%%%DDDDDDDD%%%%%%---|||----tt--#---#---------%%%---------tt---tt---||||----------------
-------||D||-%%%%||||||-||||---%%%%%%%%%---%%%||||||||||---|||||%%%%||r||||---|||---D%%%%%%%%%||---|||||||||||||||||--------||||||---|||----tt--#--##---------|||%%%%--%%%%%%%%%%%%%||||%%%%------------
-------||-||-||||||||||-|k||---|||||||||---|||||||||||||---||||||||||%%%%||---SC|----|||||||||||---|||||||||||||||||#-------||||||---|||%%%%%%%%%%%%%---%%%---|||||||--|||||||||||||||||||||------------
%%%%---||-||-|||||||%%%%||||%%%|||||||||---|||||||||SSC|---||||||||||||||||-----|----|||||||||||---|||||||#|U|||||C|#--%%%%-|D||||---||||||||||||||||---|||---|||||||--|||||||||||||||||||||------------
||||%%-|%%%%%||||%%%||||||||||||||||||#|---|%%%%%|||---|---||||||||||||||||----g|---%%%%||||tt||---|||||||#|-|||||-|#--||||-|D||||---||||||||||||||||---|||---|||||||--|||||||||||||||||||||---%%F%%%%%%
||||||-|||||||||||||||||||||||||||||%%%|---%||||||||---|g--||||%||||%||||%%---%%%---||||||||tt||---%%%%|||#|-|||||-|#--||||-|-||||---||||||||||||||||---|||---|||||||--|||||||||||||||||||||---||%||||||
||||||-||||||||||||||||||||||||S2SS|||||---||||||XXXXXXX---||||||||||||||||---|||---||||XXXXXXXX---||||XXXXXXXXXXXXXXXX||||XXXXXXX---||||||||||||||||---|||---|||||||--|||||||||||||||||||||---|||||||||
