--------------------------------------------------------------------------------------------------------------------------------------------------------------------------------------------------------
--------------------------------------------------------------------------------------------------------------------------------------------------------------------------------------------------------
--------------------------------------------------------------------------------------------------------------------------------------------------------------------------------------------------------
---------------------------------------------------------------------------S-SC-------------------------------------------------------------------------------------------------------------------------
----------------G#----------------S------S2SSCS----2SSSSSSS---------------------------------------------------------------------------------------------------------------------------------------------
----------S2SS-#-#----------------------------------------#-------2SS%%---------tt---S2SSSCS------------------------------------------------------------------------------------------------------------
---------------#-#----------------------------------------#-------%%%||---------tt--------------------------------------------------------------------------2S---#--------------------------------------
------D--------D------------------------------------------#-------|||||---%%%%%%%%%%%-------D-D------------------------------------------------------------------#----------------------S---------------
-----------------------SSSS-----------DDDDDDDDDDD------DDDDDD-----|||||---|||||||||||-------------------------------------------------------------------------g--#--------------------------------------
-S2SS------SSS%%%%%---------D-----S-----------------------D-------|||||---|||||||||||------------------------%%%%------------------%%---------------tt------%%%%%%%%------------------------------------
---------D----|||||---------------------G#--------S----g--D-------||k||---|||||||||S|-%%%%-----D-D-----------||||---%%%%----g--g---||---------------Tt------||||||||----------%%%%----------------------
--------------|||||----------------------#--S-S-#----%%%%-D-tt-D-%%%%||---|||||||||-|-||||---------%%%%%%----||||---||||-%%%%%%%%%%||---%%%%%%%--%%%%%%%%---||||||||----------||||-----%%%%-------------
%%%%----------|%%%%--%%%--DDD--D-SS---S---------#----||||---tt---||||||---|||#|||||-|-|k||---------||||||%%%%||||%%%||||-||||||||||||---|||||||--||||||||---|||||||tt--U------||||-----||||-------------
||||%%--%%%%%%D||||DD|||--------------------r---#----|k||---tt---|k||||---||###|||%%%%||||%%%%%%%%%|||||||||||||||||||||-||||||||||||---|||||||--||||||||---|||||D|tt-------%%||||%%---||||%%---%F%%%%%%
||||||--||||||-||||--|||-------------g---%%%%%%%%%%%%||||%%%%%%%%||||%%---%%%%%%%%||||||||||||||||||||||||||||||||||||||-||||||||||||---|||||||--||||||||---|||||-|tt-------||||||||---||||||---|%||||||
||||||--||||||-|||XXXXXX--XXX--XXXX---XXX||||||||||||||||||||||||||||||---||||||||||||||||||||||||||||||||||||||||||||||X||||||||||||---|||||||--||||||||---||||XXXXXXXXX---||||||||---||||||---||||||||
