--------------------------------------------------------------------------------------------------------------------------------------------------------------------------------------------------------
--------------------------------------------------------------------------------------------------------------------------------------------------------------------------------------------------------
--------------------------------------------------------------------------------------------------------------------------------------------------------------------------------------------------------
---------------------------------------------------------------------------------------------------------------------------------------------#--#--------------------------------------C----------------
-------------------------------------------------------------------------------------------------------------------------------------DDD---DDD--%%%-----------------------------------------------------
--------------------------------------------------------------------------------------------------------------------------------S2SS-D-----D----|||-----------------------------------------------------
-----------------------------------------------------------------------------------------------------------SSC-----------------------D-----D----|||--------------------------------------%%%%%%---------
------D-------------------------------------------2-------------------------------------------------SSC------------------------------D-----D----|||D--C--------------------r-k-------SSS-||||||---------
------------------------------------------------------------------------------------------------------------------------------------------------|||-----------------------%%%%---------#-||||||---------
--2SS-----------r-k----------------------------------------------------------------------------------------------------------------DDDDD---D%%%-|||---r-------------------||||---tt----#-||||||---------
---------D-----%%%%---tt----------------------S---SSS--------------------g------------2SS------%%------------------------------%%%%----g----|||D|||DDDDD------------------||||---Tt----#-||||||---------
---------------||||---tt--------tt---tt---------------%%---------------SSS2S--U----------------||---%%%-----%%--------%%%%--%%%||||-%%%%%%%%|||-|||-------------------%%%%||||%%%%%%%%%%%||||||---------
%%%%-----------||||---tt--------Tt---tt-----------g---||---------tt--------------tt----SSSSC%%%||---|||%---%||---%%---||||%%|||||||-|||||||||||-|||-----------r-------|||||||||||||||||||||||||---------
||||%%--%%%%%%%||||%%%%%%%%--%%%%%%%%%%%%%--%%%---%%%%||---------Tt-----------r--tt---------|||||---||||---|||---||---|||||||||||||-|||||||||||-|%%%%%--------%%---%%%||||||||||||||||||||||%%%%%F%%%%%%
||||||--|||||||||||||||||||--|||||||||||||--|||---||||||---%%%%%%%%%%%%%%%%%%%%%%%%%%%--%%%%|||||---||||---|||---||---|||||||||||||-|||||||||||-||||||--------||---||||||||||||||||||||||||||||||%||||||
||||||--|||||||||||||||||||--|||||||||||||--|||---||||||---|||||||||||||||||||||||||||--|||||||||---||||---|||---||---|||||||||||||X||||||||XXXXX|||||XXXXXXXX||---|||||||||||||||||||||||||||||||||||||
