--------------------------------------------------------------------------------------------------------------------------------------------------------------------------------------------------------
--------------------------------------------------------------------------------------------------------------------------------------------------------------------------------------------------------
--------------------------------------------------------------------------------------------------------------------------------------------------------------------------------------------------------
----------------------------------B-B-------------------------B--------B-B------------------------------------------------------------------------------------------------------------------------------
-------2BB------------k--BBBB---------------------B--------------tt--#------tt--BBC----#----------------------------------------------------------------------------------------------------------------
-----------BBC---D-%%%%---------------------2---------2BB--------Tt--#------tt---------#--%%%%----g-----------------------------------------------------------------------------------------------------
-%%%%%%%%----------||||----------%%%%%---------------------------tt--#------tt------g--#--||||-%%%%%%------BBBB-----------------------------------------------------------------------------------------
-||||||||------g---|k||----------|||||----------------------%%%%%%%%%%%%%%%%%%%%%%%%%%%%%%||||-||||||-----------#----------------------------------------------------------C----------------------------
-|||||G#|-%%%%%%%%%||||%%%--%%---|||||-----------%%---------||||||||||||||||||||||||||||||||||-||D|||-----------#---------------------------------------------------------------------------------------
B|||||X#|-||||||||||||||||--||---|||||%---%%----%||---%%%---|||||||||||||||||||||||-------||||-||-|||%%%--------#-----------C---------------------------------------------------------------------------
-|||||X#|----------||||----------||||||---||----|||---|||--------|||||||||||-----------D-#||||%||%||||||------DDDDD---D-------------------------------------------------------------%%%%----------------
-|||||XX|---D--C--D||||D-BBB2-------|||---||--------------------BB---BB----BBB-----------#---|||||||||||---BB---D---------------------------------------------------tt--B--tt-------||||----------------
%|||||XX|----------||||--------------------#----------%%%---------------BB2B---B-B--%%%%-#---|||||||||||--------D-------B-------%%%%--*--%%%%------------------tt---Tt-----Tt-------||||----------------
||||||XX|----------||||------g-------------#----------|||-----------tt--------------||||----#--||-|||-----------------D----tt---||||--*--||||----------%%%%----tt---tt-----tt---%%%%|||DDD---%%%%F%%%%%%
||||||XXD--%%-%%%%%||||%%%%%%%---%%DDDD--r-#----%%%---|||-----------Tt------g--r-r--||||---###-||X|||------%%%%%%%%--------tt---||||--*--||||----------||||%%%%%%%%%%%%%%%%%%%%%|||||||X-D---||||X||||||
||||||XX---||-||||||||||||||||---||-------%%%---|||---|||---%%%--%%%%%%%%%%%%%%%%%%%||||%%%%%%%||||||%%%---||||||||---%%%%%%%%%%||||%%%%%||||%%%--%%---||||||||||||||||||||||||||||||||X-----||||X||||||
