--------------------------------------------------------------------------------------------------------------------------------------------------------------------------------------------------------
--------------------------------------------------------------------------------------------------------------------------------------------------------------------------------------------------------
--------------------------------------------------------------------------------------------------------------------------------------------------------------------------------------------------------
--------------------------------------------------------------------------------------------------------------------------------------------------------------------------------------------------------
-------------D-------------------------------g-----g----------------------------------------------------------------DDDD---DDDDDDD----------------------------------------------------------------------
-----------------------------------------%%%%%%%%%%%%D-----------------S-----------C-----------------S--SS--------r-k--SSS-------C-S--------------------------------------------------------------------
-SCS-------------------------------------||||||||||||D-------------C---------------------D---tt-------------tt-D-%%%%----------------C--%%%%---%%%%------------%%----------*--tt--U--tt---tt------------
------DDDDD---%%---%%-D-----------------C||||||||||||D-----2SS-------------------------------Tt-------------tt---||||--------tt---------||||---||||---%%%%-----||------tt--*--Tt-----Tt---Tt------------
----------SSS-||---||--------------------||||||||||||--------------r--------%%%--------------tt-------------tt---||||--------tt---------||||---||||---||||-%%%%||------tt--*--tt-----tt---tt------------
SSSSS---------||---S|------------SS----S-||||||||||||-------------%%---%%---|||----D----DDDDD%%DD---DDDD%%%%%%%%%||||%%%--DDDDDDDDDDDDD%||||%%%||||%%%||||-||||||---%%%%%%%%%%%%%%%%%%%%%%%%%%%%%%------
---------D--SSS|----|-tt-D-tt------------||||||||||||-------------||---||---|||---DD---------||---------||||||||||||||||---------------|||||||||||||||||||-||||||---||||||||||||||||||||||||||||||------
---------------|----|-Tt---tt---tt-----2S||||||||||||%%%---%%%%---||---||---|||--------------||---------|||g||||||||||||--------r------|||||||||||||||||||-||||||---||||||||||||||||||||||||||||||------
%%%%-----------|g---|-tt---tt---tt-------|||||||||||||||---||||---||---||---|||--------------||--------C|SSSSC||||||||||#-S-#--%%%%----|||D|||||||||||||||%||||||---||||||||||||||||||||||||||||||------
||||%%--%%%%%%%%---%%%%%%%%%%%%%%%%%---%%|||||||||||||||---||||---||---||---%%%--------%%----||-----%%--|-----||||||||||#---#--||||---tt||D||tt||||||||||||||||||---|||||||||||||||||||||%%%%%%%%F%%%%%%
||||||--||||||||---|||||||||||||||||---|||||||||||||||||---||||---||---SS---|||---%%---||----||-----||-r|----g||||||||||#-r-#--||||---tt||-||Tt||||||||||||||||||---|||||||||||||||||||||||||||||%||||||
||||||--||||||||---|||||||||||||||||---|||||||||||||||||---||||---||--------|||---||---||XXXXXXXX---||XXXXXXXXXX|||||XXXXXXXXXX||||XXXXX||X|XXX||||||||||||||||||---||||||||||||||||||||||||||||||||||||
