--------------------------------------------------------------------------------------------------------------------------------------------------------------------------------------------------------
--------------------------------------------------------------------------------------------------------------------------------------------------------------------------------------------------------
---------------------------------------------------C----------------------------------------------------------------------------------------------------------------------------------------------------
------------------------------------------------------------------------------------------------------------S-#-------------------------#---------------------------------------------------------------
----------------------------------#--#---------------------------------------g--------------------------------#-------------------------#---------------------------S-S---------------------------------
-----------------D---%%-----DDDDDDD--%%S2S-------------DDD-DDDDDD-----------SS------%%%%---------G#-----------#-------------------------#---------------------------------------------------------------
SS----------g----D---||--------------||------------S--------------------------------||||--S2SS-U--#-----%%%%%%%%%DDDDDDD-C-----DDD----DDDDD-------------------------------------------------------------
------D-SSCSS2SS-----||S------SS-----||---ry----------------r-----------SS----------||||----------#-----|||||||||----------SSC----------D---------------------------------------------------------------
---------------------||-----------tt-|C--%%%%------S-------%%%%---tt-D-----SSSSS----SS||---------DDDDDDD|||||||||---g---C---------------D--SS------------------------%%%--------------------------------
SSSSS---------SS-----||------tt---Tt-|---||||--------------||||---Tt---tt-------------||----------------|||||||||-%%%%-----------------SD-----S------------SS-------D|||--------------------------------
---------D-----------||------Tt---tt-|r--||||k-r-------g---||||---tt---Tt-------------||g-----%%%%------S2SS||D||-||||---tt---tt---tt---D-tt------------------SSS----|||----------------%%%%------------
-------------tt------%%%---%%%%%%%%%%%%%%||||%%---%%---%%%%||||%%%%%%%%%%%%%%%%%%---%%%%%%%%%%||||-%%SS-----||-||-||||---tt---tt---Tt-----tt-----%%%%-----tt---------|||----------------||||------------
%%%%---------tt------|||---||||||||||||||||||||---||---||||||||||||||||||||||||||---||||||||||||||-||-------||%%%%||||%%%%%%%%%%%%%%%%%%%%%%%%%%%||||-----tt------g--%%%----------------||||------------
||||%%--%%%%%%%%%%---|||---||||||||||||||||||||---||---||||||||||||||||||||||||||---||||||||||||||-||-------|||||||||||||||||||||||||||||||||||||||||---%%%%%%%%%---%|||------------%%%%||||%%%%%F%%%%%%
||||||--||||||||||---|||---||||||||||||||||||||---||---||||||||||||||||||||||||||---||||||||||||||-||-%%%%%%%%|||||||||||||||||||||||||||||||||||||||---|||||||||---||||---%%%%--%%%|||||||||||||%||||||
||||||--||||||||||---|||---||||||||||||||||||||---||---||||||||||||||||||||||||||---||||||||||||||X||X|||||||||||||||||||||||||||||||||||||||||||||||---|||||||||---||||---||||--|||||||||||||||||||||||
