--------------------------------------------------------------------------------------------------------------------------------------------------------------------------------------------------------
--------------------------------------------------------------------------------------------------------------------------------------------------------------------------------------------------------
--------------------------------------------------------------------------------------------------------------------------------------------------------------------------------------------------------
--#---C-------------------------------------------------------------------------------------------------------------------------------------------------------------------------------------------------
--#--------------------D--------------------------------------------------------------------------------------------------------------------------------------------------------------------------------
--#---------------------------------DDD----------------------DDDD---------------------------------------------------------------------------------------------------------------------------------------
--#-----------------------------2SS--------------------SSS----------------------SSSS--------------------------C-----------------------------------------------------------------------------------------
-%%%%-D--------DDDDDD---DDD--------------SS-------------------------C-----------------------------------------------------------------------------------------------------------------------------------
-||||---------------SSS-----------------------S2SSSS---SS-------------C-----------------------------------------------------C---------------------------------------------------------------------------
-||||---------------------------DDDD----tt-------------------------------%%%%-----------------------------------C---------------------------------------------------------------------------------------
-||||----D--SS----D---tt--SSS------r----Tt------------tt-----%%%%-----r--||||-----%%%%%-----------------------tt--C--tt-------------------------------k-------------------------------------------------
-||||-----------------Tt----------%%%DDDDDDDD---------tt-----||||---%%%%%||||---%%|||||------%%%----tt---tt---Tt-----tt----------------------------%%%%--S-------tt--------tt---tt----------------------
%%%%|-----------g-----tt------g---|||--------------DD%%%%%---||||---|||||||||---|||||||------|||----tt---Tt---tt--r--tt---%%%%----*----------------||||----------tt---tt---tt---Tt----------------------
||||%%--%%%%%%%%%%%%%%%%%%%%%---%%|||--------SSSSC---|||||---||||---|||||||||---|||||||%%%---|||%%%%%%%%%%%%%%%%%%%%%%%%%%||||----*----------------|k||------g---tt---tt---tt---tt-----#----%%%%%F%%%%%%
||||||--|||||||||||||||||||||---|||||----------------|||||---||||---|||||||||---||||||||||---|||||||||||||||||||||||||||||||||----*--#---------%%%DDDD|%%%---%%%%%%%%%%%%%%%%%%%%%%%---%%%%%|||||%||||||
||||||--|||||||||||||||||||||---|||||----------------|||||---||||---|||||||||---||||||||||---|||||||||||||||||||||||||||||||||---XXXXX---XXXXXX|||-|||||||---|||||||||||||||||||||||---|||||||||||||||||
