--------------------------------------------------------------------------------------------------------------------------------------------------------------------------------------------------------
--------------------------------------------------------------------------------------------------------------------------------------------------------------------------------------------------------
--------------------------------------------------------------------------------------------------------------------------------------------------------------------------------------------------------
-----------#--------------------------------------------------------------------------------------------------------------------------------------------------------------------------------------------
-----------#-----------------------SSSC--------------------------D--------------------------------------------------------------------------------------------------------------------------------------
--g--------#----------------------------------S2SS------------------------------------------------------------------------------------------------------------------------------------------------------
-SS2S------#---------------------------------------------------------------------------------U----------------------------------------------------------------------------------------------------------
------DDDDDDDD--DDD-------------S2SSSSS-----k------------DDDDDD--DDD--%%------DDD-----%%%---------------------------------------------------------------------------------------------------------------
-----------D-----------------------------%%%%-------------------------||-------C------|||----r--g-------------------------------------------------------------------------------------------------------
SSSSS------D------------U---SS-----------||||---%%%%------------------||--------------|||---DDD%%SC-------r------------------------------------------C--------------------------------------------------
---------D----------tt----------tt-------|k||---||||-%%%%%%-D---tt----||-------------S|SS------||--------%%%%---tt--SSC---------------%%%%---tt---tt--#-------------------------------------------------
--------------------Tt-----tt---tt---%%%%||||%%%||||-||||||-----Tt---tt|---------r----|--------||---tt---||||---Tt----------tt---tt---||||---tt---Tt--#-----------------C-C-----------------------------
%%%%----------------tt-----tt---tt---|||||||||||||||-||||||-----tt---Tt|------%%%----r|----g--#||#--Tt---||||---tt------g---tt---tt---||||---tt---tt--#---%%%-----%%%%----------------------------------
||||%%--%%%%%%%--%%%%%%%%%%%%%%%%%%%%|||||||||||||||-||||||%%%%%%%%%%%%%%%%---|||---%%%%%---%%%||%%%%%%%%||||%%%%%%%%%%---%%%%%%%%%%%%||||%%%%%%%%%%%%%---|||-----||||----------------------%%%%%F%%%%%%
||||||--|||||||--|||||||||||||||||||||||||||||||||||%||||||||||||||||||||||---|||---|||||---|||||||||||||||||||||||||||---|||||||||||||||||||||||||||||---|||-----||||----------g------g----|||||%||||||
||||||--|||||||--||||||||||||||||||||||||||||||||||||||||||||||||||||||||||---|||---|||||---|||||||||||||||||||||||||||---|||||||||||||||||||||||||||||---|||---XX||||XXXXXX---XXXX---XXX---||||||||||||
