--------------------------------------------------------------------------------------------------------------------------------------------------------------------------------------------------------
--------------------------------------------------------------------------------------------------------------------------------------------------------------------------------------------------------
------------------------------------------------------------------------------------------------------------------------------------------------------------------#-------------------------------------
------------------------------------------------------------------------------------------------------------------------------------------------------------------#---------------------#---------------
------------------------------------------------------------------------------------------------------------------------------------------------------------------#--tt-----D---D-------#---------------
----------------------------------------------------------------------------------------------------------------------------------------------------------%%%%----#--Tt-----------------#---------------
-----------------------------C-------------------------------------------------------------------------------------------------------------------%%%%-----||||---%%%%%%%%%%%%---%%%%%%%%%%%%%-----------
-------------------------------------------------------------------------------------------------------------------------------------------------||||-%%%%||||---||||||||||||---|||||||||||||-----------
------G#-D---------------------------------------------------S--------r--C--------------------------------------------------------C-----------D%%||||-||||||||---||||||||||||---|||||||||||||-----------
SSSSS--#--------------------g------rg--------------C-----SSC------C--%%%%---tt--#----------------------U----------------------------C-----SSC--||||||-||||||||---||||||||||||---|||||||||||||-----------
-------#-#----U--------------2SS--%%%%--SSCS-------------------------||||---tt--#--tt---%%%%-----%%%%----------------tt------%%----------------||||||-||||||||---|D||||||||||---|||||||||||||-----------
---------#--D---------------------||||-------------r---------g----r--||||k--tt--#--tt---||||-----||||-----tt---------tt------||---------------g||||||%||||%|||---|-||||||||||---|||||||||||||-----------
%%%%-----#K------%%---------------||||k-----g---%%%%%%---%%%%%---%%%%||||%%%%%%%%%%%%%%%||||-----||||-----Tt---%%%%%%%%%%%---||%%%%%%%---%%%%%%%%|||||||||||||---|-||||||||||---|||||||||||||-----------
||||%%---#-------||---%%%%---%%%%%||||%%%%%%%%%%||||||---|||||---|||||||||||||||||||||||||||---%%||||%%%%%%%%%%|||||||||||---|||||||||---|||||||||||||||||||||---|-||||||||||---||||||||||%%%%%%%F%%%%%%
||||||--%%%%%%%%%||---||||---|||||||||||||||||||||||||---|||||---|||||||||||||||||||||||||||---|||||||||||||||||||||||||||---|||||||||---|||||||||||||||||||||---|-||||||||||---|||||||||||||||||%||||||
||||||--|||||||||||---||||---|||||||||||||||||||||||||---|||||---|||||||||||||||||||||||||||---|||||||||||||||||||||||||||---|||||||||---|||||||||||||||||||||---|-||||||||||---||||||||||||||||||||||||
