--------------------------------------------------------------------------------------------------------------------------------------------------------------------------------------------------------
--------------------------------------------------------------------------------------------------------------------------------------------------------------------------------------------------------
--------------------------------------------------------------------------------------------------------------------------------------------------------------------------------------------------------
--------------------------------------------------------------------------------------------------------------------------------------------------g-------------------------------#---------------------
---------------------------------------------------------------------------------------------------------------------------------------------------2B----------------------#--tt--#---------------------
-------------------------------------------------------------------------------------------------C--------------r-----------B-----C---------------------------#----%%%%%---#--tt--#---------------------
------------------------------------------------------------------------------------------D---tt---tt--#--tt---%%%%-----------*---------------------g--------###---|||||---#--tt--#-----g---------------
------D%%%%-----------------%%%%%%%---D-------------------------------------g-----------------tt---Tt--#--Tt---||||-----------*------tt------------%%%%%--%%%%%%%%%|||||%%%%%%%%%%%---%%%%%%%-----------
-------||||--------BB-------|||||||---D------------------C----k-----------BB------------------tt---tt--#--tt---||||-----------*------tt-----%%%%---|||||--|||||||||||||||||||||||||---|||||||-----------
BBBBB---------C---------r----C----------C-C---BB-----------%%%%---tt----------------%%%%%%%%%%%%%%%%%%%%%%%%%%%||||%%%%%%---%%%%%%%%%%%%%---||||---|||||--|||||||||||||||||||||||||---|||||||-----------
---------D--U------------%%%---BBC----C--------------------||||---Tt----------------|||||||||||||||||||||||||||||||||||||---|||||||||||||---||||---|||||--|||||||||||||||||||||||||---|||||||-----------
-------------------------|||-----------------tt------------|k||k--tt------%%%%%---%%|||||||||||||||||||||||||||||||||||||---|||||||||||||---||||---|||||--|||||||||||||||||||||||||---|||||||-----------
%%%%--------r----%%%%%---|||-------g--r------tt---%%%%--%%%||||%%%%%%%%---|||||---|||||||||||||||||||||||||||||||||||||||---|||||||||||||---||||---|||||--||||||||||-||||||||||||||---|||||||-----------
||||%%--%%%%%%%%%|||||---|||%%%%%%%---%%%%%%%%%%%%||||%%|||||||||||||||---|||||---|||||||||||||||||||||||||||||||||||||||---|||||||||||||---||||----------------------------------------|||||---%F%%%%%%
||||||--||||||||||||||---||||||||||---|||||||||||||||||||||||||||||||||---|||||---|||||||||||||||||||||||||||||||||||||||---|||||||||||||---|||-----------------------------------------|||||---|X||||||
||||||--||||||||||||||---||||||||||---|||||||||||||||||||||||||||||||||---|||||---||||||||---------------------||||---------------------------------------------------------------------|||||---|X||||||
