--------------------------------------------------------------------------------------------------------------------------------------------------------------------------------------------------------
--------------------------------------------------------------------------------------------------------------------------------------------------------------------------------------------------------
--------------------------------------------------------------------------------------------------------------------------------------------------------------------------------------------------------
--------------#-----------------#--g------g-------------#-----#-----------------------------------------------------------------------------------------------------------------------------------------
--------------#--D-----D--BCD---%%BB2%%%%%%%--------#--###---##------B2BBBBD----D%%%%-BBBBBBB---BBBB--------------------------------------------------------------------------C-------------------------
----%%%%%%----#K------------D---||---|||||||---D----%%%%%%%%%%%---D--------------||||-----------------------------%%%%----------------------------------------------------------------------------------
-BB-||||||----#-----r-----------||---|||||||BB-D----|||||||||||---D-----------------------------------------------||||-----------BBB-----tt-------------------------------------------------------------
------------%%%%%%%%-----DDDD---||---|||||||---D----|||||||||||---D------------B---D--%%%%--------tt--#-----------||||-------D-----------tt---tt------------%%%%-----BBB--------------------------------
------G#-D--||||||||------------||B--|||||||--------|||||||||||-----%%%%-BBB----------||||--------tt--#-------%%%%||||%%%%-----------g---tt---tt---%%%%-----||||-------------tt---%%%%------------------
BBBBB--#------------------------||---||||%|%B2B-----B-B------B------||||----------g---||||--------tt--#-------||||||||||||---%%%%%%%%%%%%%%%%%%%%%%||||-%%%%||||-------g-----tt---||||-%%%%%%%----------
-------#-U-------BBB---B-BBC---------|||||||-------------tt---------||||-------%%%%%%%||||%%%---%%%%%%%%%--%%%||||||||||||---||||||||||||||||||||||||||-||||||||%%---%%%---%%%%%%%||||-|||||||----------
---------#--D-BBB-------------------r|||||||B------------Tt-------%%||||%%%%---||||||||||||||---|||||||||--|||||||||||||||---||||||||||||||||||||||||||-||||||||||---|||---|||||||||||-||D||||----------
%%%%-----#-------------r-----g---%%%%|||||||--B----------tt-------||||||||||---||||||||||||||---|||||||||--|||||||||||||||---||||||||||||||||||||||||||-||||---------|||---|||||||||||-||-||||----------
||||%%---#-------------%%%%%%---%|||||||||||-------%%%%%%%%%%%%---||||||||||---||||||||||||||---|||||||||--|||||||||||||||---||||||||||||||||||||||||||%||||---------|||---|||||||||||%||%||||%%%F%%%%%%
||||||--%%%%%%%%%%%%---||||||---|||||||r||||--r----||||||||||||---||||||||||---||||||||||||||---|||||||||--|||||||||||--||---|||||||||||||||||||||||||||||||---------|||---||||||||||||||||||||||X||||||
||||||--||||||||||||---||||||---||||||||||||%%%%---||||||||||||---||||||||||---||||||||||||||---|||||||||--|||||||||||---------------------------|||||||||||---------|||---||||||||||||||||||||||X||||||
