--------------------------------------------------------------------------------------------------------------------------------------------------------------------------------------------------------
--------------------------------------------------------------------------------------------------------------------------------------------------------------------------------------------------------
--------------------------------------------------------------------------------------------------------------------------------------------------------------------------------------------------------
--------------------------B-B------------B------------------------------------------------------#--------------------g-------------------------------------------------#--#-------#--#------------------
--------------------------------BBB----#---------------------------------------------------DD---%%%-----------------BB2B----2BB-------------#----------------G#------DDD--%%%---%%%--%%%%%%-------------
-------------------%%-B----------------#----%%%%----g-------B2BB---BB----------BB-----DDBB------|||-----------------------------------------#-B2BBBBBBBBBBBB--#---BB------|||---|||--||||||-------------
BC--------g--------||-----r---------g--#----||||-%%%%%%----------------%%%%-------BBB-----------|||-------g----U-B--------------------------#-----------------#-----------|||---|||--||||||-------------
------D--BB2BBBD---||-r--%%%%---%%%---%%%%%%||||-||||||-----------tt---||||---tt-----------#----------B-BBB2BB-----BBBB2---------------tt---------------------------------------------------------------
---------------D---||%%%%||||---|||---||||||||||-||D|||-----------tt---|k||k--tt----------###------%%------------------------%%%%%%----Tt---------------------------------------------------------------
BBBBB--------------||||||||||---------||||||||||-||-|||%-------DDDDDDDDDDDDDDDDDDDDDDDDDDDDDD---%%%||------------------g-----||||||%%%%%%%DDDDDD--D----D-BBB%%----D---DDDDDDD---DDD--DDDDDD-------------
---------D---------||||||||||--------------#--||%||%||||-BBCBB---------XXXX---------------------|||||DDDDDD%%%%%%%%%%%DD---DD|||||||||||||-----G#-----------||------------------------------------------
----------------r----U----------------DD---#--||||||||||-------------#-XXXX------#----g---#-----|||||------|||||||||||-----------------||----g--#----------------------B-------BBB----------------------
%%%%---------%%%---B------------%%D--------#-----||-||||---------%%--#-XXXX----B-#--%%%%--#---------------------------------------------B--%%%%-#-tt-D-tt-D----------D----%%%%--#-----------------------
||||%%--%%%%%|||----------------||----%%%%%%%%%%-||D||||--2BBBBB-||--#-X|||%%%DD-#--||||--#--------tt---tt--------tt-----------------------||||---tt---tt-----------------||||--#---tt-BBB----%%%F%%%%%%
||||||--||||||||--------%%%%%---||%---||||||||||-||X||||-------------#-X||||||-r-#--||||--#--------Tt---Tt--------tt-------%%----%%%%%%----||||---tt---tt---%%%---#--#----||||--#---tt--------|||X||||||
||||||--||||||||---%%%%%|||||---|||---||||||||||-||X|||----------%%%%%%||||--|%%%%%%||||%%%%%---%%%%%%%%%%%%%--%%%%%%%%%---||%%%%||||||%%%%||||%%%%%%%%%%%%%|||------%%%%%||||%%%%%%%%%%%-----|||X||||||
