--------------------------------------------------------------------------------------------------------------------------------------------------------------------------------------------------------
--------------------------------------------------------------------------------------------------------------------------------------------------------------------------------------------------------
--------------------------------------------------------------------------------------------------------------------------------------------------------------------------------------------------------
-----------------------U--------------------------------------------------------------------------------------------------------------------------------------------------------------------------------
---------------------------#---------%%%%----g-----#----------------------------------------------------------------------------------------------------------------------------------------------------
-----------------%%%%%-r--##---#--#--||||-%%%%%%-C-#----------------------------------------------------------------------------------------------------------------------------------------------------
-BBB-------g---g-|||||%%%%%%---D--%%%||||-||||||---#--------------------DDDDDDD-------------------------------------------------------------------------------------------------------------------------
------D--%%%%%%%%|||||||||||---D--|||||||-||||||-r-#-r--------------------------------------------------------------------------------------------------------------------------------------------------
---------||||||||||||||-----------|||||||-||||||%%%%---D-----B2B---2BB-B----k-----g-----g---------------------------------------------------------------------------------------------------------------
BBBBB----||||||||||||||D---D------|||||||%||||||||||---D-----------------%%%%---%%%%--BBB2BBB2----BBB---------------------------------------------------------------------------------------------------
---------||||||||-----------------||||||||||||||||||---D-----B-----------||||---||||------------------------%%%%--BBB------------------------------------------------------------------#----------------
---------||||||||%%BB---------------------||||||---C---------------------|k||---||||------g-------D----tt---||||----------------------------tt-----------U-BBCB--------BBB-------------#----------------
%%%%-----||||||||||DD--tt-D-----C---------||||||D------------------%%%%%%||||%%%||||%%%%%%%%%%%--------tt---||||------g-------D----%%%%-----tt-------tt------------tt--------------tt--#----------------
||||%%--%||||||||||-D--tt----------tt-----||||||-------%%----------||||||||||||||||||||||||||||---%%%%%%%%%%||||%%%%%%%%%%%--------||||-----tt-------tt--------g---Tt------g-------Tt--#--%%%%%%%F%%%%%%
||||||--|||||||||||----tt-------r--Tt-----||||r|-------||---%%%%---||||||||||||||||||||||||||||---|||||||||||||||||||||||||---%%%%%||||---%%%%%%---%%%%%%%%%%%%%%%%%%%%%%%---%%%%%%%%%%%%%|||||||X||||||
||||||--|||||||||||%%%%%%%%%---%%%%%%%%%--||||||%%%%---||---||||---||||||||||||||||||||||||||||---|||||||||||||||||||||||||---|||||||||---||||||---|||||||||||||||||||||||---||||||||||||||||||||X||||||
