--------------------------------------------------------------------------------------------------------------------------------------------------------------------------------------------------------
--------------------------------------------------------------------------------------------------------------------------------------------------------------------------------------------------------
-----------------------------------------------------------------------------------------------------------#----------------------------------------------C---------------------------------------------
-----------------------------------------------------------------------------------------------------------#--------------------------------------------------------------------------------------------
-------------------------------------------------------------%%%%------------------------------------------#---------g---------tt--------------------------------------------------------C--------------
-------------------------------------------------------------||||----------------------------------------%%%%%------BB---------tt---------ry------------------------------------------------------------
-BC---------------------------%%%%%DDD-----D-------BC--------||||-------------------------------B2BBBBBB-|||||--------------%%%%%%%------%%%%--------tt---tt-------------------------------%%---%%------
------D-------------BCDDDD--%%|||||--------------B---DDDDDDD--|||%%%%-----------%%%----------------------|||||-----------BB-|||||||------||||--------tt---Tt---%%%%----g----------%%%%-----||---||------
----------------------------|||||||---------------------------|||||||-----------|||--------------------------------BBB----#--------------||||--------tt---tt---||||-%%%%%%--------||||-%%%%||---||------
BBBBB---------g------------------BB------BC---D-------B-------|||||||---------g-|||----k-----------BB------D--------------#------%%%%%%%%||||%%%--%%%%%%%%%%%%%||||-||||||--BB%%%%||||-||||||---||------
---------D--BBB2B--BBBB2B----D------------------%%%%%---#--tt--B-#--tt------B---B---%%%%--BB2---D------tt-----------------#------|||||||||||||||--|||||||||||||||||-||||||----||||||||-||||||---||------
--------------------------------tt----------g---|||||---#--Tt----#--tt--------------||||----------tt---Tt---%%%---%%%%---%%%%%%%%|||||||||||||||--|||||||||||||||||-||||||%%--||||||||-||||-------------
%%%%------------g------g--------Tt-------%%%%%%%|||||---#--tt--r-#--tt----------g---|k||k-----g---tt---tt---|||---||||---|||||||||||||||||||||||--|||||||||||||||||%||||||||------||||%||||%------------
||||%%--%%%%%%%%%%%%%%%%%%%--%%%%%%%%%---||||||||||||%%%%%%%%%%%%%%%%%%%---%%---%%%%||||%%%%%---%%%%%%%%%%%%|||---||||---|||||||||||||||||||||||--||||||||||||||||||||||||||%%%%%%||||||||||%---%F%%%%%%
||||||--|||||||||||||||||||--|||||||||---|||||||||||||||||||||||||||||||---||---|||||||||||||---|||||||||||||||---||||---|||||||||||||||||||||||--|||||||||||||||||||||||||||||||||||||||||||---|X||||||
||||||--|||||||||||||||||||--|||||||||---|||||||||||||||||||||||||||||||---||---|||||||||||||---|||||||||||||||---||||---||||||||||||----||||-----------------|||||||||||||||||||||||||||||||---|X||||||
