--------------------------------------------------------------------------------------------------------------------------------------------------------------------------------------------------------
--------------------------------------------------------------------------------------------------------------------------------------------------------------------------------------------------------
--------------------------------------------------------------------------------------------------------------------------------------------------------------------------------------------------------
--------------------------------------------------------------------------------------------------------------------------------------------------g-------------------------------#---------------------
---------------------------------------------------------------------------------------------------------------------------------------------------2S----------------------#--tt--#---------------------
-------------------------------------------------------------------------------------------------C--------------r-----------S-----C---------------------------#----%%%%%---#--tt--#---------------------
------------------------------------------------------------------------------------------D---tt---tt--#--tt---%%%%-----------*---------------------g--------###---|||||---#--tt--#-----g---------------
------D%%%%-----------------%%%%%%%---D-------------------------------------g-----------------tt---Tt--#--Tt---||||-----------*------tt------------%%%%%--%%%%%%%%%|||||%%%%%%%%%%%---%%%%%%%-----------
-------||||--------SS-------|||||||---D------------------C----k-----------SS------------------tt---tt--#--tt---||||-----------*------tt-----%%%%---|||||--|||||||||||||||||||||||||---|||||||-----------
SSSSS--||||---C---------r---|C|||||-----C-C---SS-----------%%%%---tt----------------%%%%%%%%%%%%%%%%%%%%%%%%%%%||||%%%%%%---%%%%%%%%%%%%%---||||---|||||--|||||||||||||||||||||||||---|||||||-----------
-------||D|-U------------%%%|-|SSC|---C--------------------||||---Tt----------------|||||||||||||||||||||||||||||||||||||---|||||||||||||---||||---|||||--|||||||||||||||||||||||||---|||||||-----------
-------||-|--------------||||-|---|----------tt------------|k||k--tt------%%%%%---%%|||||||||||||||||||||||||||||||||||||---|||||||||||||---||||---|||||--|||||||||||||||||||||||||---|||||||-----------
%%%%---||-|-r----%%%%%---||||-|---|g--r------tt---%%%%--%%%||||%%%%%%%%---|||||---|||||||||||||||||||||||||||||||||||||||---|||||||||||||---||||---|||||--|||||||||||||||||||||||||---|||||||-----------
||||%%-|%%%%%%%%%|||||---|||%%%%%%%---%%%%%%%%%%%%||||%%|||||||||||||||---|||||---|||||||||||||||||||||||||||||||||||||||---|||||||||||||---||||---|||||--|||||||||||||||||||||||||---|||||||---%F%%%%%%
||||||-|||||||||||||||---||||||||||---|||||||||||||||||||||||||||||||||---|||||---|||||||||||||||||||||||||||||||||||||||---|||||||||||||---||||---|||||--|||||||||||||||||||||||||---|||||||---|%||||||
||||||-|||||||||||||||---||||||||||---|||||||||||||||||||||||||||||||||---|||||---|||||||||||||||||||||||||||||||||||||||---|||||||||||||---||||---|||||--|||||||||||||||||||||||||---|||||||---||||||||
