--------------------------------------------------------------------------------------------------------------------------------------------------------------------------------------------------------
--------------------------------------------------------------------------------------------------------------------------------------------------------------------------------------------------------
--------------------------------------------------------------------------------------------------------------------------------------------------------------------------------------------------------
--------------------------------------S-----------------------------------------------------------------------------------------------------------------------------------------------------------------
------------------------------SSS-------#-------------------------------------------------------------------------------------------------------------C--------------------C----------------------------
-------------------------%%%%-----------#----------------------------------------------------------------------------------------------------------------------------------------%%%--------------------
SSSSS-----------%%-------||||-----------#-%%---DD%%---D---------------------------------------------------------------------------------------------------------------------S----|||--------------------
------D-SS2SSSC-||-SS2%%%||||-------%%%%%%||---D-||---D-------U------------------------------------------------------------------------------------------------------------------|||--------------------
----------------||----|||||||DD%%---||||||||---D-||---SSS-*------------------------------------------------------------------------------------------SS-----------tt-------SS----||%%%%-----------------
SSSSS-----------S2SS--|||||||--||---||||||||-----C|-------*--------------------------------------------------------------------------------------------------tt---tt-------------||||||-----------------
---------D--S-#-------|||||||--||---||||||||------|-------*--%%%%----y-----------------------------------------------------------------------------------g---tt---tt-----------g-||||||-----------------
--------------#-------tt|||||%%%%---||||D|||------|----g--*--||||-%%%%%%-----------------------------r-------C-----k-------------------------------DDDD---DDD%%DDD%%DDD---%%%---DDDDDDDDD---------------
%%%%--------r-#-------Tt|||||||||---||||-|||----%%%---%%%%%%%||||-||||||-SS---D-------------SS2-----%%%%---tt---%%%%-----------------------tt--SSC-----------||---||------|||------||||-----------------
||||%%--%%%%%%%%%--%%%%%|%%||||||---|%%%%%%%---%|||---|||||||||||-||||||----------------------------||||---tt---||||---tt-------------tt---Tt----------------||---||------|||------||||---%%%%%%%F%%%%%%
||||||--|||||||||--||||||||||||SS---||||||||---||||---|||||||||||-||||||-----g-----%%%%%%-------g---||||k--tt---|k||---tt---%%%-------tt---tt------g------#--#|---||#-----%%%------||||DDD|||||||%||||||
||||||--|||||||||--||||||||||||-----||||||||---||||---|||||||||||X||||||XXX---XX---||||||XXXXXXXXXXX||||XXXXXXXX||||XXXXXXXX|||---XXXXXXXXXXXXXXXXXXXXX------XXX--XXX-----|||---XXX||||---||||||||||||||
