--------------------------------------------------------------------------------------------------------------------------------------------------------------------------------------------------------
--------------------------------------------------------------------------------------------------------------------------------------------------------------------------------------------------------
--------------------------------------------------------------------------------------------------------------------------------------------------------------------------------------------------------
--------------U-----------------------------------------------------------------------------------------------------------------------------------------------------------------------------------------
--------------------------------------------------------------------------------------------------------------------------------------------------------------------------------------------------------
--------------r-----------------------------------------------------------------------------------------------------------------------------------------------------------------------------------------
-SSSS-------DDDDD-D-------------------------------------------------------------------------------------------------------------------------------------------------------------------------------------
------D-SSS---------------------------------------------------------------------------------------------------------------------------------------------------------------------------------------------
---------------------------SS------------------------------------------------------------------------------------------------------------C--------------------------------------------------------------
SSSSS-------C-----C--D------------------C-C-S2SS----------------------r-k-------------------------------------rg-----g--------------%%%%----------------------------------------------------------------
---------D------------------------%%%--------------------------------%%%%------------------%%--------SS2S----%%%%--SSS2SCS----------||||----------------------------------------------------------------
------------------r-----r---------|||-------------%%%%%--------------||||---%%-------------||----tt----------||||----------tt-------||||---%%%%--------------------------------------C--#---------------
%%%%-----------%%%%%%%%---D-----%%|||-------------|||||----%%%%%%----||||---||---%%%%%%%---||----Tt------g---||||------g---Tt-----%%||||%%%||||---------tt-------------------tt---tt--U-#---------------
||||%%--%%%%%%%||||||||---D-----|||||---%%%%%--%%%|||||%%%%||||||%%%%||||%%%||---|||||||---||%%%%%%%%%%%%%%%%||||%%%%%%%%%%%%%%---|||||||||||||---------Tt-----%%%%%----tt---Tt---tt----#--%%%%%%F%%%%%%
||||||--|||||||||||||||---D-----|||||---|||||--|||||||||||||||||||||||||||||||---|||||||---||||||||||||||||||||||||||||||||||||---|||||||||||||---%%%%%%%%%%---|||||----tt---tt---tt----#--||||||%||||||
||||||--|||||||||||||||---------|||||---|||||--|||||||||||||||||||||||||||||||---|||||||---||||||||||||||||||||||||||||||||||||---|||||||||||||---||||||||||---|||||XXXXXXXXXXXXXXXXXXXXXX-|||||||||||||
