--------------------------------------------------------------------------------------------------------------------------------------------------------------------------------------------------------
--------------------------------------------------------------------------------------------------------------------------------------------------------------------------------------------------------
-------------------#------------------------------------------------------------------------------------------------------------------------------------------------------------------------------------
-------------------#------------------------------------------------------------#-----------------------------------------------------------------------------------------------------------------------
------------SSS----#K-------------------------S-------%%------------g----------###-------%%---#--#--%%%%-------g----------------------------------------------------------------------------------------
-------------------#-----DDDDDDDD--DD---------DDDDD---||---%%%%-SS2SS2SSSSCSC%%%%%%%%%---||%%%%--%%%||||-%%%%%%%%%--------------------------------------------------------------------------------------
-SC---------------DDDD---D----------------------------||---||||--------------|||||||||---||||||--|||||||-|||||||||--------------------------------------------------------------------------------------
------D-SSSSSSS----D-------S----------S-----DDDDDDD---||---||||---g----------|||||||||---||||||--|||||||-|||||||||--------------------------------------------------------------------------------------
-------------------D-----------C--tt----SSS-----------||---||S|-%%%%-D-------|||||||||---||||||-*|||||||-|||||||||%%%-----------------------------------------------------------------------------------
SSSSS---------------DD---D--------Tt------------------%%---||-|-||||---------|||||||||---||||||-*|||||||%||||||||||||-------------------------------------C---------------------------------------------
---------D--------S------------r--tt--------g--#--#---||---||r|-|k||---------|||||||S|---||||||-*||||||||||||||||||||-----------------------------------------SSSSS------------%%%%------#--------------
-------------------------%%%%%%%%%%%%%%%%%%%%%%%--D---||---%%%%%||||%%%%D--tt||#||||-|---|||%%%%%%|||||||||||||||||||---------------------SS-*------S-----------------%%%%%----||||------#--------------
%%%%---------------------|||||||||||||||||||||||--D---||---|||||||||||||---tt||#||tt-|---SS||||||||||||||||||||||||||---SS2-----%%%%---------*--------------------g---|||||----||||------#--------------
||||%%--%%%%%%%---%%%%---|||||||||||||||||||||||--D---||---|||||||||||||---tt||#||tt-|-----||||||||||||||||||||||||||-----------||||---------*--tt------%%%---DD%%%%%%|||||%%%%||||%%%%%%%%%%%%%%F%%%%%%
||||||--|||||||---||||---|||||||||||||||||||||||------||---|||||||||%%%%%%%%%%%%%%%%%%-----|g||||||||||||||||||||||||-------g---||||------g--*--tt------|||-----|||||||||||||||||||||||||||||||||%||||||
||||||--|||||||---||||---|||||||||||||||||||||||------||---2SSSS||||||||||||||||||||||---SSSS2S|||||||||||||||||||XXX---XXXXXXXX||||XX---XXXXXXXXXXXX---|||-----||||||||||||||||||||||||||||||||||||||||
