--------------------------------------------------------------------------------------------------------------------------------------------------------------------------------------------------------
--------------------------------------------------------------------------------------------------------------------------------------------------------------------------------------------------------
--------------------------------------------------------------------------------------------------------------------------------------------------------------------------------------------------------
--------------------------------------------------------------------------------------------------------------------------------------------------------------------------------------------------------
---------------------------------------U----------------------------S----------------------------C--------------------SSS-------------------------------------------------------------------------------
------------SSSSS--------------------------------------------------------------2SS-------C-SS-----U-------tt---tt-------#-------------------------------------------------------------------------------
---------------------------------------r------------------S---C-----------C--------#----------------------Tt---tt---tt--#-------------------------------------------------------------------------------
------D---------DDDD---D-----DD---D--%%%%%-------------SS--------------------------#-----r-----g----------tt---tt---Tt--#-------------------------------------------------------------------------------
-------------------------------------|||||-----------C-----------%%%%%%---r--------#--%%%%%%%%%%%%%%%--%%%%%%%%%%%%%%%%%%%%%----------------------------------------------------------------------------
-S2SS-----------DDDD------r----------|||||SS-C-------------------||||||%%%%%-----%%%%%|||||||||||||||--|||||||||||||||||||||--------D-------------------------------------------------------------------
---------D--SSC----------%%%%--------|||||-------------g------%%%|||||||||||-----||||||||||||||||||||--|||||||||||||||||||||----------------------------------------------------------------------------
-------------------------||||--------||||tt-----%%---%%%%%%---||||||||||||||-----|||||||||||||r||||||--|||||||||||||||||||||-------------------%%%%---tt--#-------SS2-----------------------------------
%%%%---------------------||||k-------||||Tt-----||---||||||---||||||||||||||-----||D|tt||SS|||%%%|||%%%%||||||||||||||||||||--------tt-D-------||||---Tt--#---#-----------D---D-------------------------
||||%%--%%%%%%%%%%%%---%%||||%%---%%-|%%%%%%%%%%||---||||||---||||||||||||||-----||D|tt||--||||||||||||||||tt|||tt||||||||||--------Tt---------||||---tt--#--###------g-------D----tt---%%%---%%%F%%%%%%
||||||--||||||||||||---||||||||---||-|||||||||||||---||||||---||||||||||||||-----||-|tt||--||g|||||||||||||tt|||tt|||%%%%%%|--------tt-----%%%%||||%%%%%%%%%%%%%%%%%%%%%%%%--------Tt---|||---|||%||||||
||||||--||||||||||||---||||||||---||-|||||||||||||---||||||---||||||||||||||---XXXXXXXXXXXXXXX|||XXX||||XXXXXXXXXXXXX||||||XXXX--XXXXXXXXXX||||||||||||||||||||||||||||||||---XXXXXXXXXX|||---||||||||||
