--------------------------------------------------------------------------------------------------------------------------------------------------------------------------------------------------------
--------------------------------------------------------------------------------------------------------------------------------------------------------------------------------------------------------
----------------------------------------------------#---------------------------------------------------------------------------------------------------------------------------------------------------
----------------------------------------------------#---------B-----------------------------------------------------------------------------------------------------------------------------------------
----------------------B2BB-------------------G#-----#---------------------2BB--------------------#---------------------------------------C-------------------------------------tt---2BB%%%%%%-----------
--g------------------------------2BBBB---BBB--#-----#------------------------------#-------------##---%%%%---------------------------------------------------------------------Tt------||||||-----------
-BB2BB----------------------------------------#-DDDDDDD---DDDDDDD--------------tt--#----%%%%%%---%%%%%||||-%%%%%%%--------------------------------------------------------DDDDD%%DDD---||||||-----------
------------------------------------------------B---D--------------------------tt--#----||||||---|||||||||-|||||||-------------------------------------------------------------||------||||||-----------
-------#-D---D-D-D---DDDDDDD------------------------D--C--------------------DDDDDDDDD---||||||---|||||||||-||D||||%%%------tt------------tt--C---------------BB----------------||------||||||-----------
BBBBB--#------------------------DDDDDD-----DDDDDD-----C--%%%%--B------B---C--------D---------#---|||||||||-||-|||||||------Tt-------tt---Tt-----tt---%%%-------------tt---%%%%%||------D|||||-----------
-------#------B--------r-k----ry---------B---------------||||--------------------------------#---#-|||||||%||%|||||||------tt-------Tt---tt-----Tt---|||---------g---tt---|||||||--tt--D|||||-----------
------------D---D-D-D-%%%%---%%%%--------------%%%%%%-r--||||-------------g------------------#---##---|||||||||||||||%---%%%%%%%%%%%%%%%%%%%%%%%%%%%%|||---%%%%---%%%%%%%%|||||----tt---|||||-----------
%%%%------------------||||---||||----------g---||||||%%%%||||%%%%%--%%%---%%%%%%%%%%----D--%%%---%%%%%||||||||||||||||---|||||||||||||||||||||||||||||||---||||---|||||||||||||%%%%%%%%%|||||-----------
||||%%----------------||||---||||---%%---DD%%%%|||||||||||||||||||--|||---||||||||||----D--|||---|||||||||||||||||||||---|||||||||||||||||||||||||||||||---||||---|||||||||||||||||||||||||||%%%%F%%%%%%
||||||--%%--%%%%%%%%%%||||%%%||||%%%||-----|||||||||||||||||||||||--|||---||||||||||----D--|||---|||||||||||||||||||||---|||||||||||||||||||||||||||||||---||||---|||||||||||||||||||||||||||||||X||||||
||||||--||--||||||||||||||||||||||||||-----|||||||||||||||||||||||--|||---||||||||||-------|||---|||||||||||||||||||||---|||||||||||||||||||||||||||||||---||||---|||||||||||||||||||||||||||||||X||||||
