--------------------------------------------------------------------------------------------------------------------------------------------------------------------------------------------------------
--------------------------------------------------------------------------------------------------------------------------------------------------------------------------------------------------------
--------------------------------------------------------------------------------------------------------------------------------------------------------------------------------------------------------
-----------------------------------------#--#---------C-------------------------------------------------------------------------------------------------------------------------------------------------
---------------------------------------DDD--%%%%%%%---------------------------------g-S-----------------------------------------------------------------------------------------------------------------
------------------#---------------SSSS------|||||||--------%%%%%%-S---S--U--S-----SSS----------------------------------------------------------S--------------------------C-----------------------------
-SCS--------DDDDDDD-----------%%%-----------|||||||--------||||||-------------------------K-------------------------------------------------------------------------------------------------------------
------------------------------|||--------S2SS||2SS|--SS---SS|||||-S------------------------------------------------------------C------------------------------------------------------------------------
------G#-DDDDDDDDDDD----------||SSSSSSS------||---|---------|||||--------------%%%%%%%%%---%%2SS-------------------------------------------2---SS---------------------------------------#---------------
SSSSS--#-----------------U----SCS------------||---|-tt---tt-|||||------%%%%%%%%|||||||||---||-----------------------------------------------------%%%%--------tt--------%%%%------------#---------------
-------#--------r-k--------------------------||---|-Tt---tt-|#||#------|||||||||||||||||---||S-----------------------------------g----------------||||---tt---tt---tt---||||------------#---------------
------------D--%%%%------r-------g---------%%%D--DDD%%DDDDDDDD||DDD---D|||||||||||||||S|---||------------tt---tt--#------------%%%%---------g-----||||---Tt---tt---Tt---||||------%%---%%%%%------------
%%%%-----------||||-----%%%---%%%%%%%%%%%%%|||------||--------||-------|||||D|||||||||-|---||---%%%%%----tt---Tt--#--tt---tt---||||--------S---C%%||||%%%%%%%%%%%%%%%%%%||||%%%---||---|||||------------
||||%%---------||||-----|||---||||||||||||||||------||--------||-------|||||DK|%%%%%%|r|---||---|||||----tt---tt--#--tt---Tt---||||-----%%%%----|||||||||||||||||||||||||||||||---||---|||||---%%F%%%%%%
||||||--%%--%%%||||%%---|||---||||||||||||||||----#-|#------%%%%%%-----|#|||--|||||||%%%---%%%%%|||||%%%%%%%%%%%%%%%%%%%%%%%%%%||||%%---||||----|||||||||||||||||||||||||||||||---||---|||||---||%||||||
||||||--||--|||||||||---|||---||||||||||XXXXXX--XXX-|XXXXXXX||||||X----|XXXXXXX|||||||||---||||||||||||||||||||||||||||||||||||||||||---||||----|||||||||||||||||||||||||||||||---||---|||||---|||||||||
