--------------------------------------------------------------------------------------------------------------------------------------------------------------------------------------------------------
--------------------------------------------------------------------------------------------------------------------------------------------------------------------------------------------------------
------------------------------------------------------------------------------------------------------------------------------------C-------------------------------------------------------------------
--------C---------C------------------------------------------------------------------------------------------C------------------------------------------------------------------------------------------
-----------------------------------S------------------C----SSS--------------SS----------%%%%------------------------SSS--------tt-----------------------------------------------------------------------
---------------------------%%%----------SSS-------------SSS---------tt--#------U--------||||-%%%%--------tt--------------------Tt----#------------------------------------------------------------------
-----------y--------y--g---|||------------------%%%%%---------------Tt--#--tt-----%%%%%%||||-||||--------tt---------D----------tt---###-----------------------------------------------------------------
------D-%%%%%%%%%%%%%%%%%%%|||--------------g---|||||---------------tt--#--Tt-----||||||||||-||||%%---%%%%%%%%%%%------------%%%%%%%%%%%%-----------------------------------D-----UC--------------------
--------||||||||||||||||||||||---%%%---%%%%%%%%%|||||DDDDDDDDDD---%%%%%%%%%%%%%%%%||||||||||-||||||---|||||||||||---%%%%%%---||||||||||||---------------------------------------------------------------
-S2SS---||||||||k|||||||||||||---|||---||||||||||||||-------------||||||||||||||||||||||||||%||||||---|||||||||||---||||||---||||||||||||------------------------------g--------------------------------
--------|||||%||%|||||||||||||---|||---||||||||||||||------g------|||||||||||||||||||||||||||||||||---||||||||SSS---||||||---||||||||||||----S---SSS---D---tt--------%%%%------D-----%%%----------------
--------||||||||||||||||||D|||---%%%---||||||||||S||tt---%%%%-----||||||||||||||C||tt||||||||||||||---||||||||------||||||---|||||||||SS2------------------tt---tt---||||---tt---%%%%%%|----------------
%%%%----||||||k|||||||||||-|||---|||---||||||||||-||Tt---||||-----||||||||||||||-||tt||||||||||||||---||||||||----g-||||||---|||||||||-----------g---g-----tt---Tt---||||---Tt---|||||||----------------
||||%%%%||||||||||||||||||%%%%---|||---||%%%%%%||r||tt---|k||k----%%||DDDD%|||||-||tt||#||#||||||||---||%%||%%%%%---%%%%%%---|||||||||------DD---%%%---%%%%%%%%%%%%%%||||%%%%%%%%|||||||%%%%%---%F%%%%%%
||||||||||||||||||||||||||||||---|||---%%||||||%%%%%%%%%%||||%%---||%|----||%%%%%%%%%%%%||%%%||||%%---%%|||||||||---||||||---|||||||SSSSS--------|||---||||||||||||||||||||||||||||||||||||||---|%||||||
||||||||||||||||||||||||||||||---|||---||||||||||||||||||||||||---||||----|||||||||||||||||||||||||---|||||||||||---||||||---|||||||-------------|||---||||||||||||||||||||||||||||||||||||||---||||||||
