--------------------------------------------------------------------------------------------------------------------------------------------------------------------------------------------------------
--------------------------------------------------------------------------------------------------------------------------------------------------------------------------------------------------------
--------------------------------------------------------------------------------------------------------------------------------------------------------------------------------------------------------
-----------#--------------------------------------------------------------------------------------------------------------------------------------------------------------------------------------------
-----------#-----------------------BBBC--------------------------D--------------------------------------------------------------------------------------------------------------------------------------
--g--------#----------------------------------B2BB------------------------------------------------------------------------------------------------------------------------------------------------------
-BB2B------#---------------------------------------------------------------------------------U----------------------------------------------------------------------------------------------------------
------DDDDDDDD--DDD-------------B2BBBBB-----k------------DDDDDD--DDD--%%------DDD-----%%%---------------------------------------------------------------------------------------------------------------
-----------D-----------------------------%%%%-------------------------||-------C------|||----r--g-------------------------------------------------------------------------------------------------------
BBBBB------D------------U---BB-----------||||---%%%%------------------||--------------------DDD%%BC-------r------------------------------------------C--------------------------------------------------
---------D----------tt----------tt-------|k||---||||-%%%%%%-D---tt-------------------B-BB------||--------%%%%---tt--BBC---------------%%%%---tt---tt--#-------------------------------------------------
--------------------Tt-----tt---tt---%%%%||||%%%||||-||||||-----Tt---tt----------r-------------||---tt---||||---Tt----------tt---tt---||||---tt---Tt--#-----------------C-C-----------------------------
%%%%----------------tt-----tt---tt---|||||||||||||||-||||||-----tt---Tt-------%%%----r-----g--#||#--Tt---||||---tt------g---tt---tt---||||---tt---tt--#---%%%-----%%%%----------------------------------
||||%%--%%%%%%%--%%%%%%%%%%%%%%%%%%%%|||||||||||||||-||||||%%%%%%%%%%%%%%%%---|||---%%%%%---%%%||%%%%%%%%||||%%%%%%%%%%---%%%%%%%%%%%%||||%%%%%%%%%%%%%---|||-----||||----------------------%%%%%F%%%%%%
||||||--|||||||--|||||||||||||||||||||||||||||||||||%||||||||||||||||||||||---|||---|||||---|||||||||||||||||||||||||||---|||||||||||||||||||||||||||||---|||-----||||----------g------g----|||||X||||||
||||||--|||||||--||||||||||||||||||||||||||||||||||||||||||||||||||||||||||---|||---|||||---|||||||||||||||||||||||||||---|||||||||||||||||||||||||||||---|||---%%||||%%%%%%---%%%%---%%%---|||||X||||||
