--------------------------------------------------------------------------------------------------------------------------------------------------------------------------------------------------------
--------------------------------------------------------------------------------------------------------------------------------------------------------------------------------------------------------
--------------------------------------------------------------------------------------------------------------------------------------------------------------------------------------------------------
--------------------------------------------------------------------------------------------------------------------------------------------------------------------------------------------------------
--------------------------------------------------------------------------------------------------------------------------------------------------------------------------------------------------------
--------------BBBB----tt---------------------------------------------------------------------------------------------------------C--------------------B---------------BBB-----tt--BBB-----tt------------
----------------------Tt-----------------------------------------------------------------------------------------------------------C------------------------------------------tt----------tt------------
--------------g---g---tt-------------------------------------------------------C----DDDDDDD-------------------------r-k--U--C---------%%------------------g---------------g---tt------g---tt------------
--g---G#-D%%%BBBC%%%%%%%%%%-------B-C------------------------------tt-----------BBB----------------------rg--------%%%%----C----------||---%%%%%--%%%%%---%%---%%%--%%%%%%%%%%%%%%%%%---%%%%%%%%%%%-----
---BB--#--|||----||||||||||-------------------------C-#------------tt-------tt----------tt-----D---D----%%%%-------||||---------%%%%%%||---|||||--|||||---||---|||--|||||||||||||||||---|||||||||||-----
-------#--|||-U-------------C----------tt---tt--------#--%%%%%%----tt-------tt------g---tt---------D----||||-------||||----r----||||||||---|||||--|||||---||---|||--|||||||||||||||||---|||||||||||-----
----------|||-----------------C--------Tt---tt------r-#--||||||%%%%%%%%%%%%%%%%%%%%%%%%%%%%%%%%%--------||||---%%%%||||%%%%%%---||||||||---|||||--|||||---||---|||--|||||||||||||||||---||||------------
%%%%------|||---------%%%%%-------%%%%%%%%%%%%%%%%%%%%%%%|||||||||||||||||||||||||||||||||||||||---%%%%%||||%%%||||||||||||||---||||||||---|||||--|||||---||---|||--|||||||||||||||||---||||------------
||||%%---#|||---------|||||-r-r---||||||||||||||||||||||||||||||||||||||||||||||||||||||||||||||---||||||||||||||||||||||||||---||||||||---|||||--|||||---||---|||--|||||||||||||||||---||||%%%%%F%%%%%%
||||||--%%|||%%%%--%%%|||||%%%%---|||-||||||||||||||||||||||||||||||||||||||||||||||||||||||||||---||||||||||||||||||||||||||---||||||||---|||------------------------------------------|||||||||X||||||
||||||--|||||||||--||||||||||||---|||-||||||||||||||||||||||||||||||||||||||||||||||||||||||||||---||||||||||||||||||||||||||---|||-----------------------------------------------------|||||||||X||||||
