--------------------------------------------------------------------------------------------------------------------------------------------------------------------------------------------------------
--------------------------------------------------------------------------------------------------------------------------------------------------------------------------------------------------------
--------------------------------------------------------------------------------------------------------------------------------------------------------------------------------------------------------
-----------------------B----------U-B-------------------------------------------------------------------------------------------------------------------------------------------------------------------
----------------BB--D---------------------------BB2B-------y--g---------------------------2BB------------------------------------------------------------------------g----------------------------------
------------------------------tt---------%%--DD------%%%%%%%%%%%%----------------------------------------------------U------------------%%%%-----------------tt--BB---2-----------#--tt---%%%%----------
-BB-----------------g---------Tt---------||----------||||||||||||----------------------k-------------------------------BB2--------------||||---tt------------Tt----------tt-------#--tt---||||----------
------D-BB2BBDDDDD%%%%%%%---%%%%%%%%%%---||----BBBB-B||||||||||||---------tt---tt---%%%%--------BB--------------------------------------||||---Tt------------tt----------tt-------#--tt---||||----------
------------------|||||||---||||||||||---||----------|||||||||||DDDDDDD---tt---tt---||||---%%%%%%--------------------------g--------%%%%||||%%%%%%%---%%--%%%%%%%%%---%%%%%%%%--%%%%%%%%%%||||%%%%%%%---
BBBBB-----------------------||||||||||---||----------|||||||||||X---------tt---tt---|k||k--||||||---tt---%%%%%----%%%%%%%%---%%--%%%|||||||||||||||---||--|||||||||---||||||||--|||||||||||||||||||||---
---------D-------------D----#-||---------------------|||g||||g||X----DDDDD%%%%%%%%%%||||%%%||||||---Tt---|||||----||||||||---||--||||||||||||||||||---||--|||||||||---||||||||--|||||||||||||||||||||---
-------------%%%%%%DD-------#-||----------%%--%%%%%%%|||X||||X||XBBB------|||||||||||||||||||||||%%%%%%%%|||||%%%%||||||||---||--||||||||||||||||||---||--|||||||||---||||||||--||||||||||||||----------
%%%%---------||||||---------#--|%%%%%-r---||--||||||||||X||||X||X---------||||||||||||||||||||||||||||||||||||||||||||||||---||--||||||||||||||||||---||--|||||||||---||||||||--||||||||||||||----------
||||%%--%%%%%||||||%%%%%%---%%%||||||%---%||--||||||||||X||||X||X---------||||||||||||||||||||||||||||||||||||||||||||||||---||--||||||||||||||||||---||--|||||||||---||||||||--||||||||||||||%%%F%%%%%%
||||||--|||||||||||||||||---||||||||||---|||--||||||||||X||||X||XBBBCB----||||||||||||||||||||---|||||||||||||||||||||||||---||--||||||-||||---------------------------------------------||||||||X||||||
||||||--|||||||||||||||||---||||||||||---|||--||||||||||X||||X||X----------|||||||||||||||||||---|||||||||||||||||||||||||--------------||||---------------------------------------------||||||||X||||||
