--------------------------------------------------------------------------------------------------------------------------------------------------------------------------------------------------------
--------------------------------------------------------------------------------------------------------------------------------------------------------------------------------------------------------
--C-----------------------------------------------------------------------------------------------------------------------------------------------------------------------------------------------------
--------------------------------#--------------#--#------B-#--------------------------------------------------------------------------------------------------------------------------------------------
--------------------------------%%%---DD-----%%%--%%%%%%---#--------------------------------------------------------------------------------------------------------------------------------------------
C------------------------B------|||BB-D-B2BB-|||--||||||-r-#-------------------------------D------------------------------------------------------------------------------------------------------------
-BBBB------------r--------------|||---D------|||--||||||DDDDDD-D---D-----------------------D-------G#-----------g---------------------------------------------------------------------------------------
------D%%%%----D---D---------G#-------D--------------B-----D----------------B----------g-------g----#-----------B2BB------------------------------------------------------------------------------------
-------||||BBB-D---D-B---BB---#-------------BBBB-----------D----C--------------%%%%--BBB-----%%%%-D-#----------------C----------------------------------------------------------------------------------
BBBBB----------D---D----------#--DD---DDDDDDD------------------B--D---D-C------||||----------||||---------BB--------------------------------------------------------------------------------------------
---------D---BBC----------------------------------%%%%%------------------------||||----------||||------C--------BB-----------B--tt--BBB-----tt---tt---------------BBBB---------%%%%---------------------
--------------------------------B---BB-B-B--------|||||--------r--------r---%%%||||%%%%%---%%||||%%--D--------------------------tt----------tt---Tt-------%%%%%-----------tt---||||---%%%%--------------
%%%%--------------------------D----------------%%%|||||%%%%--%%%%%%%--%%%---||||||||||||---||||||||-----------------%%%%%%------tt------g---tt---tt-------|||||-------g---tt---||||---||||--------------
||||%%%%%%%%%%%%---%%----%%---D----tt------BBB-||||||||||||--|||||||--|||---||||||||||||---||||||---------%%%-------||||||---%%%%%%%%%%%%%%%%%%%%%%%%%%%%%|||||%%%%%%%%%%%%%%%%||||%%%||||---%%%%F%%%%%%
||||||||||||||||---||----||--------Tt-------------|||||||||--|||||||--|||---|||||||----------||||%%--%%%%%|||---%%%%|||------|||||||||||||||||||||||||||||||||||||||||||||||||||||||||||||---||||X||||||
||||||||||||||||---||----||---%%%%%%%%%%%%%%%%%---|||||||||--|||||||--|||---|||||||-B2BB---BB||||||--||||||||---|||||||------|||||||||||||||||||||||||||||||||||||||||||||||||||||||||||||---||||X||||||
