--------------------------------------------------------------------------------------------------------------------------------------------------------------------------------------------------------
--------------------------------------------------------------------------------------------------------------------------------------------------------------------------------------------------------
--------------------------------------------------------------------------------------------------------------------------------------------------------------------------------------------------------
-----------------------------------------------S------S-------#-----------------------------------------------------------------------------------------------------------------------------------------
--------------------------------------#------S----tt----------#-----------------------------------------------------G#----------------------------------------------------------------------------------
-----------------------%%%------------#--tt-------Tt----------#K-------------SS2SS----DDDDDD----------------------g--#--SS---SS----SSS--------SS-------------%%%%---tt----------------------------------
--S2---------------g---|||------------#--Tt--r----tt-----#----#-------------------------------------------------%%%%-#----------SSC---------------------tt---||||---Tt---tt-----------%%%%%-------------
------D-SSC2SC2SS%%%%%%|||---%%---%%%%%%%%%%%%%DDDD%%%%%%%---%%%SS2S--------------------#----U-----DDDDD--------||||---tt---tt-----------------g--------Tt---||||---tt---tt-----------|||||-------------
-----------------|||||||||---||---|||||||||||||----|||||||---|||------------SSSSS-------#--S-----------tt-------||||---Tt---tt------g----%%---%%%%%--%%%%%%%%||||%%%%%%%%%%%%%%%%---%%|||||-------------
SSSSS------S2SS--|||||||||---||---|||||||||||||----|||||||---|||----S--------------%%%%-#--------------tt---%%%%||||%%%%%%D%%%%%%%%%%%---||---|||||--||||||||||||||||||||||||||||---|||||||%---%%%%-----
---------D------S|||||||||---|S---|||||||||||||----|||||||---|||-------------------||||------------g---tt---||||||||||||||-|||||||||||---||---|||||--||||||||||||||||||||||||||||---||||||||---||||-----
-----------------|||||||||---|----|||tt|||tt|||%%%%%|C||||---|||----r----%%%%%%----||||---%%%%%---%%%%%%%%%%||||||||||||||-|||||||||||---||---|||||--|S||||||||||||||||||||||||||---||||||||---||||-----
%%%%-------------|||||||||---|r---|||Tt|||Tt|||||||||-||%%---|%%%%%%%---%||||||%%%%||||%%%|||||---||||||||||||||||||||tt||-||||||tt|||---||---||tt|--|-||||||||||||||||||||||||||---||||||||---||||-----
||||%%--%%%%%%%%%||||||%%%---%%---%%%%%%%%%%%%%||||||r||||---||||||||---|||||||||||||||||||||||---||||||||||||||||||||tt||-|#||||tt|||---||---||tt|--|-||||||||||||||||||||||||||---||||||||---%%F%%%%%%
||||||--||||||||||||||||||---||---||||||||||||||||||%%%%||---%|||||||---|||||||||||||||||||||||---||||||||||||||||||||tt||-###|||tt|||---%%---||tt|--%%%%%%||||||||||||||||||||||---||||||||---||%||||||
||||||--||||||||||||||||||---||---||||||||||||||||||||||||---||||||||---|||||||||||||||||||||||---||||||||||||||||||XXXXXXXXXXXXXXXXXX---||---XXXXXXX||||||||||||||||||||||||||||---||||||||---|||||||||
