--------------------------------------------------------------------------------------------------------------------------------------------------------------------------------------------------------
--------------------------------------------------------------------------------------------------------------------------------------------------------------------------------------------------------
------------------------------------------------------------------------------------------------------------------------------------------------------------------------------------#-------------------
----------------------------#--------------------------------------#--#-------#--#--------------------------------------------------------------------------------------------------#-------------------
-------------------DDDDDD---%%%------------------------------DDDDDDD--DDD---%%%--%%%%%%%----------------------------------------------------------------------------------DDD---DD--#----%%%------------
----------------------------|||----------g--------#-------------------------|||--|||||||---------------------------------------------------------------------SCSSSSSS---C---SSS-D-%%%%---|||------------
--------------------D-------|||-2SS----SSS2S------#------D-----D------------|||--|||||||----------------------------------------------------------------------------------------D-||||---|||------------
------D---------------------|||-------------------#K------------------------|||--|||||||--------SSCD----------------------------------------------------------------------------D-||||---|||------------
----------------------------|||------------g------#-------------------------|||--|||||||------------------------SSS----------------------------------------SSSSSSSS2--------------||||---|||------------
--2SS-------U----------D---r|||-----%%%%DDDDD---DDDDDDD---DDDDDDDDD--DDDD---%%%--%%%||||----------------U-------------S2S----tt--S--tt---%%%%---------------------------DDDDD---DD||||---|||------------
---------D------------------%%%%--%%||||--------------SSS-------------------|||--|||||S2SS-S--------r------------------------tt-----tt---||||---%%%%------------------------------||||---|||------------
----------------------------||||--||||||----------------------SS------S-----|||--|||||------------%%--------%%%%%%-------g---tt--r--tt---|k||---||||-%%%%-------------------g-----||||---|||------------
%%%%-------------%%%%--%%---||||--|#||||-------------S------------tt----S---|||--|||||------------||--------||||||%---%%%%%%%%%%%%%%%%%%%||||%%%||||-||||----SSS2SS-------%%%%--SSS|||---|||------------
||||%%--%%%%%%---||||%%||---D||tt-|#||||--------%%%%----tt--------Tt--------|||-tt|||tt----r--%%%%||---%%%%%|||||||---||||||||||||||||||||||||||||||-||||#----------------||||-----|||---%%%---%%F%%%%%%
||||||--||||||---||||||||----||tt-|#||||--------||||-r--tt--------tt--------g||-tt|||tt---%%%%%%||||---||||||||||||---||||||||||||||||||||||||||||||-||||##------g--------||||-----|g|---|||---||%||||||
||||||--||||||---||||||||---XXXXXXXXXX||XXXXX---||||XXXXXXXXX--XXXXXXXXXX---XXXXXXXXXXXXXX||||||||||---||||||||||||---||||||||||||||||||||||||||||||X||||XXXXXXXXXXXX---XX||||XXXXXXXX---|||---|||||||||
