--------------------------------------------------------------------------------------------------------------------------------------------------------------------------------------------------------
--------------------------------------------------------------------------------------------------------------------------------------------------------------------------------------------------------
--------------------------------------------------------------------------------------------------------------------------------------------------------------------------------------------------------
-----------------------------------------------------------------------------------------------------------------------------------------------------------------------------------------g--------------
---------------------------------------------------------------------------------------------------------------------------------------------------------------------------------------BBB2-------------
--------------------------------------------------------------------------------------------------------------------------------------------------------------------------------------------------------
----------g---------------------------C----------------------------------------------------------------------------------------------------------------------------------------------------g------------
------D-BBB2B-------------------------------------------------------------------------------------------------D---------------------------------------------------------------------%%%%%%%%%%%%%%%-----
------------------------------------------------------------------------------------------------------------------------------------------------------------------------------------|||||||||||||||-----
BBBBB------------------------k-----------k------%%%%---------------------------------------------------------------------------------------------------------C-C------g----------%%%|||||||||||||||-----
---------D---tt--C--------%%%%--------%%%%--BBB-||||-----------------------------------C-------------------------D-------------%%%%--U----D--tt-D---tt-D-------------BB---BCB2BB-||||||||||||||||||-----
-------------tt-----------||||--------||||-------------%%---------tt-----%%%--------------------------C--------------tt---tt---||||----------tt-----Tt---tt-----%%%%%%D----------||||||||||||||||||-----
%%%%---------tt--r--------|k||k-------|k||k-----g------||---------Tt-----|||----------------------tt-----------------tt---tt---||||----------tt-----tt---tt-----||||||-----------|||||||||--------------
||||%%-%%%%%%%%%%%%%%%%%%%||||%%%--%%%||||%%%%%%%%%%---||%%%%--%%%%%%%---|||------%%--------------Tt----------%%%%%%%%%%%%%%%%%||||%%%%%--%%%%%%%%%%%%%%%%%%%%%%||||||-----------|||||||||--%%%%%F%%%%%%
||||||-||||||||||||||||||||||||||--|||||||||||||||||---||||||--|||||||---|||%%%---||---%%%%%%%%%%%%%%%%%%%%---||||||||||||||||||||||||||--||||||||||||||||||||||||||||-----------|||||||||--|||||X||||||
||||||-||||||||||||||||||||||||||--|||||||||||||||||---||||||--|||||||---||||||---||---||||||||||||||||||||---||||||||||||||||||||||||||--||||||||||||||||||||||||||||----------------------|||||X||||||
