--------------------------------------------------------------------------------------------------------------------------------------------------------------------------------------------------------
--------------------------------------------------------------------------------------------------------------------------------------------------------------------------------------------------------
------------------------------------------------------------------------#-------------------------------------------------------------------------------------------------------------------------------
--------------------------------------------------------------------#---#---------------#--#----------#------------------------#------------------------------#-------------#---------------------------
----SSSSSSSS-------SS-----------#------------------------%%%%------###--#--%%%%---DDDDDDD--DDD---DD---%%%--------DDD---------DDD----SS%%----------------------#-------------#---------------------------
--g-------------D---------------#---------------------%%%||||---%%%%%%%%%%%||||--r-----------S--------|||-----G----SSS----SS-D--------||----------------------#-------------#---------------------------
2SS2S---------------------------#----------D-----S2SS-|||||||---|||||||||||||||---DD------------------|||---S----------------D--------||----SSSSS-S---------%%%%%-----g---%%%%%-------------------------
--------------------------------#---S2SS--------------|||||||---|||||||||||||||-----------------------|||--------------------D--------||%%%%%-------------S-|||||----SSS--|||||-----------#-------------
------G#-D%%%%--%%%%%%%---DDDDDDDDD----------2SS---SS-S|||||S---D||||||||||||||------SSS--------------|||---------------------------DD|||||||--------S-C----|||||---------|||||----g---#--#-------------
SSSSS--#--||||--|||||||---------D----------------------|||||----D|||||||||S|S||--------DDDDDDD---DD---DD%%%------%%DD--------DD2S-----|||||||-----------tt--|||||------tt-||tt|D-%%%%--#--#-------------
-------#-S||||--|||||||-----r-k-D----SS-----------tt---|||||-----|||SSS|||-|-||---%%%%------------------|||DDD---||-------------------|||S|||---%%%%----Tt--|tt||-tt---tt-||Tt|--||||--#----------------
----------||D|--|D|SSC|--D-%%%%-DU----------------tt---||%%%%----|||---|||-|-||---||||------------2---S-|||------||2SS----------------|||-|||---||||----tt--|Tt||-Tt---tt-||tt|--||||--#----------------
%%%%------||-|--|-|---|----||||-D---tt-----%%--%%%%%%%%%%||||----|tt---|||-|-||---||||%%%%%-*----S------|||------||-------S-----------|||-|SS%%%||||%%%%%%%%%%%%%%%%%%%%%%%%%%%%%||||%%%%%%%------------
||||%%----||-|--|-|---|g---||||k-r--tt-----||--||||||||||||||--r-|Tt---||%%%%%%---|||||||||-*-----------|tt------||----------tt-----%%|||-|--|||||||||||||||||||||||||||||||||||||||||||||||---%%F%%%%%%
||||||--%%%%%%%-|%%%%%%%%%%||||%%%%%%%%%---||%%||||||||||||||---%%%%%%%%%||||||---|||||||||-*-----g-----|Tt--#---||----------tt-----||||%%%%%|||||||||||||||||||||||||||||||||||||||||||||||---||%||||||
||||||--|||||||-||||||||||||||||||||||||---||||||||||||||||||---|||||||||||||||---|||||||||XXX---XX---XXXXXXXX---XX--XX---XXXXXXX---||||||||||||||||||||||||||||||||||||||||||||||||||||||||---|||||||||
