--------------------------------------------------------------------------------------------------------------------------------------------------------------------------------------------------------
--------------------------------------------------------------------------------------------------------------------------------------------------------------------------------------------------------
--------------------------------------------------------------------------------------------------------------------------------------------------------------------------------------------------------
--------------------------------------------------------------------------------------------------------------------------------------------------------------------------------------------------------
---------------------------------------------------------------------------------------g----------------------------------------------------------------------------------------------------------------
--------------------------------------------------------------------------%%-----BB2B---2BBBB--D--------------------------------------------------------------------------------------------------------
-BB---------g-----------------------------------------------%%%-----D-BBB-||-BBC-------------------r--------%%%%----g--g--g-----------------------------------------------------------------------------
------D--BCBB2---------------------------------B----------B-|||-----------||-----BB-----------g------%%%----||||-%%%%%%%%%%%%%--------------------------------------------------------------------------
------------------------------------------#-----------------|||--r-k------||B-#---------DDD%%%%%%%---|||%%%%||||-|||||||||||||-----tt--BBCB-------------------------------------------------------------
BBBBB-------------------B-----BBBBB---r-k-#---------------------%%%%---D--||--#---BBB------|||||||---|||||||||||-|||||||||||||tt---tt----------%%%%----y---C-------C------------------------------------
---------D--B------------------------%%%%-#---------------------||||--------r-#-------------------------||||||||-|||||||||||||tt---tt------g---||||-%%%%%%----------------------------------------------
-------------------------------------||||------%%---BB2---------||||-----%%%%%%%%%%%%----------------D--||||||||%|||||||||||||%%%%%%%%%%%%%---%||||-||||||----------------------C------#----------------
%%%%--------------------------%%%----||||------||-----------%%%%||||%%%%%||||||||||||-----%%%------------------||||||||||||||||||||||||||||---|||||-||||||------------------%%%%---tt--#----------------
||||%%--%%%%%%---%%%---%%%%---|||%%%%||||%%%---||-------g---|||||||||||||||||||||||||-----|||--------%%%%%%%---||||||||||||||||||||||||||||---|||||-||||||%%------tt---tt---||||---tt--#--%%%%%%%F%%%%%%
||||||--||||||---|||---||||---||||||||||||||---||%%%%%%---%%|||||||||||||||||||||||||-----|||%%%%%---|||||||---||||||||||||||||||||||||||||---|||||%||||||||------Tt---tt---||||---tt--#--|||||||X||||||
||||||--||||||---|||---||||---||||||||||||||---||||||||---|||||||||||||||||||||||||||-----||||||||---|||||||---||||||||||||||||||||||||||||---||||||||||||||%---%%%%%%%%%%%%||||%%%%%%%%%%|||||||X||||||
