--------------------------------------------------------------------------------------------------------------------------------------------------------------------------------------------------------
--------------------------------------------------------------------------------------------------------------------------------------------------------------------------------------------------------
------------------#-------------------------------------------------------------------------------------------------------------------------------------------------------------------------------------
------------------#--------------C-B-----C-B---------------------------#----------#---------------------------------------------------------------------------------------------------------------------
------------------#K-----------------------------------------U-------%%%----D-----D---------------------------------------------------------------------------------------------------------------------
------------------#--#-----%%%----------------C---r------------BBB---|||----BBB---------------B#BBB-----------------------------------------------------------------------------------------------------
------------%%%%%%%%%%---%%|||----------%%%%%----%%%%--B-#-----------|||-----------------B-B------------------------------------------------------------------------------------------------------------
------D-BBB-||||||||||---|||||---DDD---%|||||----||||----#--%%%%----------------------------------------------------------------------------------------------------------------------------------------
------------|||||||||------------------||||||----||||k---#--||||-----G#-----------------------tt--------------------------------------------------------------------------------------------------------
-B2BB-------U---BB---------------------||||||%%%%||||DDDDDDD||||B2----#-----D-----D#B---------Tt------%%%DD--------G#-----------------------------------------------------------------------------------
---------D-----------------------------||||||||||||||----D--||||------#-----------------DDDDDD%%DDD---|||-----------#-----------------------------------------------------------------------------------
---------------tt----------------%%%-------------||||----D--||||--------------B---------------||--------tt---%%%%---#-----------------------------------------------------------------------------------
%%%%-----------tt---%%----DD-----|||-------------||||%%-C--B||||------------------------------||--------Tt---||||---------------------------------------------------------------------------------------
||||%%--%%%%%%%%%%%%||-----------|||---DDDDDDDD2B||||||---------DD---DDDD-----------D---%%---#||#-------tt---||||-------------------------------------------------------------------------%%%%%%%F%%%%%%
||||||--||||||||||||||------------g--------------||||||-r--r----------------------------||%%%%--%%%---%%%%%%%||||%%--------g--------g--g-----g--g-----------------g-----------------g-----|||||||X||||||
||||||--||||||||||||||---%%%%%---BB2---------BBBB||||||%%%%%%BCB-------2B---B%%---%%%---||||||--|||---|||||||||||||-BB#BB%%%%%%%%%%%%%%%%%%%%%%%%%%%%%%%%%%%%%%%%%%%%%%%%%%%%%%%%%%%%%%%%%%||||||X||||||
