--------------------------------------------------------------------------------------------------------------------------------------------------------------------------------------------------------
--------------------------------------------------------------------------------------------------------------------------------------------------------------------------------------------------------
--------------------------------------------------------------------------------------------------------------------------------------------------------------------------------------------------------
------------------------------------------------------------------------------#-------------------------------------#--#-------#--#---------------------------------------------------------------------
-----------------------------%%%------------------------------------------D---#----------------D-------------g----DDD--DDD---%%%--%%%%%%%---------------------------------------------------------------
---------------------S2SSSSS%|||---DDD----------------------------------------#-----------------------------SS2SS------------|||--|||||||---------------------------------------------------------------
----------------------------||||---D---------G#-----------SSSCS---------------#----------------------------------------------|||--|||||||---------------------------------------------------------------
------D---------------------||||---D----------#--------------%%%%%%--DDDDDDDDDDDD------%%%%%%--%%%----------------g----------|||--|||||||------------------------------g--------------------------------
---------------------G#--S--|SS|-------%%%%-D-#--------------||||||-----------D--------||||||--|||--SSSSS---SSSSSSS2SS-------|||--|||||||---------------------SS2----S----------------------------------
--2SS-------SS2S------#-----|--|-------||||-------------2SSSSS|S|||------g----D--------||C|||--|||-----------------DDDDDDD---|||--DDDDDDD------------------------------------tt-----%%%-----------------
---------D---------U--------tt-|-------|k||k-----S------------|-|||----%%%%---tt-D-%%%%||-|||--|||-tt---------------S--------|||-------S------------SS------------g----------tt-----|||-----------------
-------------%%%------------tt-|---%%%%||||%%--D--------------|-||tt---||||---tt---||||||-|||--|||-Tt------------------S-----|||---------------------------%%%%%%%%%%%---%%%%%%%%---|||-----------------
%%%%---------|||---r--%%%%D%%%%%---||||||||||---------%%%%%%--|-||Tt---||||---tt---||||||-|||--|||-tt-------D-U-----------tt-D|%%%%--------------------g---|||||||||||---||||||||---|||%%%%%------------
||||%%--%%%%%|||---%%%||||-|||||---||||||||||------r--||||||%%%%%%%%%%%||||%%%%%%%%||||%%%%%%%-|%%%%%%%%%---D----%%%%%----tt--|||||-------------D---%%%%%%%|||||||||||---||||||||---||||||||%%%%%F%%%%%%
||||||--||||||||---|||||||-|||||---|||||||DDD%%%%%%---||||||||||||||||||||||||||||||||||||||||-||||||||||--------|||||----tt--|||||---%%%-----------||||||||||||||||||---||||||||---|||||||||||||%||||||
||||||--||||||||---|||||||-|||S2---SSSS||||--||||||---||||||||||||||||||||||||||||||||||||||||-||||||||||---XXXXX|||||XXXXXXXXX||||XXX|||---XXXXX---||||||||||||||||||---||||||||---||||||||||||||||||||
