--------------------------------------------------------------------------------------------------------------------------------------------------------------------------------------------------------
--------------------------------------------------------------------------------------------------------------------------------------------------------------------------------------------------------
-----------------------------------------------------------------------------#---------------#--------------------------------------------------------#-------------------------------------------------
-----------------------------------------------------------------------------#---------------#--------------------------------------------------------#-------------------------------------------------
--------------U--------------------------------------------------------------#---------------#------------------------------------------------%%%-----#-------------------------------------------------
---------------------------D---------------------%%%%%%------------------DDDDDDD------DDDDDD%%%%-------DD---DD----------------------%%%%%%----|||-----#-------C-----------------------------------------
-BB---------g------------------------------------||||||---------------#------D--------------||||------------------B2B---------------||||||%%%%|||---%%%---B---------------------------------------------
------D--B2BB2%%%-BBBBBB-----------r-k----------B-------------------k-#----------C-B-C---C---------------------------------------DDD|||||||||||||---|||-------------------------------------------------
--------------|||------------tt---%%%%------------*------BB------%%%%-#-tt-----------------------%%%%----------C-C------------B-----|||||||||||||---|||------------------C------------------------------
BBBBB---------|||------------Tt---||||---tt---tt--*--tt----------||||---Tt---tt-------------tt---||||-------------------------------------------#------------%%%%---------------tt----------------------
---------D----------------r--tt---||||---tt---tt--*--tt------g---|k||k--tt---tt-------------Tt---||||-------%%----------%%-------g---%%%%%%----##----%%---DD%||||-----tt---tt---Tt----------------------
-------------tt--------D---%%%%%%%||||%%%%%%%%%%%%%%%%%%%%%---%%%||||%%%%%%%%%%%%%%%%%%%%%%%%%%%%||||%%%%---||%%%%%%%---||%---%%%%%%%||||||%%%%%%---%||-----|||||-----tt---Tt---tt---%%%----------------
%%%%---------Tt------------||||||||||||||||||||||||||||||||---|||||||||||||||||||||||||||||||||||||||||||---|||||||||---|||---|||||||||||||||||||---|||-----|||||---%%%%%%%%%%%%%%%%%|||----------------
||||%%--%%%%%%%%%%--%%%%---||||||||||||||||||||||||||||||||---|||||||||||||||||||||||||||||||||||||||||||---|||||||||---|||---|||||||||||||||||||---|||-----|||||---||||||||||||||||||||---%%%%%%F%%%%%%
||||||--||||||||||--||||---||||||||||||||||||||||||||||||||---|||||||||||||||||||||||||||||||||||||||||||---|||||||||---|||---|||||||||||||||||||---|||-----|||||---||||||||||||||||||||---||||||X||||||
||||||--||||||||||--||||---||||||||||||||||||||||||||||||||---|||||||||||||||||||||||||||||||||||||||||||---|||||||||---|||---|||||||||||||||||||---|||-----|||||---||||||||||||||||||||---||||||X||||||
