--------------------------------------------------------------------------------------------------------------------------------------------------------------------------------------------------------
--------------------------------------------------------------------------------------------------------------------------------------------------------------------------------------------------------
--------------------------------------------------------------------------------------------------------------------------------------------------------------------------------------------------------
-----------------------------------------------------------------------------C--------------------C-----------------------------------------------------------------------------------------------------
-----------------------------------------------y--y-------r---------------tt--BBBBCB---------------------------------g----------BB----------------------------------------------------------------------
------------------------DDDDDD----%%%%%------%%%%%%%%-*--%%%%-------------tt--------------------tt-----%%%---------%%%%--D--BB2B----BCB2BBB2B-----------------------------------------------------------
----------------------------------|||||---U--||||||||-*--||||-------------tt------g-------------tt-----|||---------||||-------------------#-----------------------D-------------------------------------
------D--------------------gk----rg||||------||||||||-*--||||-----------DD%%%%%%%%%%%%%%%%%---%%%%%%---|||---------||||---------g---------#-----%%%-----------------------------------------------------
-------------------------%%%%---%%|%|||------||DDD|||%%%%||||%%%%%%%%-----|||||||||||||||||---||||||---|||%%%%--%%%||||%%%%%%%%%%%%%%%%---#-----|||-%%%-----------------------------------C-------------
-B2BB--------------------||||---|||||||------||XXX|||||||||||||||||||-----||||||||||||--------||||||---|||||||--|||||||||||||||||||||||DDDDDD---|||-|||-C-#-------tt-D-tt---tt--------------------------
---------D--------------r||||---||||k||%%%%DDDDDXX||||||||||||||||--------||--------------D---||||||---|||||||--|||||||||||||||||-----U---D-D---|||-|||---#-------Tt---Tt---Tt---tt---------------------
-------------tt--------%%||||%DD|||||||||||--XXXXX|||||||||||-------------||---------tt--#D---||||||---|||||||--|||||||||||---------------D-D---|||-|||---#-------tt---tt---tt---Tt---------------------
%%%%---------tt--------|||||||--|||||||||||--XXXXX|||||||||||%%%%%%---------%%%%%----tt--#D---||||||---|||||||--|||||||||||-------tt------D-D---|||%|||%%%%%%--%%%%%%%%%%%%%%%%%%%%%%%--%%%%------------
||||%%---%%%%%%%%%--%%%||||||---|||||||||||--XXXXX|||||||||||||||||%%----%%%|||||----tt--#-------------|||||||--|||||||||||-------tt------------|||||||||||||--|||||||||||||||||||||||--||||---%%F%%%%%%
||||||---|||||||||--|||||||||---|||||||||||--XXXXX|||-|||||||||||||||----||||||||%%%%%%%%%%------------------------||||||||%%%%%%%%%%%%%%%%%%---|||||||||||||--|||||||||||||||||||||||--||||---||X||||||
||||||---|||||||||--|||||||||---|||||||||||--XXXXX|||-|||||||||||||||----||||||||||||||||||------------------------||||||||||||||||||||||||||---|||||||||||||--|||||||||||||||||||||||--||||---||X||||||
