--------------------------------------------------------------------------------------------------------------------------------------------------------------------------------------------------------
--------------------------------------------------------------------------------------------------------------------------------------------------------------------------------------------------------
----------------------------------------#---------------------------------------------------------------------------------------------------------------------------------------------------------------
----------------------------------------#---------g-----------B-----------------------------------------------------------------------------------------------------------------------------------------
----------------tt---D---%%----%%%%%%---#----%%---B2B-------------B-----------------------------------------G#---------------------C-----------------BBBBBBBBBB-------BC2BBBBBBB-#----------------------
----------------tt-------||DDDD||||||DDDDD---||----------------------BB----------BB--------------------------#----------B---------------DDDDDD-----------------------------------#----------------------
-B2B---------%%%%%%%%%------------------D----||---#-----------%%-B------BB2--D-------tt--#----D--B---B--%%%%-#-tt---tt-----%%%%-BBB-BBB---------------BB-------------------------#----------------------
------D-B2BB-|||||||||----*----g-------kD----||---#-----------||----tt----------tt---Tt--#--------------||||---tt---Tt-----||||--------------D----B----------------B2BBBBBBBBB---#----------------------
--------------------------*--%%%%---%%%%----------#--D---%%---||-r--tt----------Tt---tt--#--------------||||---tt---tt-----||||---%%%%%--------------tt---DDDDDDD---------------%%%%--------------------
BBBBB-------2BB--2BB------*--||||---||||----------#------||---||%%%%%%%%%%%%%%%%%%%%%%%%%%---%%%%%---%%%||||%%%%%DDD%%DDDDDD|||%%%|||||---#--#-------Tt-------------------------||||-----G#-------------
---------D----------------*--|k||---|k||--r-------%%%%---||---||||||||||||||||||||||||||||---|||||---||||||||||||---||-----X|||||||||||%%%%--DD---DDD%%DDD-------------------B------------#-------------
-------------------------%%%%||||%%%||||%%---%%---||||---||---|||||||||||||----------||------|||||---|||||||---||---||-----X|||---|||||||||----------||----%%%%---%%%%----------------------------------
%%%%---------------------|||||||||||||||||---||---||||---||---||---------D-B%%%%%%---||--D-------B------||||----tt---tt----X|||--D-------------------||----||||---||||---tt-----tt---tt-----------------
||||%%--%%%%%%%%%--%%%---|||||||||||||||||---||---||||---||---||%%%%%%---DKD||||||----------------------||||----tt---tt----X|||---------tt-----------||----||||---||||---tt-----tt---tt-------%%%F%%%%%%
||||||--|||||||||--|||---|||||||||||||||||---||---||||---||---||||||||-------|||||----%%%D--------------||||----tt---tt--#-X|||---------Tt---%%--------%%%%||||%%%||||%%%%%%%%%%%%%%%%%%%%%---|||X||||||
||||||--|||||||||--|||---|||||||||||||||||---||---||||---||---||||||||%%%%%%%--|||%%%%|||----%%%%%---%%%||||%%%%%%%%%%%%%%-X|||--%%%%%%%%%%%%||---%%%%%||||||||||||||||||||||||||||||||||||---|||X||||||
