--------------------------------------------------------------------------------------------------------------------------------------------------------------------------------------------------------
--------------------------------------------------------------------------------------------------------------------------------------------------------------------------------------------------------
--------------------------------------------------------------------------------------------------------------------------------------------------------------------------------------------------------
------------------------------------------------------------------------S-----------#-------------------------------------------------------------------------------------------------------------------
--------------------#----------------SSCD----D---------------------------------%%%%%%---DD---DD---DD-----------------SSSSSSS----------------------------------------------------------------------------
---------------%%---D----D-D------------D----------------------SS-S----------G#||||||----SSC-D----------------------------------------------------------------------------------------------------------
-SSSS----------||---D----D------------GDD--------S---S-SSC--D--------------C--#||||||--------D----------------------------------------------------------------------------------------------------------
------DDDDD--DD||---D----D----------U--D-----------------------------%%%%%----#||||||--------D----------------------------------------------------------------------------------------------------------
---------------||----------tt-D----------------------------g---------|||||-----||||||--------------------------------------DDDD----------------------%%%%---tt--#---------------------------------------
SSSSS----------SS----------tt---tt------------g------%%%%%%%%%%%%%%%%|||||-----||||||---DD---DD---DDC------------------SSS-----%%%%---tt-------------||||---tt--#--%%%%----g----------------------------
---------D--C--------------tt---Tt-----%%%---%%%%%---|||||||||||||||||||||DDDDD||||||------------------------------------------||||---Tt-----%%%%----||||---tt--#--||||-%%%-----------------------------
---------------------D---%%%%%%%%%%%%%%|||---|||||---|||||||||||||||||||||-----||||||--------S2------------%%--------------g---|k||---tt-----||||%%%%||||%%%%%%%%%%||||-|||-----------------------------
%%%%--------r-----r------|||||||||||||||||---|||||---|||||||||||||C|||||||---#-SS2|||----------------------||-------%%%%%%%%%%%||||%%%%%%%---||||||||||||||||||||||||||-|||tt---tt---tt-----------------
||||%%--%%%%%%%%%---%%---|||||||||||||||||---|||%%---||||tt|||||||-||||||tt--#----|||--------------%%%%---%||---%%%%||||||||||||||||||||||---||||||||||||||||||||||||||-|||Tt---tt---tt-------%%%F%%%%%%
||||||--|||||||||---||---||||||||||||||%%%---|||||---||||tt||#||#|r||||||tt--#----|g|-r--%%%%%%----||||---|||---||||||||||||||||||||||||||---||||||||||||||||||||||||||%|||%%%%%%%%%%%%%%%%---|||%||||||
||||||--|||||||||---||---||||||||||2SS||||---XXX||---XXXXXXXXX||XXXXXXXXXXXXXXXXXXXXX---X||||||---X||||---|||---||||||||||||||||||||||||||---||||||||||||||||||||||||||||||||||||||||||||||---||||||||||
