--------------------------------------------------------------------------------------------------------------------------------------------------------------------------------------------------------
--------------------------------------------------------------------------------------------------------------------------------------------------------------------------------------------------------
--------------------------------------------------------------------------------------------------------------------------------------------------------------------------------------------------------
------------------------------------------------------S-------------------------------------------------------------------------------------------------------------------------------------------------
-----------------------------SCS-----------S--------------SS----------------------------------DDDDDD----DDD--DDD-D--------------------------------------------------------------------------------------
------------------------------------------------------r-------------tt-----------------------------SSS-----------------S--------------------------------------------------------------------------------
-S2S--------%%---%%%%----------g-----------r-------%%%%%SS----------tt---------------SSSSSSS------------------------------------S-----------------------------------------------------------------------
------D-SSS-||---||||-----S2SSSS2S----D---%%%%----%|||||%%----------tt-------------#----------%%%%---tt---tt--#--tt-D---S2S------------------------------g----------------------------#-S---------------
------------||---||||-----------------D---||||----||||||||DDDD----DD%%DDD2SS-----k-#--SS------||||---tt---tt--#--Tt---------U--------------SSC---------SSS2SS-SSS----------tt--#--tt--#-----------------
SSSSS-------||---||SS-----------------S---|||g----||||||||----------||--------%%%%-#----------||||---tt---tt--#--tt---%%%%%------------------------tt-----------------tt---Tt--#--Tt--#-----------------
---------D--||---||---------2SSSS2--------|||-----|S||||||DDDDD-----||--------||||---tt---%%%%||||%%%%%%%%%%%%%%%%%%%%|||||----%%%%------------g---Tt------g------g---tt---tt--#--tt--#-----------------
------------||---||-------%%%%------------|||-----|-|SSS||---------U||--------|k||---Tt---|||||||||||||||||||||||||||||||||----||||--------%%%%%%%%%%%%%%%%%%%%%%%%%%%%%%%%%%%%%%%%%%%%%%---------------
%%%%--------||---%%-------||||-----g------|%%%%---|-|---||---%%-----||%%%%%%%%||||%%%%%%%%|||||||||||||||||||||||||||||||||%%%%||||--------||||||||||||||||||||||||||||||||||||||||||||||---------------
||||%%--%%%%%%---||%%%%---||||%%%%---%%---%||||---|-|---|g---||----r|||||||||||||||||||||||||||||||||||||||||||||||||||||||||||||||---%%---||||||||||||||||||||||||||||||||||||||||||||||---%%%%%F%%%%%%
||||||--||||||---||||||---||||||||---||---|||||---%%%%%%%%%%%||---%%%%|||||||||||||||||||||||||||||||||||||||||||||||||||||||||||||---||---||||||||||||||||||||||||||||||||||||||||||||||---|||||%||||||
||||||--||||||---||||||---||||||||---||---|||||---|||||||||||||---|||||||||||||||||||||||||||||||||||||||||||||||||||||||||XXXXXXXX---||---||||||||||||||||||||||||||||||||||||||||||||||---||||||||||||
