--------------------------------------------------------------------------------------------------------------------------------------------------------------------------------------------------------
--------------------------------------------------------------------------------------------------------------------------------------------------------------------------------------------------------
--------------------------------------------------------------------------------------------------------------------------------------------------------------------------------------------------------
---------------------------------------------------------------------------------------------------------#--#-------------------------------------------------------------------------------------------
-----------#---------------------------------------------------%%%----y----------%%%---DDDDDD----DDD---DD---%%%---DDDDDDD-D-------D---------------------------------------------------------------------
-----------#---------------D-------D-D---------------SSS---SSC%|||-%%%%%%--SSSSC-|||SS-------------SSS---%%%|||SS-D-------------------------------------------------------------------------------------
-----------#-------------------S---------------G#----------%%%||||-||||||--------|||---------------------||||||-----------------------------------C-------------------C---------------------------------
------DDDDDDDD-----------------------------S-S--#----------|||||||-||||||--------|||---------------------||||||---DDDDDDDDD---DDDDDDDDD-----------------------------------------------------------------
-----------D------------------D------tt-D--------------S---|||||||-|||||DDSSSSS--|||---------------------||||||-----------------------------------------------------------------------------------------
-S2SS------D-------S-----------------tt--------------------|||||||%||||||----DDDDDDD---DDDDDD----DDD--%%%||||||---DDDDDDDC-----------------%%%%----g-----g----------------------------------------------
---------D-D---tt--------r------r----tt---------%%----C----||||||||||||||-----------------------------|||||||||----------------------------||||-%%%%%%%%%%%-----------*---------------------------------
-----------D---Tt-----D---%%--%%---%%%%%%%%%%%%%||---------||||||||||||||--C--------SS-SSS-S---g------|||||r|||---------------%%%%--%%%---%||||-|||||||||||--tt---tt--*---------------------------------
%%%%-----------tt---------||--||---|||||||||||||||----r----%%||C|||||||||-----tt----------------2SS---||||%%%%|---------------||||--|||---|||||-||D||||||||--Tt---Tt--*--%%--------%%%%-----------------
||||%%--%%%%%%%%%%%%%%%---||--||---|||||||||||||||---%%%---||||-||tt|||||SS---Tt---tt----------------tt||||||||--tt---%%%%%---||||--|||---|||||-||-||||||||--tt---tt--*--||---%%%%%||||---%%%%%%%F%%%%%%
||||||--|||||||||||||||---||--||---|||||||||||||||---|||---||||r||Tt|||||-----tt---tt------------g---Tt||||||||--Tt---|||||---||||--|||---|||||%||%||||||||%%%%%%%%%%%%%%||---|||||||||---|||||||%||||||
||||||--|||||||||||||||---||--||---|||||||||||||||---|||---|||XXXXXX|||||XXXXXXXXXXXXXXXXXXXX---XXXXXXXXXX||||XXXXXXXX|||||---||||--|||---|||||||||||||||||||||||||||||||||---|||||||||---||||||||||||||
