--------------------------------------------------------------------------------------------------------------------------------------------------------------------------------------------------------
--------------------------------------------------------------------------------------------------------------------------------------------------------------------------------------------------------
--------------------------------------------------------------------------------------------------------------------------------------------------------------------------------------------------------
--------------------------------------------------------------------------------------------------------------------------------------------------------------------------------------------------------
---------------D-D---D----------------------------D----------C------------------------------------------------------------------------------------------------------------------------------------------
--------------------------------------------------------------------------------------------------------------------------------------------------------------------------------------------------------
----------g--------------------B-B2B----C--2B-----------BB------------------------------------------------------------------------------------------------------DDD-------------------------------------
------D-BBB2%%-*--D-D---D-BB--------------------BC---D-------------------------------------------------DDD--DD----------------------------------------------2BB-----------------------------------------
------------||-*---------------------------------------tt---%%%%----y--y---------------------------BBB------------------------------------------------------------------B---%%%%----%%%%----------------
-B2BB-------||-*--------------g-------r------------g---tt---||||-%%%%%%%%%----C----------------------------------------------------------------------------r-k--------------||||----||||----------------
---------D--||%%%%%%%%--%%%%---%%%-----%%%%-----%%%%%%%%%%%%||||-|||||||||-D-------C-----------------tt---tt--#-BB----D----U--tt--------------------------%%%%----------%%%%||||----||||----------------
------------||||||||||--||||---|||-----||||-----||||||||||||||||-|||||||||------------tt---tt---tt---tt---tt--#---------------tt--------------------------||||---%%%%%%-||||||||%%%%||||%%%%------------
%%%%--------||-|||||||--||||---|||-----||||-----||||||||||||||||-|||||||||%%%------r--Tt---Tt---tt---tt---tt--#-----g----r----tt---%%%-----------tt-------||||---||||||%|||||-||||||||||||||------------
||||%%--%%%%||%|||||||--||||---|||-----||||-----||||||||||||||||%||||||||||||%%--%%%%%%%%%%%%%%%%%%%%%%%%%%%%%%%%%%---%%---%%%%%%%%|||------tt---Tt-----%%||||%%%||||||||||||-||||||||||||||%%%%%F%%%%%%
||||||--||||||||||||||--||||---|||-----||||-----|||||||||||||||||||||||||||||||--||||||||||||||||||||||||||||||||||---||---|||||||||||------tt---tt-----|||||||||||||||||||||-|||||||||||||||||||X||||||
||||||--||||||||||||||--||||---|||-----||||-----|||||||||||||||||||||||||||||||--||||||||||||||||||||||||||||||||||---||---|||||||||||---%%%%%%%%%%%%---|||||||||||||||||||||-|||||||||||||||||||X||||||
