--------------------------------------------------------------------------------------------------------------------------------------------------------------------------------------------------------
--------------------------------------------------------------------------------------------------------------------------------------------------------------------------------------------------------
--------------------------------------------------------------------------------------------------------------------------------------------------------------------------------------------------------
---------------------------------------g------------------------------------------------------------------------------------g-----g---------------------------------------------------------------------
--------------------------------tt------------%%%SSSS2SDDD-----------%%%%%%--%%%----DDD----------------------------G#--%%%%%%%%%%%%SS---S---S-SSC--D------SS--------------------------------------------
--------------------------------Tt------------|||DDDD----------------||||||--|||-------------------------------G----#--||||||||||||-------------------tt------------------------------------------------
-SS2S--------------------DDDDDDDDDDD---DD---DD|||-----------SS---SS--|SS|||--|||-------SS-S---r--------S------------#--||||||||||||S--------------g---Tt------------S2S---------------------------------
------D---------------------------------------|||-----S-S------------|--||tt-|S|-tt----------%%%%--SS2------D----------||||||||g|||--------%%%%%%%%%%%%%%%---------------------------------%%%%---------
----------------G---S2SS---r-k----------------|||----------tt---tt---tt-||Tt-|-|-Tt---tt-----||||----------------------|||%|||||||%-----DDD|||||||||||||||DDDD--------------SS-SS---SS-----||||---------
2SSSS---------------------%%%%-----D----S----D||tt------r--tt---tt---Tt-||tt-|r|-tt---tt-----||||------g----------%%---|g||||||||||--------|||||||||||||||-------SSSSSSS-------------------||||---------
---------D--tt------------||||----------------||tt---%%%%%%%%%%%%%%%%%%%%%%%%%%%%%%%%%%%%%%%%||||%%%%%%%---%%%%---||-%%||%|||||||||DD---DD-*||||||||S|S|S|S-------------------------S2SS---||||---------
------------Tt------------||||--------------g-||tt---|||||||||||||||||||||||||||||||||||||||||||||||||||---||||---||-||||||||||||||--------*|||||D||-|-|-|--S--tt--------------------------||||---------
%%%%--------tt-----%%--%%%||||%%%%%%---%%---%%%%%%%%%|||||||||||||||||||||||||||||||||||||||||||||||||||---||||---||-||||||||||||||--------*||tt|-||-|-|-|-----Tt-----------%%%%%----------||||---------
||||%%--%%%%%%%%---||%%|||||||||||||---||---||||||||||||||||||||||||||||||||||||||||||||||||||||||||||||---||||---||-||||||||||||||--------*||tt|-||-|-|-|-----tt---%%%%%---|||||----------%%%%%%F%%%%%%
||||||--||||||||---|||||||||||||||||---||---||||||||||||||||||||||||||||||||||||||||||||||||||||||||||||---||||---||%||||||||||||||%%---%%%%%%%%%%%%%%%%%%%%%%%%%%%%|||||---|||||---D--D---||||||%||||||
||||||--||||||||---|||||||||||||||||---||---||||||||||||||||||||||||||||||||||||||||||||||||||||||||||||---||||---|||||||||||||||||||---|||||||||||||||||||||||||||||||||---|||||----------|||||||||||||
