--------------------------------------------------------------------------------------------------------------------------------------------------------------------------------------------------------
--------------------------------------------------------------------------------------------------------------------------------------------------------------------------------------------------------
--------------------------------------------------------------------------------------------------------------------------------------------------------------------------------------------------------
--------------------------------------------------------------------------------------------------------------------------------------------------------------------------------------------------------
-----------------------------y-------ry-------------------SSS-------D--#---------------------------------------------------g-------U--------------------------------S-----------------------------------
---------------------%%%%--%%%%---D-%%%%---%%%%---tt-SSS---------------#-------------------------------------------------%%%%-S2S--------------------------------------------D--------------------------
-SCS-------g--g--y---||||--||||-----||||---||||---Tt----------g--------#---------------------------D---------------------||||------------%%-------------------tt---------SSC----------------------------
------D%%%%%%%%%%%%%%||||-r||||k----||||k--||||---tt---%%%%%%%%---%%%%DDDD----S--------C---------------------------------||||---%%%%%%---||----tt---%%%%%-----tt---%%%---D----------C-------------------
-------||||||||||||||||||%%||||%%%%%||||%%%||||%%%%%%%%||||||||---||||-D--------SSCS-----------------------C--SS-----%%%%||||%%%||||||---||----Tt---|||||---%%%%%%%|||----DDDD---D-----S----------------
SSSSS--||||||||||||||||||||||||||||||||||||||||||||||||||||||||---|C||-D---------------------------tt-D--------------|||||||||||||||||---||DDDDDDDDD|||||---||||||||||-------D---D----------------------
-------||||||||||||||||||||||||||||||||||||||||||||||||||||||||---|-||--------------g---%%%%%------tt---tt---tt-SS---|||||||||||||||||---||---------|||||---#|||||||||----DD----------------------------
-------|||||D||||||||||||%%||||%%%|tt||||||||||||||||||||||||%%---|-||%%%%---%%%%%%%---%|||||------tt---Tt---Tt------||||||||||tt||SS2---||-*-------|||||---#||tt||SSS-----------%%%%%%%%---------------
%%%%---|||||-||||||||||||||||||||||tt|||||||||||||||||tt|||||||---|-||||||---|||||||---||||||%---%%%%%%%%%%%%%%%%%---||||||||||Tt||------||-*-------|||||---#||tt||--------------||||||||---------------
||||%%-|||||%||||||||||||||||||||||tt|||||||||||||||||tt|||||||---%%%%||||---|||||||---|||||||---|||||||||||||||||---||||||||||tt||----g-||-*--%%%%%%||||---#||tt||-------#--#---||||||||---%%%%%F%%%%%%
||||||-||||||||||||||||||||||||%%%%%%|||||%||||%%%%%%%%%%%|||||---||||||||---|||||||---|||||||---|||||||||||||||||---|||||||DDD%%%%%%%---%%%%%%||||||%%%%---%%%%%%%%%%---%%--D---||||||||---|||||%||||||
||||||-||||||||||||||||||||||||||||||||||||||||||||||||||||||||---||||||||---|||||||---|||||||---|||||||||||||||||---S2SS||||--|||||||---||||||||||||||||---||||||||||---||------||||||||---||||||||||||
