--------------------------------------------------------------------------------------------------------------------------------------------------------------------------------------------------------
--------------------------------------------------------------------------------------------------------------------------------------------------------------------------------------------------------
---------------------C----------------------------------------------------------------------------------------------------------------------------------------------------------------------------------
--------------------------------------------------------------------------------------------------------------------------------------------------------------------------------------------------------
--C-------------------------------------------------------------------------------y------------------------------------y---------------U---BB----%%%%%--------D----tt-------------#-----#---------------
--------------------------------------------------------------------------------------B-------------------------tt-D-%%%%---%%%%-----------------|||||%%%%%--------tt------#--#--###---###--------------
--r----------------DDD--%%%----------------------------2BB--C---------------------------------------------------tt---||||---||||----------tt%%%%%||||||||||---%%%%%%%%%%%%%%--%%%%%%%%%%%%%%%%%%--------
DDDDD-D-------B2BC------|||----------BCB--------C-------------------------------%%%%%---------------------------tt---|k||---||||----------tt|||||||||||||||---||||||||||||||--||||||||||||||||||--------
------------------------|||--BB-------------------C-----------------------------|||||-----------%%%%%%%--%%---%%%%%%%||||%%%||||%%%--%%%%%%%|||||||||||||||---||||||||||||||--||||||||||||||||||--------
---------------------B---------------------------------------------------%%%%%%%|||||%%%----g---|||||||--||---|||||||||||||||||||||--||||||||||||||||||||||---||||||||||||||--||||||||||||||||||--------
---------D--BB2--D----------tt-B---BBBBB----------r-------%%%%----y------|||||||||||||||-%%%%%%%|||||||--||---|||||||||||||||||||||--||||||||||||||||||||||---||||||||||||||--||||||||||||||||||--------
---------------------r------Tt---------------%%%%%%%%--%%%||||-%%%%%%%%%%|||||||||||||||-||||||||||||||--||---|||||||||||--||||||||--||||||||||||||||||-------||||||||||||||--||||||||||||||||||--------
%%%%------------g---%%%%%%%%%%%%---------g---||||||||--|||||||-|||||||||||||||||||||||||-||||||||||||||--||---|||||||||||--||||||||--||||||||||||-------------------------------------------------------
||||%%--%%%%%%%%%%%%||||||||||||---%%%%%---%%||||||||--|||||||-||D||||||||||||||||||||||-||||||||||||||--||---|||||||||||---||||-----||||||||||||------------------------------------------%%%%%%F%%%%%%
||||||--||||||||||||||||||||||||---|||||---||||||||||--|||||||-||-||||||||||||||||||||||-||||||||||------------------||||%%%||||%-----------|||||------------------------------------------||||||X||||||
||||||--||||||||||||||||||||||||---|||||---||||||||||--|||||||%||%|||||||||||||----------||||||||||------------------||||||||||||-----------|||||------------------------------------------||||||X||||||
