--------------------------------------------------------------------------------------------------------------------------------------------------------------------------------------------------------
--------------------------------------------------------------------------------------------------------------------------------------------------------------------------------------------------------
--------------------------------------------------------------------------------------------------------------------------------------------------------------------------------------------------------
--------------------------------------------------------------------------------------------------------------------------------------------------------------------------------------------------------
-------------------------------U------C---------------------------------------------------------------------------------------------------------------------------------------BB------------------------
--------------------------------------------------------------------------------------------------------------------------------------------------------------------------------------------------------
------------------------------------%%--%%-----------------------------D----------------------------------------------------------------------------------------------tt-----tt-------------------------
------D-----------------------------||--||----------------------------------------------------------------------------------------------------------------------------tt-----Tt-------------------------
---------------------------%%DDDD---||D-||----------------------2BB---------------g--------------------------------------------------------------------------------DDD%%DDDDD%%DDDDD--------------------
BBBBB--------r-k--BBBB----r||-----------||------C------tt-D---------*-----D---D-BBB2BCB--------D---------------------------------------------U-C---------------BBC----||-----||----tt--#----------------
---------D--%%%%------%%%%%||-----------||-------------tt-----------*--tt---------------D---D-------------------------------------------------------------------------||-----||----Tt--#----------------
------------||||------|||||||-----------||------r------tt-----------*--Tt-----------g-----------------------------C---C--------rg-----------------tt---tt----------g--#--#---#--#--tt--#----------------
%%%%--------||||------|||||||----------------%%%%%%%%%%%%%%%%-----%%%%%%%%%%--%%%%%%%%%%%---%%%%--D------C-----D-----------#--%%%%---tt-----------Tt---Ttr--%%%%%%%%%%%--%%%%%--%%%%%%%%%%%%------------
||||%%----%%||||%%%--%|||||||----------------||||||||||||||||-----||||||||||--|||||||||||---||||-----tt-----tt-------------#--||||---tt-----%%%%%%%%%%%%%%%%|||||||||||--|||||--||||||||||||%%%%%F%%%%%%
||||||----|||||||||--||||||||----------------||||||||||||||||-----||||||||||--|||||||||||---||-------tt--r--tt-------%%----#--||||---tt-----|||||||||||||||||||||||||||--|||||--|||||||||||||||||X||||||
||||||----|||||||||--||||||------------------||||||||||||||||-----||||||||||--|||||||||||---||%%--%%%%%%%%%%%%%%%%%%%||---%%%%||||%%%%%%%---|||||||||||||||||||||||||||--|||||--|||||||||||||||||X||||||
