--------------------------------------------------------------------------------------------------------------------------------------------------------------------------------------------------------
--------------------------------------------------------------------------------------------------------------------------------------------------------------------------------------------------------
--------------------------------------------------------------------------------------------------------------------------------------------------------------------------------------------------------
------------C-------------------------------------------------------------------------------------------------------------------------------------------------------------------------------------------
-------------------------------------------------------------------------------------B---------DDDDDDD----D---------------------------------------------------------------------------------------------
-----------------------------------------DDD--%%%---BBDD----DDD--DDD--DDD--%%---------------------------------------------------------------------------------------------------------------------------
BBB----------------------------2BBB---BB------|||------BBC-----------------||-------------------------B----BBBB----g------------------------------------------------------------------------------------
------D-----DDDDDD------------------------------------------------------------U-C-B2BB-----BB-%%%-BBCB-----------%%%%--------%%%%%BB--------------------------------------------------------------------
------------------------------------------BB%%%---tt--B-----D--------tt---tt------------------|||----------------||||-----%%%|||||---C--tt---------------------U----------------------------------------
BBBBB---------r-k--2BB-B2BB---ry-------C----|||---tt-----tt-----tt---Tt---tt------------------|g|-----g----------||||-----|||||||tt-----Tt-----%%%---------------------------------------#--------------
---------D---%%%%------------%%%%-----------||g---tt-----Tt-----Tt---tt---tt--------------%%%%|||%%%%%%---%%--%%%||||%%---|||||||tt-----tt-----|||---------------------------------------#--------------
-------------||||------------||||--------%%%|||%%%%%%%%%%%%%%%%%%%%%%%%%%%%%%%%%%%%%%----%|||||||||||||---||--|||||||||---|||||||%%%%%%%%%%%---|||-------%%%-------------%%%----tt---tt--#--------------
%%%%---------||||------------||||k-------||||||||||||||||||||||||||||||||||||||||||||----||||||||||||||---||--|||||||||---||||||||||||||||||---|||%%%%---|||%%%%%%--%%---|||----tt---Tt--#--------------
||||%%--%%%%%||||%%%%%%%--%%%||||%%---%%%||||||||||||||||||||||||||||||||||||||||||||----||||||||||||||---||--|||||||||---||||||||||||||||||---|||||||---|||||||||--||---|||%%%%%%%%%%%%%%%%---%%F%%%%%%
||||||--||||||||||||||||--|||||||||---|||||||||||||||||||||||||||||||||||||||||||||||----||||||||||||||---||--|||||||||---||||||||||||||||||---|||||||---|||||||||--||---|||||||||||||||||||---||X||||||
||||||--||||||||||||||||--|||||||||---|||||||||||||||||||||||||||||||||||||||||||||||----||||||||||||||---||--|||||||||---||||||||||||||||||---|||||||---|||||||||--||---|||||||||||||||||||---||X||||||
