--------------------------------------------------------------------------------------------------------------------------------------------------------------------------------------------------------
--------------------------------------------------------------------------------------------------------------------------------------------------------------------------------------------------------
--------------------------------------------------------------------------------------------------------------------------------------------------------------------------------------------------------
-----------------------------------------------------------------------#--#-----------------------------------------------------#--#--------------------------------------------------------------------
----------------B----------------------------------------------------DDD--%%%--DDD--DDD--------------------------DDD---DDDD---%%%--%%%%%%---------------------------------------------------------------
----------------------------------------------------------BB-----2BB------|||--------------------------------BBB--------------|||--||||||---------------------------------------------------------------
-BBBB-----------r----DDDDD------------------------------------------------|||-------------------------D--*-B--%%%%%%----------|||--||||||------------g----------------------------g-------%%%%%%--------
------D%%%%%--%%%---D-----------------G---B2BB-C-C-B-------------------BB---U--D---tt--------------------*----||||||-------------------------------BBB#BB--tt-------------%%%%%%%%%-----B-||||||--------
-------|||||--|||---D------U-------------------------BB---D--------C---------------Tt---tt----------g----*-r--||||||---------------------------------------Tt--------tt---|||||||||-------||||||--------
BBBBB---------|||---D---D--------------------------------------%%%----tt----r------tt---Tt----BC2BDBB2B%%%%%%%||||||---DDDD---DDDDD---k----------------g---tt--------Tt---|||||||||%%-----||||||--------
---------D------------------------tt---------------------g-----|||-r--tt---%%%%%%%%%%%%%%DDDDDDDD-D----|||||||---------------------%%%%-----------%%%%%%%%%%%%%%--%%%%%%%%|||||||||||-----||||||--------
----------------------------------tt---------%%%%%%%%%%---%%---|||%%%%%%%%%||||||||||||||---------D-------------B-B----------------||||-----------||||||||||||||--|||||||||||||||||||-----||||||--------
%%%%----------------%%%--%%%%---%%%%%%%---%%%||||||||||---||---||||||||||||||||||||||||||------BBBBBC---------D------tt---tt-D-----|k||-----%%%---||||||||||||||--|||||||||||||||||||---%%||------------
||||%%--%%%%%--%%---|||--||||---|||||||---|||||||||||||---||---|||||||||||||||||||-||------------------tt------------tt---Tt-----%%||||%%---|||---||||||||||||||--|||||||||||||||||||---||||%%%%%F%%%%%%
||||||--|||||--||---|||----||---|||||||---|||||||||||||---||---|||||||||||||||||||-----%%%%%-----------Tt------------tt---tt-----||||||||---|||---||||||||||||||--|||||||||||||||||||---|||||||||X||||||
||||||--|||||--||---|||%%%%||---|||||||---|||||||||||||---||---|||||||||||||||||||B2BB%|||||%%%%%%%%%%%%%%%%--%%%%%%%%%%%%%%%%%%%||||||||---|||---||||||||||||||--|||||||||||||||||||---|||||||||X||||||
