--------------------------------------------------------------------------------------------------------------------------------------------------------------------------------------------------------
--------------------------------------------------------------------------------------------------------------------------------------------------------------------------------------------------------
--------------------------------------------------------------------------------------------------------------------------------------------------------------------------------------------------------
--------------------------------------------------------------------------------------------------------------------------------------------------------------------------------------------------------
--------------------------------------------------------------------------------------------------------------------------------------------------------------------------------------------------------
--------------------------------------------------------------------------------------------------------------------------------------------------------------------------------------------------------
-----------------C---------------------S---C----k----C--------------------------------------------------------------------------------------------------------------------------------------------------
------D--------------------------------------%%%%----------------------------------C------------------------------------------------------------------------------------------------------#-------------
---------------------------------------------||||-------%%----DDDDD-----------------------------------------------------------------------------------------------------------------------#-------------
SSSSS----------------SS----%%%%%-------------|k||-------||-----------g-----CC---------------rg----------------------------------r-k----------------------C------tt---------------------C--#-------------
---------D---tt--SSS------%|||||----tt-----%%||||%%%%%%%||----*-------2--------------------%%%%-------SS2----------tt-------U--%%%%---%%%%-----S----------------tt-------tt-----------------------------
-------------Tt-----------||||||----tt-----|||||||||||||||----*-------------------%%%------||||---------------tt---Tt---tt-----||||---||||----------------------tt-------tt---%%------------------------
%%%%---------tt------g----||||||%%%%%%%%---|||||||||||||||----*-------------------|||------||||k----------g---Tt---tt---Tt--r--||||---||||------g---%%%%%%%%%%%%%%%%%%%%%%%%%%||---%%%%%%%%-------------
||||%%--%%%%%%%%%%%%%%%---||||||||||||||---|||||||||||||||---%%%%-D-----%%%%%D-%%%|||---%%%||||%%%--%%%%%%%%%%%%%%%%%%%%%%%%%%%||||%%%||||%%---%%%%%||||||||||||||||||||||||||||---||||||||%%%%%%F%%%%%%
||||||--|||||||||||||||---||||||||||||||---|||||||||||||||---||||-D---%%|||||--||||||---||||||||||--||||||||||||||||||||||||||||||||||||||||---|||||||||||||||||||||||||||||||||---||||||||||||||%||||||
||||||--|||||||||||||||---||||||||||||||---|||||||||||||||---||||-----|||||||--||||||---||||||||||--||||||||||||||||||||||||||||||||||||||||---|||||||||||||||||||||||||||||||||---|||||||||||||||||||||
