--------------------------------------------------------------------------------------------------------------------------------------------------------------------------------------------------------
--------------------------------------------------------------------------------------------------------------------------------------------------------------------------------------------------------
------------------------------------#-------------------------------------------------------------------------------------------------------------------------------------------------------------------
------------------------------------#-------------------------------------------------------------------------------------------------------------------------------------------------------------------
-------------S--------------------g-#--------------------------------------------C--C--C--------------------------------------------------k-------------------------------------------------------------
------------------------DDDDDD-S2SS2%%%--DDD-----D-------------------------------------------------------------------------------------%%%%---tt--------------------------------------------------------
-----------------r------------------|||------------------------------------------------------------------------------------------------||||---Tt---%%%%-------------------------------------------------
------------SS---SSS-----%%%%%SS----|||SS------------------------S2SS-----------------g------------------------------------------------|k||k-rtt---||||-----tt------------------r-k------SS-------------
------G#-D---------------|||||---SS2|||-------SS-------SSC----------------------tt--SSS2SS2----D------------------%%%%-------------%%%%||||%%%%%%%%||||-----tt---%%%%%---------%%%%---------------------
---SS--#-----------------||||tt-----|||------------------------------------tt---Tt-----------------%%%%----g------||||----%%%%--%%%||||||||||||||||||||---%%%%%%%|||||----tt---||||----------g----------
-------#-----------------g|||Tt-----|g|-----------g--------g---%%%%%%------Tt---tt------g-----%%%--||||-%%%%%%%%%%||||----||||--|||||||||||||||||||||||---||||||||||||----tt---||||------%%%DDDDDD------
---------#--D-----%%%---%%%%%%%%%%%%%%%%%%%%%%%%%%%---%%%%%%%%%||||||%---%%%%%%%%%%%%%%%%%%---|||%%||||-||||||||||||||%---||||--|||||||||||||||||||||||---||||||||||||%%%%%%%%%||||%%%---|||------------
%%%%-----#-------%|||---|||||||||||||||||||||||||||---||||||||||||||||---||||||||||||||||||---|||||||||-||D||||||||||||---||||--|||||||||||||||||||||||---||||||||||||||||||||||||||||---|||------------
||||%%---#-------||||---|||||||||||||||||||||||||||---||||||||||||||||---||||||||||||||||||---|||||||||-||-||||||||||||---||||--|||||||||||||||||||||||---||||||||||||||||||||||||||||---|||%%%%%F%%%%%%
||||||--%%%%%%---||||---|||||||||||||||||||||||||||---||||||||||||||||---||||||||||||||||||---|||||||||%||%||||||||||||---||||--|||||||||||||||||||||||---||||||||||||||||||||||||||||---||||||||%||||||
||||||--||||||---||||---|||||||||||||||||||||||||||---||||||||||||||||---||||||||||||||||||---|||||||||||||||||||||||||---||||--|||||||||||||||||||||||---||||||||||||||||||||||||||||---|||||||||||||||
