--------------------------------------------------------------------------------------------------------------------------------------------------------------------------------------------------------
--------------------------------------------------------------------------------------------------------------------------------------------------------------------------------------------------------
-------------------------------------------------------------------#---------------#--------------------------------------------------------------------------------------------------------------------
-------------------------------------------------------------------#---------------#--------C-----------------------------------------------------------------------------------------------------------
-----------------------------------------SSSS-S-----#----%%%%%%%---#------D--------#--------------------------------------------------------------------------------------------------------------------
---------------------%%%%%-----------------------D--#-S--|||||||%%%%%%%---D----D---DDD------------S-----------------------------------------------------------------------------------------------------
-SSSS----------%%%---|||||%%%-----------------------#----||||||||||||||------------D--------------------------------------------------------------------------------------------------------------------
------D--2SSSS-|||---||||||||--2S2---S2S------------#-r--||||||||||||||---%%%%%----D--------DDDDDDD-----------------------------------------------------------------------------------------------------
---------------|||---||||||||---------------%%%%%%%%%DDDD||||||||||||||---|||||----D----SSS---------------------------------------------------D---------------------------------------------------------
SSSSS----------|||---S||2SS||----------g----|||||||||----||||||||||||||---|||||----D------------%%%---%%---------------------------------------------------------%%%%--SSS------------------------------
---------D--SSC||D----||---|U-#--S---SSS2S--|||||||||----||||y|||S|||||--g|||||-------------g---|||---||-------------------g--------------------------------C----||||----------D---D----tt--------------
---------------||-----||---|--#-------------|||||tt|D----D|%%%%||-|*|SS---2SS||------%%%%%%D%%%%|||---||---------S-------%%%%-----------------tt-D------tt-------||||------g-------D----tt--------------
%%%%-----------|g-----||---|r-#-------------tt|||Tt|D-tt--|||||||-|*|--------||------||||||-|||||||---D|-----------------||||-------tt---tt---Tt---tt---tt---%%%%||||%%%%%%%%%%%--------tt--------------
||||%%--%%%%%%%%%%---%%%--%%%%%%%%-----#----Tt|||tt|--tt--||k||k|-|*|--------%%%---%%||||||%|||||||---D|-------------g---||||-------tt---Tt---tt---Tt---tt---|||||||||||||||||||---%%%%%%%%%%---%F%%%%%%
||||||--||||||||||---|||--||||||||-----%%%%%%%%%%%%%%%%%%%%||||%%%%%%%%---%%%|||---||||||||||||||||----|------%%%%---%%%%||||%%%%%%%%%%%%%%%%%%%%%%%%%%%%%%%%|||||||||||||||||||---||||||||||---|%||||||
||||||--||||||||||---|||--||||||||-----||||||||||||||||||||||||||||||||---||||||---||||||||||||||||---XX---XXX||||---|||||||||||||||||||||||||||||||||||||||||||||||||||||||||||---||||||||||---||||||||
