--------------------------------------------------------------------------------------------------------------------------------------------------------------------------------------------------------
--------------------------------------------------------------------------------------------------------------------------------------------------------------------------------------------------------
--------------------------------------------------------------------------------------------------------------------------------------------------------------------------------------------------------
--------------------------------------------------------------------------------------------------------------------------------------------------------------------------------------------------------
--------------------------------------------------------------------------------------------------------------------------------------------------------------------------------------------------------
------------------------------S---------------------------SS----S-SS-------------------------S---------------------------------------------U------------------------------------------------------------
--------------------------------C----------------C------------------------------------------------------------------------------------------------------------------------------------------------------
--------------------------------------------------------------------------------------------------------------------------------------------------------------------------------------------------------
--------------------------------------------------------------------------------------------------------------------------------------------------------------------------------------------------------
--------------------------------------------------------------------------------------------------------------------------------------------------------------------------------------------------------
--S-------------U--------------US#----#--------ttS-----SC---C-#--S----ttS-----tt-------------------------------tt--C-U-------tt------------C--------#------------S--------------------------------------
---tt----------#---------#-------#----#--------tt-------------#-------tt------tt-------------------------------tt------------tt---------------------#---------------------------------------------------
---tt----------#---------#tttt---#---##--------tt------------##------#tt-#----tt------------------------------#tt-----###----tttttttttttttt-tttttttt#tttttttttttt-tttttt-tttttttttttttttttttttttttttttt-
---ttk-k-g--k--#-k-g-g-g-#tttt---#---##-k-kg-g#tt-kk-g---#---##-----g#tt-#-g--tt-gg-gg-g-k-g-gg-k-g-k-g-g--g-g#tt-g---###k-g-tttttttttttttt-tttttttt#tttttttttttt-ttttttgttttttttttttttttttttttttttttttF
%%%|||%|%|%%|%%|%|%|%|%|%|||||%%%|%%-||%|%||%||||%||%|%%%|%-%||%-%-%||||%|%|%%||%||%||%|%|%|%||%|%|%|%|%|%%|%||||%|%%%||||%|%||||||||||||||%|||||||||||||||||||||%|||||||||||||||||||||||||||||||||||||%
||||||||||||||||||||||||||||||||||||-||||||||||||||||||||||-||||-|-|||||||||||||||||||||||||||||||||||||||||||||||||||||||||||||||||||||||||||||||||||||||||||||||||||||||||||||||||||||||||||||||||||||
