--------------------------------------------------------------------------------------------------------------------------------------------------------------------------------------------------------
--------------------------------------------------------------------------------------------------------------------------------------------------------------------------------------------------------
--------------------------------------------------------------------------------------------------------------------------------------------------------------------------------------------------------
--------------------------------------------------------------------------------------------------------------------------------------------------------------------------------------------------------
--------------------------------------------------------------------------------------------------------------------------------------------------------------------------------------------------------
--U-----------------------B----------B---U--B-------------U-----------------------BB-BUUB--B-B------------------------------------------------------------------------U---------------------------------
-----------------------------------C-----------------------------------------------------------------------------------------------------------------------------------C--------------------------------
--------------------------------------------------------------------------------------------------------------------------------------------------------------------------------------------------------
--------------------------------------------------------------------------------------------------------------------------------------------------------------------------------------------------------
--------------------------------------------------------------------------------------------------------------------------------------------------------------------------------------------------------
B#C----------------------#---------B#--ttCU--------#------C----------------------B----CC--#-#-U------------------------B--#-------------------------------------------CB-----------U--------------------
-#-----------------------#----tt----#--tt----------#---#----------------------------------#-#--#--------------------#-----#-----------#-----------------------------------------------------------------
-#-----------------------#----tt--#-#--tt----------#---#tt----------------------#--------##-#--##-----------#--####-###-########-----############-###################---###########-####################
-#--k-g-g-k-gg-k-g-g-g---#-g--tt#-#-#ggtt----#-k-g-#g--#tt--k-g-k-g-g--g--k-g-k-#----g---##-#g-###k-g-k-g-g-#-k####-###-########g-k--############-####################--###########-###################F
XXXXXXXXXXXXXXXXXXXXXXXXXX-XX-XXX-XXXXXXXXXXXX-XXXXXXXXXXXXXXXXXXXXXXXXXXXXXXXXXXX--XXXX-XXXXXXXXXXXXXXXXXXXXXXXXXX-XXXXXXXXXXXXXXXXXXXXXXXXXXXXXXXXXXXXXXXXXXXXXXXXXXXXXXXXXXXXXXXXXXXXXXXXXXXXXXXXXXXX
XXXXXXXXXXXXXXXXXXXXXXXXXX-XX-XXX-XXXXXXXXXXXX-XXXXXXXXXXXXXXXXXXXXXXXXXXXXXXXXXXX--XXXX-XXXXXXXXXXXXXXXXXXXXXXXXXX-XXXXXXXXXXXXXXXXXXXXXXXXXXXXXXXXXXXXXXXXXXXXXXXXXXXXXXXXXXXXXXXXXXXXXXXXXXXXXXXXXXXX
