--------------------------------------------------------------------------------------------------------------------------------------------------------------------------------------------------------
--------------------------------------------------------------------------------------------------------------------------------------------------------------------------------------------------------
--------------------------------------------------------------------------------------------------------------------------------------------------------------------------------------------------------
--------------------------------------------------------------------------------------------------------------------------------------------------------------------------------------------------------
--------------------------------------------------------------------------------------------------------------------------------------------------------------------------------------------------------
-----------------------------------------------------SS------------S-SSS------------S---S---SS--S---------------------------------------------------------------------------------------------S---------
-----------------------------------------------------------------------------------------------C--------------------------------------------------------------------------------------------------------
--------------------------------------------------------------------------------------------------------------------------------------------------------------------------------------------------------
--------------------------------------------------------------------------------------------------------------------------------------------------------------------------------------------------------
--------------------------------------------------------------------------------------------------------------------------------------------------------------------------------------------------------
----------------------------------------------------S--tt------U#---------------------#S---S---S-tt---------------------------------------------S-------------------------------------------------------
-------------------------------------------------------tt-#-----###-------------------#----------tt-----------------------------------------------------------------------------------------------------
-------------------------------------------------------tt-#-----###-------------------#----------tt-----------------------------------------------------------------------------------------------------
-k-g-k-gk-g-k-g-k-k-g-g--k-k-g-k-k-k--k-g-k-g-g--------tt-#k-k--###----gk-k-g--k-g--g##-g#-------tt-g--k--k--k-g-k-g-g-g-g-k-k-k-g-k-g-g-k--k----g-k----k-g--g-g-g-g-g-k-g-g-k-g-g--g-g##--###-########F
%|%|%|%||%|%|%|%|%|%|%|%%|%|%|%|%|%|%%|%|%|%|%|%%%%%%--||-||%|%%|||%%%%||%|%|%%|%|%%|||%||%%%%%%-||%|%%|%%|%%|%|%|%|%|%|%|%|%|%|%|%|%|%|%|%%|%%%%|%|%%%%|%|%%|%|%|%|%|%|%|%|%|%|%|%%|%|||%%|||-||||||||%
|||||||||||||||||||||||||||||||||||||||||||||||||||||--||-||||||||||||||||||||||||||||||||||||||-|||||||||||||||||||||||||||||||||||||||||||||||||||||||||||||||||||||||||||||||||||||||||||||-|||||||||
