--------------------------------------------------------------------------------------------------------------------------------------------------------------------------------------------------------
--------------------------------------------------------------------------------------------------------------------------------------------------------------------------------------------------------
--------------------------------------------------------------------------------------------------------------------------------------------------------------------------------------------------------
--------------------------------------------------------------------------------------------------------------------------------------------------------------------------------------------------------
--------------------------------------------------------------------------------------------------------------------------------------------------------------------------------------------------------
----------------S-S-------------S-----------------S-S----------------------------------S----------------------------------------------------------------------------------------------------------------
------------------------------------C-------------------------------------------------------------------------------------------------------------------------------------------------------------------
--------------------------------------------------------------------------------------------------------------------------------------------------------------------------------------------------------
--------------------------------------------------------------------------------------------------------------------------------------------------------------------------------------------------------
--------------------------------------------------------------------------------------------------------------------------------------------------------------------------------------------------------
--------------#S-------------------#S-----------U--C--------------#-#-------------------#---------------------------------------------------------------------------C-----------------------------------
--------------#--------------------#-#----------------------------#-#-------------------#---------------------------------------------------------------------------------------------------------------
--------------#------------------tt#-##---------------------------#-#-------------------#-------------------------------------------------tttt--#tttt-----tttttttttt-tttttttttttt-tttttttttttttttttttttt
k-k-k-g-k-g--g#---g---k-k-g-g-g--tt#-###gg-k-g-------gk-g-k-g-k-g-#g#gk-g-k-g--k-g-k-k-g#k-g-g-k-k-g-k-g-k-k-g-k-g-g-g-k-g-g-k-k--k-k-k-g-tttt#-#tttt-g-g-tttttttttt-ttttttttttttgtttttttttttttttttttttF
|%|%|%|%|%|%%||%%%|-%%|%|%|%|%|%%|||%|||||%|%|%%%%%%%||%|%|%|%|%|%|||||%|%|%|%%|%|%|%|%|||%|%|%|%|%|%|%|%|%|%|%|%|%|%|%|%|%|%|%|%%|%|%|%|%|||||-|||||%|%|%||||||||||%||||||||||||||||||||||||||||||||||%
|||||||||||||||||||-|||||||||||||||||||||||||||||||||||||||||||||||||||||||||||||||||||||||||||||||||||||||||||||||||||||||||||||||||||||||||||-||||||||||||||||||||||||||||||||||||||||||||||||||||||||
