--------------------------------------------------------------------------------------------------------------------------------------------------------------------------------------------------------
--------------------------------------------------------------------------------------------------------------------------------------------------------------------------------------------------------
--------------------------------------------------------------------------------------------------------------------------------------------------------------------------------------------------------
--------------------------------------------------------------------------------------------------------------------------------------------------------------------------------------------------------
--------------------------------------------------------------------------------------------------------------------------------------------------------------------------------------------------------
------------------------------------------------------------------------SS-----------------------------------------------S----------S-----------U------------SU--S-------------------------S---------S-S
------C-------------------------------------------------------------------------------------------------------------------C-------------------------------------------------------------C---------------
--------------------------------------------------------------------------------------------------------------------------------------------------------------------------------------------------------
--------------------------------------------------------------------------------------------------------------------------------------------------------------------------------------------------------
--------------------------------------------------------------------------------------------------------------------------------------------------------------------------------------------------------
-----SS-----tt---------------#------------------#C---------------------S--tt---#C---------C-------------------------------S-------S-------------C-------------C---------#---------------S---------------
------------tt--------------##tt----------------#--------------------tt---tt--##-----------------#-------------------------------------tt-------------------------------#-------------------------------
-----------#tt-------------###tt----------------#--tt----------------tt---tt-###-----------------#--------------#-----------tt---------tt-------------------------------#-------------------------------
k-g----k-g-#ttk-gg-g--k-g-####tt-g-k-g-k-g-kk-gg#--ttg-k-g-k-g-k-g-k-tt---tt-###-k-k-g-k---g-k-g-#k-g-k-g---g-#-#-----------tt---------tt--------g--ggggggggg---g-ggggg##ggggggggggggggg-ggggg-gggggg-gF
|%|%%%%|%|%||||%||%|%%|%|%||||||%|%|%|%|%|%||%|||%%|||%|%|%|%|%|%|%|%||%%%||-|||%|%|%|%|%%%|%|%|%||%|%|%|%--|-|-|---%%%--%%-||----%-%--||--%----%|--|||||||||%%%|%||||||||||||||||||||||%|||||%||||||-|%
||||||||||||||||||||||||||||||||||||||||||||||||||||||||||||||||||||||||||||-|||||||||||||||||||||||||||||--|-|-|---|||--||-||----|-|--||--|----||--|||||||||||||||||||||||||||||||||||||||||||||||||-||
