--------------------------------------------------------------------------------------------------------------------------------------------------------------------------------------------------------
--------------------------------------------------------------------------------------------------------------------------------------------------------------------------------------------------------
--------------------------------------------------------------------------------------------------------------------------------------------------------------------------------------------------------
--------------------------------------------------------------------------------------------------------------------------------------------------------------------------------------------------------
--------------------------------------------------------------------------------------------------------------------------------------------------------------------------------------------------------
-----------------------------SU-----------U---------------------------------UU--------------------------------------------------------------------------------------SSSSSSSSSSSSS--SSSSSSSSSSSSSSSSSSSSS
---------------------------------------------C-C-----------------------------------------------------------------------------------------------------------C--------------------------------------------
--------------------------------------------------------------------------------------------------------------------------------------------------------------------------------------------------------
--------------------------------------------------------------------------------------------------------------------------------------------------------------------------------------------------------
--------------------------------------------------------------------------------------------------------------------------------------------------------------------------------------------------------
------------------------------C#--C----U--C--SSS------#---------------tt-S--CC---------------------------------------------------------------#-------------S---U----------------------------------------
-------------------------------#--------#--------#---##---------------tt---------------------------------------------------------------------#----------------------------------------------------------
-------------------------------#--------#--tt----##-###---------------tt---------------------------------------------------------------------#tttttttttttt---tt-tttt-------------tt---------------------
g-g-k-kk-g-k-g-g-g-k-k-g-k--#g-#g--k-g--##-tt---k######-k-k-g--k-g-g--tt------k-g-k-g-k--k-k-g-g-g-k-g-k-g-g-g-g-k-g-k-g--g-g-g-k-g-g--k-g-g-#tttttttttttt#--tt-ttttgggggggggggggttggggggggggggggggggggF
|%|%|%||%|%|%|%|%|%|%|%|%|%%||%||%%|%|%%||%||%%%|||||||%|%|%|%%|%|%|%%||%%%-%%|%|%|%|%|%%|%|%|%|%|%|%|%|%|%|%|%|%|%|%|%|%%|%|%|%|%|%|%%|%|%|%||||||||||||||%%||%|||||||||||||||||||||||||||||||||||||||%
|||||||||||||||||||||||||||||||||||||||||||||||||||||||||||||||||||||||||||-||||||||||||||||||||||||||||||||||||||||||||||||||||||||||||||||||||||||||||||||||||||||||||||||||||||||||||||||||||||||||||
