--------------------------------------------------------------------------------------------------------------------------------------------------------------------------------------------------------
--------------------------------------------------------------------------------------------------------------------------------------------------------------------------------------------------------
--------------------------------------------------------------------------------------------------------------------------------------------------------------------------------------------------------
--------------------------------------------------------------------------------------------------------------------------------------------------------------------------------------------------------
--------------------------------------------------------------------------------------------------------------------------------------------------------------------------------------------------------
---------------------B-----U-----------------------------------B--U-----------------------B------------------BBBB--BBU-BBB-BB-BBBBBBB-BBB--BB-BB-B-BBB-BB-BB-BBBB--BB-B-BBBBB-BB---BBBBBBB-BBBBBB-BBBBBB
C----------------C--------------------------------------------------------------------------------------------------------------------------------------------------------------------------------------
--------------------------------------------------------------------------------------------------------------------------------------------------------------------------------------------------------
--------------------------------------------------------------------------------------------------------------------------------------------------------------------------------------------------------
--------------------------------------------------------------------------------------------------------------------------------------------------------------------------------------------------------
B--------#-------B------tt#C-----------U--Btt-------------------CBCBC--------------------C-----------------BB----tt--CB------B-------B---C---B----B---B--B--B--------B-B-----B----B-------B------B------
---------#-------------#tt#---------tt-----tt--------------------------------------------------------------------tt----------------------------------------------tt-------------------------------------
---------#--------#tt--#tt#---------tt-----tt------------------------#---------------------tt--------------------tt-----------------------#----------------------tt-------------tt----------------------
--k-g--k-#g-k--g--#ttg-#tt#-k-g-k-g-tt--#--ttk-gg-k-g-k-g-k-g--------#k-g--g-g-k--k-k-g-g--tt-g-k-k-g-k-g--------tt-----------------------#----------------------tt-------------tt---------------------F
XXXXXXXXXXXXXXXXXXXXXXXXXXXXXXXXXXXXXXXXXXXXXXXXXXXXXXXXXXXXXXXXXXXXXXXXXXXXXXXXXXXXXXXXXX-XXXXXXXXXXXXXXXXXXXXXXXXXXXXXXXXXXXXXXX-X-XXXXXXXXXXXXXXXXXXXXXXXXXXXXXXXXXXXXXXXXXXXXXXXXXXXXXXXXXXXXXXXXXXX
XXXXXXXXXXXXXXXXXXXXXXXXXXXXXXXXXXXXXXXXXXXXXXXXXXXXXXXXXXXXXXXXXXXXXXXXXXXXXXXXXXXXXXXXXX-XXXXXXXXXXXXXXXXXXXXXXXXXXXXXXXXXXXXXXX-X-XXXXXXXXXXXXXXXXXXXXXXXXXXXXXXXXXXXXXXXXXXXXXXXXXXXXXXXXXXXXXXXXXXX
