--------------------------------------------------------------------------------------------------------------------------------------------------------------------------------------------------------
--------------------------------------------------------------------------------------------------------------------------------------------------------------------------------------------------------
--------------------------------------------------------------------------------------------------------------------------------------------------------------------------------------------------------
--------------------------------------------------------------------------------------------------------------------------------------------------------------------------------------------------------
--------------------------------------------------------------------------------------------------------------------------------------------------------------------------------------------------------
B---B-----------------B--B---------------------------------------------------B----------B-U----------------------UB-------U--------------B--------------------------------------------------------------
----------------------------------------------------------------------------------------------------------------------------------------------------------C---------------------------------------------
--------------------------------------------------------------------------------------------------------------------------------------------------------------------------------------------------------
--------------------------------------------------------------------------------------------------------------------------------------------------------------------------------------------------------
--------------------------------------------------------------------------------------------------------------------------------------------------------------------------------------------------------
-----UU-----------B--U--B----------------------------------------------tt----------tt-tt--C----#-----------CU---#C-#------CB----------------------C---CC-CBCCC-CCCUCCCCCCCCCUCCCCCCCCCCCCCCCUCCCCCCCCCCC
--tt---------------tt-----#-----------------------------------tt-tttttttttt--------tt#tt------##---------------##--#------------------------------------------------------------------------------------
--tt---------------tt-----#-----------------------------------tt-tttttttttt-----tt-tt#tt-----###--------------###--#------------------------------------------------------------------------------------
--ttg--k-g-k-g-k#g-tt-gg-g#k-k-g-k-g-k-g-k-k-gk-g--k-g-g--k-g-tt-tttttttttt---g-tt-tt#tt---#-###g-g-k-g-k-g--####-g#---------k-g-k-------g--------------k-----g----------------------------------------F
XXXXXXXXXXXXXXXXXXXXXXXXXXXXXXXXXXXXXXXXXXXXXXXXXXXXXXXXXXXXX-XXXXXXXXXXXXX-XXX-XXXXXXXXXXXX-XXXXXXXXXXXXXXXXXXXXXXXXXXXXXXXXXXXXXXXXXXXXXXX-XXXXXXXXXXXXXXXXXXXXXXXXXXXXXXXXXXXXXXXXXXXXXXXXXXXXXXXXXXX
XXXXXXXXXXXXXXXXXXXXXXXXXXXXXXXXXXXXXXXXXXXXXXXXXXXXXXXXXXXXX-XXXXXXXXXXXXX-XXX-XXXXXXXXXXXX-XXXXXXXXXXXXXXXXXXXXXXXXXXXXXXXXXXXXXXXXXXXXXXX-XXXXXXXXXXXXXXXXXXXXXXXXXXXXXXXXXXXXXXXXXXXXXXXXXXXXXXXXXXX
