--------------------------------------------------------------------------------------------------------------------------------------------------------------------------------------------------------
--------------------------------------------------------------------------------------------------------------------------------------------------------------------------------------------------------
--------------------------------------------------------------------------------------------------------------------------------------------------------------------------------------------------------
--------------------------------------------------------------------------------------------------------------------------------------------------------------------------------------------------------
--------------------------------------------------------------------------------------------------------------------------------------------------------------------------------------------------------
U----------------------------------------------------------------------------------------------------------------------U-----------------------B----------B----------B----------------------------------
-----------------------------------------------------------------------------------------------------------CCCCCC-CCCC---CC-C---C---C-C-C--CCCC-CCC--CCCCC--CCCCC-CCC-CCCCCCCCC-CCCCCCCCCCCCCCCCCCCCCCCC
--------------------------------------------------------------------------------------------------------------------------------------------------------------------------------------------------------
--------------------------------------------------------------------------------------------------------------------------------------------------------------------------------------------------------
--------------------------------------------------------------------------------------------------------------------------------------------------------------------------------------------------------
C----------------------------------------------------------------------------------------------------------BBBBBB-BBBB-C-BB-B---B--BBBBBBB-BBBB-BBB--BBBBB--BBBBB-BBB-BBBBBBBBB-BBBBBBBBBBBBBBBBBBBBBBBB
---------------------------------------------------------------------------------------------------------------------------------tt----------------tt--------------------------#------------------------
--------------------------------------------------#--#-----------------------------------------------------------#---------#-#---tt----------------tt--------------------------#------------------------
-g-k-k-g--k-g-k-g-g-k-k-k-g--k-k-g-k-g-g-k-g-g-k#-##-#k-g-k-g-g-k-k-g-k-g-k-g--k-g--k-g-g-k-k-g-g-k-g-g-k-g------#----g-#--#-#k--tt----------------tt------------k-------------#-----------------------F
XXXXXXXXXXXXXXXXXXXXXXXXXXXXXXXXXXXXXXXXXXXXXXXXX-XX-XXXXXXXXXXXXXXXXXXXXXXXXXXXXXXXXXXXXXXXXXXXXXXXXXXXXXXXXXXXXXXXXXXXXXXXXXXXXXXXXXXXXXXXXXXXXXXXXXXXXX-XXXXXXXXXX-XXXXXXXXXXXXXXXXXXXXXXXXXXXXXXXXXX
XXXXXXXXXXXXXXXXXXXXXXXXXXXXXXXXXXXXXXXXXXXXXXXXX-XX-XXXXXXXXXXXXXXXXXXXXXXXXXXXXXXXXXXXXXXXXXXXXXXXXXXXXXXXXXXXXXXXXXXXXXXXXXXXXXXXXXXXXXXXXXXXXXXXXXXXXX-XXXXXXXXXX-XXXXXXXXXXXXXXXXXXXXXXXXXXXXXXXXXX
