--------------------------------------------------------------------------------------------------------------------------------------------------------------------------------------------------------
--------------------------------------------------------------------------------------------------------------------------------------------------------------------------------------------------------
--------------------------------------------------------------------------------------------------------------------------------------------------------------------------------------------------------
--------------------------------------------------------------------------------------------------------------------------------------------------------------------------------------------------------
--------------------------------------------------------------------------------------------------------------------------------------------------------------------------------------------------------
U---B------------------B--------U-U---------------------------------------BB----------B-----UB--------------------------B---------B---------------------------------------------------------------------
---------------------------------------------------------------------------------------C-------------------------------------------------------------------------------------C--------------------------
--------------------------------------------------------------------------------------------------------------------------------------------------------------------------------------------------------
--------------------------------------------------------------------------------------------------------------------------------------------------------------------------------------------------------
--------------------------------------------------------------------------------------------------------------------------------------------------------------------------------------------------------
C---------------------#---------CCC--B-#-----------------------------------------------B-U--C---BB---------------------------B-----------------------------------------------B--------------------------
-#----tt--------------#------------tt--#------------------------------------------------------#---------------------tt-------------#--------------------------------------------------------------------
-#----tt------------tt#------------tt--#------------------------------------tttt----------##--#--------tttttttt-tttttt---tttt-tttt-#tttt-tttt-tttttttt-tttttttttttttttttttttt-tttttttttttttttttttttttttt
-#----tt-g-g-k-g-g--tt#gk-g--------tt--#k-g-k-g-g--g-gk-g--g-g--g-k-g-k-g-g-tttt-g-g------##--#---k-g-ktttttttt-ttttttg--tttt-tttt-#tttt-ttttgttttttttktttttttttttttttttttttt-tttttttttttttttttttttttttF
XXXX--XXXXXXXXXXXXXXXXXXXXXXXXXXXXXXXXXXXXXXXXXXXXXXXXXXXXXXXXXXXXXXXXXXX-X-XXXXXXXXXXXXXXXXXXXXXXXXXXXXXXXXXXXXXXXXXXXX-XXXXXXXXXXXXXXXXXXXXXXXXXXXXXXXXXXXXXXXXXXXXXXXXXXXXXXXXXXXXXXXXXXXXXXXXXXXXXXX
XXXX--XXXXXXXXXXXXXXXXXXXXXXXXXXXXXXXXXXXXXXXXXXXXXXXXXXXXXXXXXXXXXXXXXXX-X-XXXXXXXXXXXXXXXXXXXXXXXXXXXXXXXXXXXXXXXXXXXX-XXXXXXXXXXXXXXXXXXXXXXXXXXXXXXXXXXXXXXXXXXXXXXXXXXXXXXXXXXXXXXXXXXXXXXXXXXXXXXX
