--------------------------------------------------------------------------------------------------------------------------------------------------------------------------------------------------------
--------------------------------------------------------------------------------------------------------------------------------------------------------------------------------------------------------
--------------------------------------------------------------------------------------------------------------------------------------------------------------------------------------------------------
--------------------------------------------------------------------------------------------------------------------------------------------------------------------------------------------------------
--------------------------------------------------------------------------------------------------------------------------------------------------------------------------------------------------------
-----------------U-------U-S-------------S--S----------------------S-------------------S-------------------U--------SS-S--------S---------------S-------------------------------S-----------------------
--------------------------------------------------------------------------------------------------------------C-----------------------------------------------------------------------------------------
--------------------------------------------------------------------------------------------------------------------------------------------------------------------------------------------------------
--------------------------------------------------------------------------------------------------------------------------------------------------------------------------------------------------------
--------------------------------------------------------------------------------------------------------------------------------------------------------------------------------------------------------
-tt-----------tt-Ctttt#ttC--tt------#-------------------------------UC--------------ttC-S------------------C--S---#---#--S---------------------#-C-C---------S------------------------------------#-----
#tt-----------tt--tttt#tt---tt-----##---------------#-------------------------------tt---------------------------##---#-#-######-#####-#########--#-######-#--##################-#######################
#tt-----------tt--tttt#tt---tt----###--#---#---#tt--#------------#------------------tt--------------------------###---#-#-######-###############--#-######-#--##################-#######################
#tt-k-k-g-k-g-tt#-tttt#tt-#gtt---#####-#---#-#-#tt#g#k-g-k-g-k-g-#-g---#-k-k-g--k-g-tt----g-k-g-k-g-k-k-g-k----####-gg#g#-######g###############g-#-######g#--##################-######################F
|||%|%|%|%|%|-|||%|||||||%||||-%%|||||-|%-%|-|-|||||||%|%|%|%|%|%|%|%%%|%|%|%|%%|%|%||%%%-|%|%|%|%|%|%|%|%|%%%%||||%|||||%|||||||||||||||||||||||%|%||||||||%%||||||||||||||||||%||||||||||||||||||||||%
|||||||||||||-||||||||||||||||-|||||||-||-||-|-||||||||||||||||||||||||||||||||||||||||||-||||||||||||||||||||||||||||||||||||||||||||||||||||||||||||||||||||||||||||||||||||||||||||||||||||||||||||||
