--------------------------------------------------------------------------------------------------------------------------------------------------------------------------------------------------------
--------------------------------------------------------------------------------------------------------------------------------------------------------------------------------------------------------
--------------------------------------------------------------------------------------------------------------------------------------------------------------------------------------------------------
--------------------------------------------------------------------------------------------------------------------------------------------------------------------------------------------------------
--------------------------------------------------------------------------------------------------------------------------------------------------------------------------------------------------------
--------------------------------------------------------------------------------------------------------------------------------------------------------------------------------------------------------
--------------------------------------------------------------------------------------------------------------------------------------------------------------------------------------------------------
--------------------------------------------------------------------------------------------------------------------------------------------------------------------------------------------------------
--------------------------------------------------------------------------------------------------------------------------------------------------------------------------------------------------------
--------------------------------------------------------------------------------------------------------------------------------------------------------------------------------------------------------
------------------------------------------------------#-------------------------------------------------------------------------------------------------------------------------------------------------
--------------#--------------------------------------##-------------------------------------------------------------------------------------------------------------------------------------------------
------------#-#-------------------------------------###-------------------------------------------------------------------------------------------------------------------------------------------------
g-k--g--k-g-#-#k-g-k-g-k-g-k-g-k-gk-g-k-k-g-k-g-k--####-k-k-g-k-g--k-g-g--k-g-k-g---kg-k-k-g--k-g-k-k-k-k-k-g-k-k-g-k-k-k-g-kk-k-k-kk-g-kk-k-k-k--k-g-k-g-k-g-gkk-k-k-g--k-k-g--k-g----k--k--k----k----F
|%|%%|%%|%|%|-||%|%|%|%|%|%|%|%|%||%|%|%|%|%|%|%|%%||||-|%|%|%|%|%%|%|%|%%|%|%|%|%%%||%|%|%|%%|%|%|%|%|%|%|%|%|%|%|%|%|%|%|%||%|%|%||%|%||%|%|%|%%|%|%|%|%|%|%|||%|%|%|%%|%|%|%%|%|%%%%|%%|%%|%%%%|%%%%%
|||||||||||||-|||||||||||||||||||||||||||||||||||||||||-||||||||||||||||||||||||||||||||||||||||||||||||||||||||||||||||||||||||||||||||||||||||||||||||||||||||||||||||||||||||||||||||||||||||||||||||
