--------------------------------------------------------------------------------------------------------------------------------------------------------------------------------------------------------
--------------------------------------------------------------------------------------------------------------------------------------------------------------------------------------------------------
--------------------------------------------------------------------------------------------------------------------------------------------------------------------------------------------------------
--------------------------------------------------------------------------------------------------------------------------------------------------------------------------------------------------------
--------------------------------------------------------------------------------------------------------------------------------------------------------------------------------------------------------
-----------------------------------UB------------U-------------------------------B-------------------------------------U----------B------------------------------------------B---------B----------------
-------------------------------------------------------------------------------C------------------------------------------------------------------------------------------------------------------------
--------------------------------------------------------------------------------------------------------------------------------------------------------------------------------------------------------
--------------------------------------------------------------------------------------------------------------------------------------------------------------------------------------------------------
--------------------------------------------------------------------------------------------------------------------------------------------------------------------------------------------------------
-----------------------------------C------U----CBCBC#-#-----------BBB----#--#-CB--UB---------------------tttt-tttttt-ttCtttttttttt-ttttttBtttttttttttt-tttttttttttttttttttttt-tttt--ttU-tttttttttttttttt
----------------------------------------tt----------#-#----------------tt#-##----------------------------tttt-tttttt#tt-tttttttttt-tttttt-tttttttttttt#tttttttttttttttttttttt-tttt--tt--tttttttttttttttt
----------------------------------------tt----------#-#----------------tt####----------------------------tttt-tttttt#tt-tttttttttt-tttttt-tttttttttttt#tttttttttttttttttttttt-tttt--tt--tttttttttttttttt
k-g-k-g-k--k-g-k-g--g-g-g-k--k-g-k------tt-g-k------#g#k-k-g-k-g-g-----tt####g-------kk-k-g-k-g-k-g-k-g--ttttgtttttt#tt-ttttttttttgtttttt-tttttttttttt#tttttttttttttttttttttt-ttttk-tt--tttttttttttttttF
XXXXXXXXXXXXXXXXXXXXXXXXXXXXXXXXXXXXXXXXXXXXXXXXXXXXXXXXXXXXXXXXXXXXXX-XXXXXXXXXXXXXXXXXXXXXXXXXXXXXXXXXXXXXXXXXXXXXXXXXXXXXXXXXXXXXXXXXXXXXXXXXXXXXXXXXXXXXXXXXXXXXXXXXXXXXX-XXXXXXXXXXXXXXXXXXXXXXXXXX
XXXXXXXXXXXXXXXXXXXXXXXXXXXXXXXXXXXXXXXXXXXXXXXXXXXXXXXXXXXXXXXXXXXXXX-XXXXXXXXXXXXXXXXXXXXXXXXXXXXXXXXXXXXXXXXXXXXXXXXXXXXXXXXXXXXXXXXXXXXXXXXXXXXXXXXXXXXXXXXXXXXXXXXXXXXXX-XXXXXXXXXXXXXXXXXXXXXXXXXX
