--------------------------------------------------------------------------------------------------------------------------------------------------------------------------------------------------------
--------------------------------------------------------------------------------------------------------------------------------------------------------------------------------------------------------
--------------------------------------------------------------------------------------------------------------------------------------------------------------------------------------------------------
--------------------------------------------------------------------------------------------------------------------------------------------------------------------------------------------------------
--------------------------------------------------------------------------------------------------------------------------------------------------------------------------------------------------------
--------------S--------------------SS-----S-------------UU--S--------------------S-------S------------------------S--------------S-US---S---S-----------------------------------------------------------
-------------------------------C------C---------C------------CC------------------------------------------------------------------------------------------------------C----------------------------------
--------------------------------------------------------------------------------------------------------------------------------------------------------------------------------------------------------
--------------------------------------------------------------------------------------------------------------------------------------------------------------------------------------------------------
--------------------------------------------------------------------------------------------------------------------------------------------------------------------------------------------------------
-------------C------tt---------S------S-CC--tt--SU-----UCC#--SS--ttU-#--------C---U--#-CC--------------U--#tt-U-------------C------C-SS------------------------------S------------------------------C---
------------------tttt----------------------tt--------#---#----#-tt--#---------------#-------------------##tt-------------------------------------------------------------------------------------------
------------------tttt---------------------#tt----tt--#---#----#-tt--#------#--tt--tt#--------tt--------###tt--#-----------#-tttt------#-tt--tttttttttt-tttttttttt----tttttttt-tt-tttttttttttttttttt-tt-
-g--g-k-g-g-------tttt-k-gg-g----k--gg-----#tt#---tt-g#---#-g--#-tt--#kg-k--#--tt--tt#---gk-g-tt-k-k-g--###tt--#--gg-k-k-g-#-tttt-g----#gttg-tttttttttt-ttttttttttg---tttttttt#tt-tttttttttttttttttt-ttF
%|%%|%|%|%|%%%--%-||||%|%||%|%%%%|%-||%%%%%||||%%%||-||%%%|%|%%|%||%%|||%|%%|%%||%%|||%%%||%|%||%|%|%|%%|||||-%|%%||%|%|%|%|%||||%|%%%%|||||-||||||||||%|||||||||||%%%|||||||||||-||||||||||||||||||%||%
||||||||||||||--|-|||||||||||||||||-||||||||||||||||-||||||||||||||||||||||||||||||||||||||||||||||||||||||||-||||||||||||||||||||||||||||||-||||||||||||||||||||||||||||||||||||-||||||||||||||||||||||
