--------------------------------------------------------------------------------------------------------------------------------------------------------------------------------------------------------
--------------------------------------------------------------------------------------------------------------------------------------------------------------------------------------------------------
--------------------------------------------------------------------------------------------------------------------------------------------------------------------------------------------------------
--------------------------------------------------------------------------------------------------------------------------------------------------------------------------------------------------------
--------------------------------------------------------------------------------------------------------------------------------------------------------------------------------------------------------
-----------------------------------------------B---UB--------------------------------------------------------------------------BBB------------------------B---------------UU----------------------------
-----------------------------------------------------------------------------------------------------------------------------------------------------------C--------------------------------------------
--------------------------------------------------------------------------------------------------------------------------------------------------------------------------------------------------------
--------------------------------------------------------------------------------------------------------------------------------------------------------------------------------------------------------
--------------------------------------------------------------------------------------------------------------------------------------------------------------------------------------------------------
---------------------------------------------------C-C------------------------------------------------------------------------------------------#------#---B--------------CC----------------------------
----------------------------------------tt--#-#-------------------------------------------------------------------------------------------------#------#------------------------------------------------
---------------------------------------#tt#-#-#--tt----------------------------------------------------------------------------------------tttt-#tttttt#tt--tttttttt-tt-tt---tttttttttttttttttttttttttt-
-k-g-k-g-g-g-k-k-k-g--g-k--k-g-k-g-k-g-#tt#-#-#--tt---#g-k-g-k-k-g-k-k-g-g--k-g-k-k-g-kk-k-g-g--g-g-k-k-k-gk-kk-gk-k-k-k-k-k-g-gggk-k-k-k--tttt-#tttttt#tt--tttttttt-tt-tt---ttttttttttttttttttttttttttF
XXXXXXXXXXXXXXXXXXXXXXXXXXXXXXXXXXXXXXXXXXX-X-XX-XXXXXXXXXXXXXXXXXXXXXXXXXXXXXXXXXXXXXXXXXXXXX-XXXXXXXXXXXXXXXXXXXXXXXXXXXXXXXXXXXXXXXXXXXXXXXXXXXXXXXXXXX-XXXXXXXXXXXXXXXXXXXXXXXXXXXXXXXXXXXXXXXXXXXXX
XXXXXXXXXXXXXXXXXXXXXXXXXXXXXXXXXXXXXXXXXXX-X-XX-XXXXXXXXXXXXXXXXXXXXXXXXXXXXXXXXXXXXXXXXXXXXX-XXXXXXXXXXXXXXXXXXXXXXXXXXXXXXXXXXXXXXXXXXXXXXXXXXXXXXXXXXX-XXXXXXXXXXXXXXXXXXXXXXXXXXXXXXXXXXXXXXXXXXXXX
