--------------------------------------------------------------------------------------------------------------------------------------------------------------------------------------------------------
--------------------------------------------------------------------------------------------------------------------------------------------------------------------------------------------------------
--------------------------------------------------------------------------------------------------------------------------------------------------------------------------------------------------------
--------------------------------------------------------------------------------------------------------------------------------------------------------------------------------------------------------
--------------------------------------------------------------------------------------------------------------------------------------------------------------------------------------------------------
-------------B-U-B---------------------------B-----------B----B--B--------------------------------------------------------------------B------------------U--------U-------------------------------------
---------------------------------------------------------------------------------------C--------------------------------------------------------------C---------------------------C---------------------
--------------------------------------------------------------------------------------------------------------------------------------------------------------------------------------------------------
--------------------------------------------------------------------------------------------------------------------------------------------------------------------------------------------------------
--------------------------------------------------------------------------------------------------------------------------------------------------------------------------------------------------------
------U-------BCB----------------------------------------------#-----------------------Btt-------------UUUBUU-----------B----------------ttC-B------#CB--C--------Ctt------U----B-B---------------------
----------------------------------------------tt----------tt---#------------------------tt-----------------------------------------------tt----#---##--##-#--#####-tt#-####-####-#-#####################
------------------#---------------------------tt----------tt---#------------------------tt----------------------------##-########--###-##tt---###-###--##-##-#####-tt#-####-####-#-#####################
-k-g---gk-k-g----g#g-g-g-k-g-g-k-g-k-g--k-g-k-ttk-g-k-g-g-tt---#--g-g-k-g-k-g-k-g--k-g--tt--k-g-k-k-g--------k-k-g-g-k##-########g-###-##tt-g-#######--##-########-tt#-####-####-#-####################F
XXXXXXXXXXXXXXXXXXXXXXXXXXXXXXXXXXXXXXXXXXXXX-XXXXXXXXXXX-XXX--XXXXXXXXXXXXXXXXXXXXXXXXXXXX-XXXXXXXXXXXXXXXXXXXXXXXXXXXXXXXXXXXXXXXXXX-XXXXXXXXXXXXXXXXXXXXXXXXXXXXXXX-XXXXXXXXXXXXXXXXXXXXXXXXXXXXXXXXX
XXXXXXXXXXXXXXXXXXXXXXXXXXXXXXXXXXXXXXXXXXXXX-XXXXXXXXXXX-XXX--XXXXXXXXXXXXXXXXXXXXXXXXXXXX-XXXXXXXXXXXXXXXXXXXXXXXXXXXXXXXXXXXXXXXXXX-XXXXXXXXXXXXXXXXXXXXXXXXXXXXXXX-XXXXXXXXXXXXXXXXXXXXXXXXXXXXXXXXX
