--------------------------------------------------------------------------------------------------------------------------------------------------------------------------------------------------------
--------------------------------------------------------------------------------------------------------------------------------------------------------------------------------------------------------
--------------------------------------------------------------------------------------------------------------------------------------------------------------------------------------------------------
--------------------------------------------------------------------------------------------------------------------------------------------------------------------------------------------------------
--------------------------------------------------------------------------------------------------------------------------------------------------------------------------------------------------------
------------------------U-BB------------------------------------------------------------------------------------U--B-------------------------B----------------------------------------------------------
---------------------------------------------------------------------------------------------------------------------C----------C-----------------------------------------------------------------------
--------------------------------------------------------------------------------------------------------------------------------------------------------------------------------------------------------
--------------------------------------------------------------------------------------------------------------------------------------------------------------------------------------------------------
--------------------------------------------------------------------------------------------------------------------------------------------------------------------------------------------------------
------------------------C-------------U---------------------------------#-------------------------------------CBCB---BB---------B-tt-----------U--------------tt-Utt------------------------------------
--------------------------------#---#-------------------##-------------##---------------------------------------------------------tt--------------------------tt--tt------------------------------------
--------------------------------##-##-------------------###-----------###---------------------------------------------------------tt--------------#-----------tt--tt--------------####-#--#-------------
k-k-g-g-k-k-g-k--k-k-g-----gg-k-#####--k-g-g-g-k-g-k-g-k####-g-k-g-k-g###k-g-g-k-g-k-k-g-g-k--k-g-g-k-g-k-g-g----------##g#-####-#tt###k-g-k--#-#-##g-#####g##tt#-tt##-###-######-####k##-#############F
XXXXXXXXXXXXXXXXXXXXXXXXXX-XXXXXXXXXXXXXXXXXXXXXXXXXXXXXXXXXXXXXXXXXXXXXXXXXXXXXXXXXXXXXXXXXXXXXXXXXXXXXXXXXXXXXXXX-XXXXXXXXXXXXXXXXXXXXXXXXXXXXX-XXXXXXXXXXXXXXXXXXXXXXXXXXXXXXX-XXXXXXX-XXXXXXXXXXXXXX
XXXXXXXXXXXXXXXXXXXXXXXXXX-XXXXXXXXXXXXXXXXXXXXXXXXXXXXXXXXXXXXXXXXXXXXXXXXXXXXXXXXXXXXXXXXXXXXXXXXXXXXXXXXXXXXXXXX-XXXXXXXXXXXXXXXXXXXXXXXXXXXXX-XXXXXXXXXXXXXXXXXXXXXXXXXXXXXXX-XXXXXXX-XXXXXXXXXXXXXX
