--------------------------------------------------------------------------------------------------------------------------------------------------------------------------------------------------------
--------------------------------------------------------------------------------------------------------------------------------------------------------------------------------------------------------
--------------------------------------------------------------------------------------------------------------------------------------------------------------------------------------------------------
--------------------------------------------------------------------------------------------------------------------------------------------------------------------------------------------------------
--------------------------------------------------------------------------------------------------------------------------------------------------------------------------------------------------------
--------------------------S----------S-------S------------------------------S--UU--------------S-------------S--U-S-U-----------------------------------------------------------------------------------
--------------------------------------C--------------------------------------------------------------------------C---------------C------C-------------------------------------C-------------------------
--------------------------------------------------------------------------------------------------------------------------------------------------------------------------------------------------------
--------------------------------------------------------------------------------------------------------------------------------------------------------------------------------------------------------
--------------------------------------------------------------------------------------------------------------------------------------------------------------------------------------------------------
-------#U----------tt-S-tt----------C-S----------S----------------------C----SCCC--U-------tt-----------------ttCS--C------#C-#--S------S-tt----------------------------------S-------------------------
-------#-----------tt---tt--------#----tt-------#------------------------------------------tt---##------------tt-----------#--#-----------tt------------------------------------------------------------
------##-----------tt---tt--------#----tt-------#------------------------tt#-----#---------tt-#-##------------tt-----------#--#-----------tt------------------------------------------------------------
-k-g-g##-k-g-g--g--tt---ttg-k-k-g-#----ttk-g--#-#--k-g-k-k-g--k-k-g-g-g--tt#-----#g-k-k-k-gtt-#g##k-k-gg-k-g--tt---g-ggg-gg#-g#gg-gggggg-gttgggggggggggggggggggggggggggggggggg-gggggggggggggggggg-gggggF
%|%|%|||%|%|%|%%|%%||%%%|||%|%|%|%|%%%%|||%|%%|%|%%|%|%|%|%|%%|%|%|%|%|%%|||%%%%%||%|%|%|%|||-|||||%|%||%|%|%-||%%%|%|||%|||%||||%||||||%|||||||||||||||||||||||||||||||||||||%||||||||||||||||||-|||||%
|||||||||||||||||||||||||||||||||||||||||||||||||||||||||||||||||||||||||||||||||||||||||||||-|||||||||||||||-|||||||||||||||||||||||||||||||||||||||||||||||||||||||||||||||||||||||||||||||||||-||||||
