--------------------------------------------------------------------------------------------------------------------------------------------------------------------------------------------------------
--------------------------------------------------------------------------------------------------------------------------------------------------------------------------------------------------------
--------------------------------------------------------------------------------------------------------------------------------------------------------------------------------------------------------
--------------------------------------------------------------------------------------------------------------------------------------------------------------------------------------------------------
--------------------------------------------------------------------------------------------------------------------------------------------------------------------------------------------------------
------U-----------B----------------B------B----------------------------B-------------U-BB------------------B-----------------------B-------------B------------------------------------------------------
----------------------------------------------------------------------------------------------------------------------------------------------------------------C---------------------------------------
--------------------------------------------------------------------------------------------------------------------------------------------------------------------------------------------------------
--------------------------------------------------------------------------------------------------------------------------------------------------------------------------------------------------------
--------------------------------------------------------------------------------------------------------------------------------------------------------------------------------------------------------
BU-ttBCBU#-----------------------U---U-----------------------------------------------C------------------ttB-----------------------------#-----------------U-----B---------------------------------------
---tt----#---------#----------------------------------------------------tt-----#------#--#--------------tt--tt-tt-tttttt-----tttttt-tttt#tttttttt-tttttttt-tt#tt-tttttttttttttttttttttttttttttttttttttt-
---tt----##--------#-----------#--------tt-----------tt-----------------tt-----##-----#--#--------------tt--tt-tt-tttttt-----tttttt-tttt#tttttttt-tttttttt-tt#tt-tttttttttttttttttttttttttttttttttttttt-
--#tt----##k-k-g---#k-g-k-g-k-g##------gtt-k-g-k-k-g-ttk-k-g-#g-k-g---k-tt-k-g-###----#-g#k-g-g--g-g-g-ktt--ttgtt-tttttt-g-g-tttttt-tttt#tttttttt-tttttttt-tt#tt-ttttttttttttttttttttttttttttttttttttttF
XXXXXXXXXXXXXXXXXX-XXXXXXXXXXXXXXXX--XXXXXXXXXXXXXXXXXXXXXXXXXXXXXXXXXXXXXXXXXXXXXX-XXXXXXXXXXXXXXXXXXXXXXXXXXXXXXXXXXXXXXXXXXXXXXX-XXXXXXXXXXXXXXXXXXXXXXXXXXXXXXXXXXXXXXXXXXXXXXXXXXXXXXXXXXXXXXXXXXXX
XXXXXXXXXXXXXXXXXX-XXXXXXXXXXXXXXXX--XXXXXXXXXXXXXXXXXXXXXXXXXXXXXXXXXXXXXXXXXXXXXX-XXXXXXXXXXXXXXXXXXXXXXXXXXXXXXXXXXXXXXXXXXXXXXX-XXXXXXXXXXXXXXXXXXXXXXXXXXXXXXXXXXXXXXXXXXXXXXXXXXXXXXXXXXXXXXXXXXXX
