--------------------------------------------------------------------------------------------------------------------------------------------------------------------------------------------------------
--------------------------------------------------------------------------------------------------------------------------------------------------------------------------------------------------------
--------------------------------------------------------------------------------------------------------------------------------------------------------------------------------------------------------
--------------------------------------------------------------------------------------------------------------------------------------------------------------------------------------------------------
--------------------------------------------------------------------------------------------------------------------------------------------------------------------------------------------------------
--------S-S--------------------------------------S--S----------------------S----S---S-SS---S-------------------------------------U----S----------------------S--S--SSSSS-SSSSSSSSSSSSSSSSS-SSSS-SSSSSSSS
-------------------C-----C----C-C---------------------C-------------------C--------C-C----------------------------------C-------------------------------------------------------------------------------
--------------------------------------------------------------------------------------------------------------------------------------------------------------------------------------------------------
--------------------------------------------------------------------------------------------------------------------------------------------------------------------------------------------------------
--------------------------------------------------------------------------------------------------------------------------------------------------------------------------------------------------------
---------U--------CS----US---#S-S-------------S---S---S-tt-CS------U------S----#-S-S-S----#--U----------------------#---S--------C---#----------------------------------S----------------------C--------
tt-----#-------------#tt-----#-#--#------------tt-------tt-----#---------------#----------#-------------------------#----------tt----#-------##############---##-##-------------------------------------
tt-----#---tt--------#tt--#tt#-#--##-----tt----tt-------tt-----#----tt---------#--------tt#---#-----------------tt--#tt----tttttt----#-------##############---##-##-------------------------------------
tt-k-g##g--tt-g-g---##tt--#tt#-#-g###k-k-tt-g--ttg---g-gtt----g#--g-tt-g---g---#--------tt#g--#gk-k-g-gg-k-g-g--ttg-#ttg--gtttttt-g-g#-k-g-g-##############g--##-##-----------------------k------------F
||%|%||||%%||%|%|%%%||||%%||||%|%|||||%|%||%|%%|||%%-|%|||%%%%||--|%||%|%-%|%%%|%%%%-%%%||||%%|||%|%|%||%|%|%|%%|||%||||%%|||||||%|%||%|%|%|%|||||||||||||||%%||%||%%%%%%%%%%%%%%%%%%%%%%%|%%%%%%%%%%%%%
||||||||||||||||||||||||||||||||||||||||||||||||||||-|||||||||||--|||||||-||||||||||-|||||||||||||||||||||||||||||||||||||||||||||||||||||||||||||||||||||||||||||||||||||||||||||||||||||||||||||||||||
