--------------------------------------------------------------------------------------------------------------------------------------------------------------------------------------------------------
--------------------------------------------------------------------------------------------------------------------------------------------------------------------------------------------------------
--------------------------------------------------------------------------------------------------------------------------------------------------------------------------------------------------------
--------------------------------------------------------------------------------------------------------------------------------------------------------------------------------------------------------
--------------------------------------------------------------------------------------------------------------------------------------------------------------------------------------------------------
--U---------------------B--U------------------------------------------------------------------------------------------------------------------------------------------------------------------B---------
----------------------------------C---------------------------------------------------------------------------------------------------------------------------------------------------------------------
--------------------------------------------------------------------------------------------------------------------------------------------------------------------------------------------------------
--------------------------------------------------------------------------------------------------------------------------------------------------------------------------------------------------------
--------------------------------------------------------------------------------------------------------------------------------------------------------------------------------------------------------
--C------------------------C---tt-B-----------------------------------------------------------tt-------#---U--U-------#--#---tt----#--------##-###-------###########--#-######----##--########-U########
-----------------------------tttt-------------------------------------------------------------tt-------#--------------#tt#---tt----#--------##-###-------###########tt#-######----##tt########--########
tt---------------------------tttt-------------------------------------------------------------tt-------#---------tt---#tt#-#-tt----#--------##-###-------###########tt#-######----##tt########--########
tt-k-g-k-g-k-g--k-g-k-gg-g---tttt--g-k-g-k-g-g-k-g--k-g-g-k-g-k-g-g-k-k-k-g-g-k-g-g----g-k-g--ttk-g-k-g#ggg-gg-ggttggg#tt#g#gttgggg##ggggggg##-###g-k-g-g###########tt########k-k-##tt########--#######F
XXXXXXXXXXXXXXXXXXXXXXXX-XXXXXXXXXXXXXXXXXXXXXXXXXXXXXXXXXXXXXXXXXXXXXXXXXXXXXXXXXXXX--XXXXXXXXXXXXXXXXXXXXXXXXXXXXXXXXXXXXXXXXXXXXXXXXXXXXXXX-XXXXXXXXXXXXXXXXXXXXXXXXXXXXXXXXXXXXXXXXXXXXXXXXXXXXXXXXX
XXXXXXXXXXXXXXXXXXXXXXXX-XXXXXXXXXXXXXXXXXXXXXXXXXXXXXXXXXXXXXXXXXXXXXXXXXXXXXXXXXXXX--XXXXXXXXXXXXXXXXXXXXXXXXXXXXXXXXXXXXXXXXXXXXXXXXXXXXXXX-XXXXXXXXXXXXXXXXXXXXXXXXXXXXXXXXXXXXXXXXXXXXXXXXXXXXXXXXX
