--------------------------------------------------------------------------------------------------------------------------------------------------------------------------------------------------------
--------------------------------------------------------------------------------------------------------------------------------------------------------------------------------------------------------
--------------------------------------------------------------------------------------------------------------------------------------------------------------------------------------------------------
--------------------------------------------------------------------------------------------------------------------------------------------------------------------------------------------------------
--------------------------------------------------------------------------------------------------------------------------------------------------------------------------------------------------------
-------B----------------------------------------U--------U-----U---BB------B-U----------------U--------------------------U------------------------------------------B-----------------------------------
-------------------------------------------------------C---------------------------C--------------------------------------------------------------C-----------------------------------------------------
--------------------------------------------------------------------------------------------------------------------------------------------------------------------------------------------------------
--------------------------------------------------------------------------------------------------------------------------------------------------------------------------------------------------------
--------------------------------------------------------------------------------------------------------------------------------------------------------------------------------------------------------
---------U--------------------------------------C----#-B-C-----CC-B-------B--C-----Btt##tt----C-------------tt----B--tt--C-------B----------------B--------------------------C------------------CC------
----------------------------------tt---------------tt#------------------------------tt##tt-------------tt---tt-------tttt---------------------------#---------------------------------------------------
----------#-----------------------tt-------------tttt#------------------------------tt##tt-------------tttt-tt-#-----tttt---------------------------#---------------------------------------------------
-k-g-kg---#k-g-g-k-g-k-g-g-k-g-kg-ttg-gk-g-g--g--tttt#g---k-g--------k-k-g----kk-gg-tt##tt--#g---k-g-g-tttt#tt-#-----tttt---------------------------#----g---------------------------------------------F
XXXXXXXXXXXXXXXXXXXXXXXXXXXXXXXXXXXXXXXXXXXXXXXXXXXXXXXXXXXXXXXXXXXXXXXXXXXXXXXXXXXXXXXXXXXXXXXXXXXXXXXXXXXXXX-XXXXXXXXXXXXXXXXXXXXXXXXXXXXXXXXXXXXXXXXXXXXXXXXXXXXXXXXXXXXXXXXXXXXXXXXXXXXXXXXXXXXXXXXX
XXXXXXXXXXXXXXXXXXXXXXXXXXXXXXXXXXXXXXXXXXXXXXXXXXXXXXXXXXXXXXXXXXXXXXXXXXXXXXXXXXXXXXXXXXXXXXXXXXXXXXXXXXXXXX-XXXXXXXXXXXXXXXXXXXXXXXXXXXXXXXXXXXXXXXXXXXXXXXXXXXXXXXXXXXXXXXXXXXXXXXXXXXXXXXXXXXXXXXXX
