--------------------------------------------------------------------------------------------------------------------------------------------------------------------------------------------------------
--------------------------------------------------------------------------------------------------------------------------------------------------------------------------------------------------------
--------------------------------------------------------------------------------------------------------------------------------------------------------------------------------------------------------
--------------------------------------------------------------------------------------------------------------------------------------------------------------------------------------------------------
--------------------------------------------------------------------------------------------------------------------------------------------------------------------------------------------------------
------U-------------UU-S-SUU------S--S------S---------------------------------------S------S------------------S----S-----S-----S----S---S--SSS-SSS-SSSS-SS--SS-SSSSSS-SSSSSSS------SSSSS--SSS-SSS-SSSSSS
---------------------------------C-C--------------------------C-----------------------------------------------------------C-----------------------------------------------------------------------------
--------------------------------------------------------------------------------------------------------------------------------------------------------------------------------------------------------
--------------------------------------------------------------------------------------------------------------------------------------------------------------------------------------------------------
--------------------------------------------------------------------------------------------------------------------------------------------------------------------------------------------------------
---#--C---------U--UCC#-C-CC-----S-SU--------tt---------------S------------S-C--C-tt-C---CC-----------------------#-------S----------C----S---S---C----S---S---------S-------tt--tt------S--------------
--##tt----------------#------tt------------#-tt------------#----#-----------------tt--tt------tttt----------------#---------------------------------------#------------------tttttt-----#---------------
-###tt----------------#------tttt----------#-tt---------#--#---##-----------------tt--tt----tttttt-----------#----#---------------#---tt------------------#------------------tttttt-----#----#----------
####tt-#-g-k-g---kg---#-----#tttt----g--k--#-ttk-k-g-g--#--#g--##k-k-k-g--g----k--ttg-tt----ttttttk-k-g-g-k-g#ggg-#ggg-g-g--g---g-##--tt------------------#---g--------------tttttt-----#----#---#-----F
||||||%|%|%|%|%-%||%%%|-%-%%|||||%%%%|%-|%%|%|||%|%|%|%%|%%||%%|||%|%|%|%%|%%%%|%-|||%||%%%%|||||||%|%|%|%|%|||||%||||%|%|%%|%%%|%||%%||-%%---%---%----%--|%--|------%-------||||||-----|%---|---|-----%
|||||||||||||||-|||||||-|-|||||||||||||-|||||||||||||||||||||||||||||||||||||||||-||||||||||||||||||||||||||||||||||||||||||||||||||||||-||---|---|----|--||--|------|-------||||||-----||---|---|-----|
