--------------------------------------------------------------------------------------------------------------------------------------------------------------------------------------------------------
--------------------------------------------------------------------------------------------------------------------------------------------------------------------------------------------------------
--------------------------------------------------------------------------------------------------------------------------------------------------------------------------------------------------------
--------------------------------------------------------------------------------------------------------------------------------------------------------------------------------------------------------
--------------------------------------------------------------------------------------------------------------------------------------------------------------------------------------------------------
----------------------------S--SSS--S-S------------------------------------------S---------S-S-------------------------------------------------------------S-------------------SS---SSSSSSSSSSSSSSSS----
-----------------------------------------------------------------------------------------C--------------------------------------------------------------------------------------------------------------
--------------------------------------------------------------------------------------------------------------------------------------------------------------------------------------------------------
--------------------------------------------------------------------------------------------------------------------------------------------------------------------------------------------------------
--------------------------------------------------------------------------------------------------------------------------------------------------------------------------------------------------------
---------------------------U--S---tt----------------------------S---------------U--------S--C-S--tt---------------------------------------------------------#--------------------Utt----------------####
----------------------------------tt-------------------------------#tt--tt#---------------------#tt---------------------------------------------------------#---------------------tt----------------####
----------------------------------tt-----------------------------#-#tt#-tt#---------------------#tt---------------------------------------------------------#---------------------tt----------------####
#k-k-k-g--k-g-g-g-gk-k-g----g----gtt--gk-g-k-g-k-g-g-k-g-g-k-g-g-#-#tt##tt#-g-gk---g-g----#----##tt-g-k-g-g-k-g-g--k-g-g--k-k--g-g-g-g---k-g--k-k-g-k-k-g---#--g--g------g-g-g-gg-ttgggggggggg-ggggg###F
||%|%|%|%%|%|%|%|%||%|%|%%%%|%%--|||-%||%|%|%|%|%|%|%|%|%|%|%|%|%|-||||||||-|%||%%%|%|%%%%|-%%%||||%|%|%|%|%|%|%|%%|%|%|%%|%|%%|%|%|%|%%%|%|%%|%|%|%|%|%|%%-|-%|%%|%%%--%|%|%|%||%||||||||||||-||||||||%
|||||||||||||||||||||||||||||||--|||-|||||||||||||||||||||||||||||-||||||||-|||||||||||||||-|||||||||||||||||||||||||||||||||||||||||||||||||||||||||||||||-|-||||||||--||||||||||||||||||||||-|||||||||
