--------------------------------------------------------------------------------------------------------------------------------------------------------------------------------------------------------
--------------------------------------------------------------------------------------------------------------------------------------------------------------------------------------------------------
--------------------------------------------------------------------------------------------------------------------------------------------------------------------------------------------------------
--------------------------------------------------------------------------------------------------------------------------------------------------------------------------------------------------------
--------------------------------------------------------------------------------------------------------------------------------------------------------------------------------------------------------
--------------------------------------------------U--------------SS--S---------------------------------------------------------------------S------------------------------S-S-----------S---------------
-----------------------------------------------------------------------------------------------------------------------------------------------------C--------------------------------------------------
--------------------------------------------------------------------------------------------------------------------------------------------------------------------------------------------------------
--------------------------------------------------------------------------------------------------------------------------------------------------------------------------------------------------------
--------------------------------------------------------------------------------------------------------------------------------------------------------------------------------------------------------
-tt-ttC-----------------------------------------C-C-C--------------US---------#-------S---------------------------UUUCUUU--UUUUU-UU--UU--UU-UUUUU-U-USUU-UUUUUUUUUU--U-UUU-U-UCCCCUCUUUU-UUUUUUUSUUUUUUU
-tt-tt-------------------------------------------------------------------tt--##--------------------------------------------------------tt---------------------------------------------------------------
-tt-tt------------------------------------------------#-tt-------------tttt-###----------------------------------------------------tt--tt--------------------------#------------------------------------
-tt-tt-g-k-gk-g-k-g-k-g-k-g-k-g-k-k-g--k-g-g-k-g------#-ttk-k-g--g-----tttt####ggk-g-#-k-k-k-g-k-g-k-g-k-k-g---k-g--------------k--tt--tt--------g-----------------#--g--------------------------------F
%||%||%|%|%||%|%|%|%|%|%|%|%|%|%|%|%|%%|%|%|%|%|%%%%%%|%|||%|%|%%|%%%-%|||||||||||%|%|%|%|%|%|%|%|%|%|%|%|%|%%%|%|%%%%%%%%-%%%%%|%%||%%||%%-%%%%%|%-%%%%%%%%%%%%%%%|-%|%%%%%%%%%%%%%%%%%-%%%%%%%%%%%%%%%
|||||||||||||||||||||||||||||||||||||||||||||||||||||||||||||||||||||-||||||||||||||||||||||||||||||||||||||||||||||||||||-||||||||||||||||-|||||||-||||||||||||||||-|||||||||||||||||||-|||||||||||||||
