--------------------------------------------------------------------------------------------------------------------------------------------------------------------------------------------------------
--------------------------------------------------------------------------------------------------------------------------------------------------------------------------------------------------------
--------------------------------------------------------------------------------------------------------------------------------------------------------------------------------------------------------
--------------------------------------------------------------------------------------------------------------------------------------------------------------------------------------------------------
--------------------------------------------------------------------------------------------------------------------------------------------------------------------------------------------------------
----------------------------U-----------S-----S-----------------------------------U-----------------------------S---------------------------------------------------------S---------S-------------------
------------------------------------------------------------------------------------------------------------------------------------------------------------------C-------------------------------------
--------------------------------------------------------------------------------------------------------------------------------------------------------------------------------------------------------
--------------------------------------------------------------------------------------------------------------------------------------------------------------------------------------------------------
--------------------------------------------------------------------------------------------------------------------------------------------------------------------------------------------------------
-----------C--------------C-C----------#----------------------S-------------------C----U-----tttt-----------------------------------------------------------------S------------------S------------------
-------------tt------------------#-----#---tt----------------------------------------tt----tttttt---------------------------------------------------------------------------#---------------------------
-------------tt----------------#-#-----#---tt----------------#---------------------tttt----tttttt---------------------------------------------------------------------------#---------------------------
k-k-g-k-g-g-#tt-k-g-k--k-g----g#-#k-g--#gk-tt-gk-k--k-g-k-k-g#-k-g-g-g-k-g-k-g-k-g-tttt-g--ttttttk-g-g-k-k-kk-kk-k-g-k-k-g-k-k-kk-k-k-k-kk-k-kk-kk-k-k-k-k-k-k-k-g-k#####g-#####g##---#################F
|%|%|%|%|%|%|||%|%|%|%%|%|%%%%||-||%|%%|||-||-||%|%%|%|%|%|%||%|%|%|%|%|%|%|%|%|%|%||||%|%%|||||||%|%|%|%|%||%||-|%|%|%|%|%|%|%||%|%|%|%||%|%||%||%|%|%|%|%|%|%|%|%|||||||%||||||||%-%|||||||||||||||||%
||||||||||||||||||||||||||||||||-|||||||||-||-||||||||||||||||||||||||||||||||||||||||||||||||||||||||||||||||||-|||||||||||||||||||||||||||||||||||||||||||||||||||||||||||||||||||-|||||||||||||||||||
