--------------------------------------------------------------------------------------------------------------------------------------------------------------------------------------------------------
--------------------------------------------------------------------------------------------------------------------------------------------------------------------------------------------------------
--------------------------------------------------------------------------------------------------------------------------------------------------------------------------------------------------------
--------------------------------------------------------------------------------------------------------------------------------------------------------------------------------------------------------
--------------------------------------------------------------------------------------------------------------------------------------------------------------------------------------------------------
-UU----------------------------------------------------------B--B-----------------BB-----------------------------B---B----U-----------------------------------------------------------------------------
--------------------------------------------------------C--------------------------------------------------------------------------C--------------------------------------------------------------------
--------------------------------------------------------------------------------------------------------------------------------------------------------------------------------------------------------
--------------------------------------------------------------------------------------------------------------------------------------------------------------------------------------------------------
--------------------------------------------------------------------------------------------------------------------------------------------------------------------------------------------------------
UCC--------------------------------------tt-------------B---U--C---U----------B-CB----------------------------------C---U-CB-B-----B--------B---------------------B-------#-----------------------------
-----------------------------------------tt--------------tt------------------------------------------------------------------------------------tt-----------#-------------#----tt-----------------------
-------------------#-----tt--------------tt--------------tt------#----------------------------#---------tt-------------------------------------tt-----------#-------------#----tt-----------------------
----g-kk-k-g-k-g---#-k-g-tt-k-g-k-g--g-g-tt-k-g--g-k-g---tt#--k--#g--k-k-g-g--------k-g-k-g#--#-g-k-g-k-tt-----g-------#-g---------------------tt-----------#----------g-k#-#-#tt##########g###########F
XXX-XXXXXXXXXXXXXXXX-XXXXXXXXXXXXXXXXXXXXXXXXXXXXXXXXXX-XXXXXXXX-XXXXXXXXXXXXXXXXX--XXXXXXXXXXXXXXXXXXXXXXXXXXXXX-XXXXXXXXXXXXXXXXXXXXXXXX-XXXXXXXXXXXXXXXXXXXXXXXXXXXXXXXXXXXXXXXXXXXXXXXXXXXXXXXXXXXXX
XXX-XXXXXXXXXXXXXXXX-XXXXXXXXXXXXXXXXXXXXXXXXXXXXXXXXXX-XXXXXXXX-XXXXXXXXXXXXXXXXX--XXXXXXXXXXXXXXXXXXXXXXXXXXXXX-XXXXXXXXXXXXXXXXXXXXXXXX-XXXXXXXXXXXXXXXXXXXXXXXXXXXXXXXXXXXXXXXXXXXXXXXXXXXXXXXXXXXXX
