--------------------------------------------------------------------------------------------------------------------------------------------------------------------------------------------------------
--------------------------------------------------------------------------------------------------------------------------------------------------------------------------------------------------------
--------------------------------------------------------------------------------------------------------------------------------------------------------------------------------------------------------
--------------------------------------------------------------------------------------------------------------------------------------------------------------------------------------------------------
--------------------------------------------------------------------------------------------------------------------------------------------------------------------------------------------------------
------------B-------B------------------------B---U--------------U-------BB---------------------------------B------------U-------------------------------------------------------------------------------
C----C----------------------------------------C---------C-----------------C-----------------------------------------C------------------------------C----------------------------------------------------
--------------------------------------------------------------------------------------------------------------------------------------------------------------------------------------------------------
--------------------------------------------------------------------------------------------------------------------------------------------------------------------------------------------------------
--------------------------------------------------------------------------------------------------------------------------------------------------------------------------------------------------------
B-tt#B#-----------C#-----------------#--------BU-CB--#-UB---B--CC-U-------B--------------C----------------U---tttt-#B---C-B-B-BBBB-BB-C--BBBBB-B--BBBBB---BBBB-BBBB--BBBB-B-BBB-BBBBBBBBBBBBBBBBBBBBBBBB
--tt#-#tt----#-----#--------------#--#-------------tt#--------------tttt--------------------------------------tttt-#------------------------------------------------------------------------------------
--tt#-#tt----#-----#-tt----tttt---#tt#----------#--tt#-----#--------tttt------------------#-------------------tttt-#-------------------tt-------tt------------------#-----------------------------------
--tt#-#tt-#--#-k-g-#-tt-g-gtttt-k-#tt#k-g-gg----#--tt#g--#-#-#g--g--ttttg--ggg-k-g-k-g-k--#g-k-k-k-k-g-g-k--k-tttt-#-k-g-------------k-tt-------tt-------#----------#----------------------------------F
XXXXXXXXXXXXXXXXXXXXXXXXXXXXXXXXXXXXXXXXXXXXX-XXXXXXXXXXXX-XXXXXXXXXXXXXXXXXXXXXXXXXXXXXXXXXXXXXXXXXXXXXXXX-XXXXXX-XXXXXX-XXXXXXXXXXXXXXXXXXXXXXXXXXXXXXXXXXXXXXXXXXXXXXXXXXXXXXXXXXXXXXXXXXXXXXXXXXXXXX
XXXXXXXXXXXXXXXXXXXXXXXXXXXXXXXXXXXXXXXXXXXXX-XXXXXXXXXXXX-XXXXXXXXXXXXXXXXXXXXXXXXXXXXXXXXXXXXXXXXXXXXXXXX-XXXXXX-XXXXXX-XXXXXXXXXXXXXXXXXXXXXXXXXXXXXXXXXXXXXXXXXXXXXXXXXXXXXXXXXXXXXXXXXXXXXXXXXXXXXX
