--------------------------------------------------------------------------------------------------------------------------------------------------------------------------------------------------------
--------------------------------------------------------------------------------------------------------------------------------------------------------------------------------------------------------
--------------------------------------------------------------------------------------------------------------------------------------------------------------------------------------------------------
--------------------------------------------------------------------------------------------------------------------------------------------------------------------------------------------------------
--------------------------------------------------------------------------------------------------------------------------------------------------------------------------------------------------------
--U-----------------------------------------BB--------------------B-------------------B---------------------------------BU-----B---B---------B----------------------------------------------------------
C-----------------------------------------------------------------------------------------------------------------------------------------------------------C-------------------------------------------
--------------------------------------------------------------------------------------------------------------------------------------------------------------------------------------------------------
--------------------------------------------------------------------------------------------------------------------------------------------------------------------------------------------------------
--------------------------------------------------------------------------------------------------------------------------------------------------------------------------------------------------------
B-C-B----tt---------------#------------#---------------tt------ttC-#-tt----------------#tt--tt---------tttt--------------C----------------#-----------------B-------------------------------------------
---------tt---------------#-------#---##--tt-----------tt#----#tt--#-tt-----------tt---#tt--tt---#-----tttt-------------------------------#----------------------#--------------------------------------
---------tt---------------#-------##-###--tt--tt-------tt#---##tt--#-tt-----------tttt-#tttttt#--#-----tttt--------------------------tt---#-----#--tt------------#--------------------------------------
-----#--kttg-k-k-k-g-k-g--#-gk-g--#######-tt-gtt-g-k-g-tt#gg###tt--##tt-kk-k-g----ttttg#tttttt#--#g-k--ttttk-gg-k-g------------------ttk--#-----#--tt------------#-------------------------------------F
XXXXXXXXXXXXXXXXXXXXXXXXXXXXXXXXX-XXXXXXXXXXXXXXXXXXXXXXXXXXXXXXXX-XXXX-XXXXXXXX--XXXXXXXXXXXXXXXXXXXXXXXXXXXXXXXXXXXXXXXXXXXXX-XXX-XXXXXXXXX-XXXXXXXXXXXXXXXXXXXXXXXXXXXXXXXXXXXXXXXXXXXXXXXXXXXXXXXXXX
XXXXXXXXXXXXXXXXXXXXXXXXXXXXXXXXX-XXXXXXXXXXXXXXXXXXXXXXXXXXXXXXXX-XXXX-XXXXXXXX--XXXXXXXXXXXXXXXXXXXXXXXXXXXXXXXXXXXXXXXXXXXXX-XXX-XXXXXXXXX-XXXXXXXXXXXXXXXXXXXXXXXXXXXXXXXXXXXXXXXXXXXXXXXXXXXXXXXXXX
