--------------------------------------------------------------------------------------------------------------------------------------------------------------------------------------------------------
--------------------------------------------------------------------------------------------------------------------------------------------------------------------------------------------------------
--------------------------------------------------------------------------------------------------------------------------------------------------------------------------------------------------------
--------------------------------------------------------------------------------------------------------------------------------------------------------------------------------------------------------
--------------------------------------------------------------------------------------------------------------------------------------------------------------------------------------------------------
----------------------------------BB-U-----B---B-B---BB--BB-U--------------------------------------------------U------BB----------------------------------------------B---B-----------------------------
--------------------------------------------C----------------------C-----------------------------------------------------------------------------C------------------------------------------------------
--------------------------------------------------------------------------------------------------------------------------------------------------------------------------------------------------------
--------------------------------------------------------------------------------------------------------------------------------------------------------------------------------------------------------
--------------------------------------------------------------------------------------------------------------------------------------------------------------------------------------------------------
-------------------------------------CC---#-B-----#-B-------C------BB-------------------------------------B-U--C-tt-tt---------------------------B------------------------------------------------------
#---------------------------#--tt------tt-#-------#----tt------------tt---------#--------------------------------tt-tt------------------------------------------tttttt-tt-------------------------------
#---------------------------##-tt------tt-#-------#----tt------------tt-tt----#-##-------------------------------tt-tt---------------------tt-#-----------------tttttt-tt-------------------------------
#g-k-g--k-g-k-g-g-g-g-g-k-g-###tt#--k--ttg#g--g---#----tt--k--k-g-g--tt-tt-k-g#-##k-g-k-g-k-g---k-g-g-k-g-----g--ttgtt-------------#---#---tt-#-g-------g-------tttttt-tt------------------------------F
XXXXXXXXXXXXXXXXXXXXXXXXXXXXXXXXXX-XXXXXXXXXXXXXX-XXX--XXXXXXXXXXXXXXXX-XXXXXXX-XXXXXXXXXXXXXXXXXXXXXXXXXXXXXXXXXXXXXX--XXXXXXXXXXXXXXXXXXXXXXXXXXXXXXXXXXXXXXXXXXXXXXXXXXXX-XXXXXXXXXXXXXXXXXXXXXXXXXXX
XXXXXXXXXXXXXXXXXXXXXXXXXXXXXXXXXX-XXXXXXXXXXXXXX-XXX--XXXXXXXXXXXXXXXX-XXXXXXX-XXXXXXXXXXXXXXXXXXXXXXXXXXXXXXXXXXXXXX--XXXXXXXXXXXXXXXXXXXXXXXXXXXXXXXXXXXXXXXXXXXXXXXXXXXX-XXXXXXXXXXXXXXXXXXXXXXXXXXX
