--------------------------------------------------------------------------------------------------------------------------------------------------------------------------------------------------------
--------------------------------------------------------------------------------------------------------------------------------------------------------------------------------------------------------
--------------------------------------------------------------------------------------------------------------------------------------------------------------------------------------------------------
--------------------------------------------------------------------------------------------------------------------------------------------------------------------------------------------------------
--------------------------------------------------------------------------------------------------------------------------------------------------------------------------------------------------------
-------------------------B-----------------------------U--------------U--B---B----------BBB-----------------------B----------------------B--------------------------------------------------------------
C--------------------------------------------------------C----------------C-----------------------------------------------C-C---------------------------------------------------------------------------
--------------------------------------------------------------------------------------------------------------------------------------------------------------------------------------------------------
--------------------------------------------------------------------------------------------------------------------------------------------------------------------------------------------------------
--------------------------------------------------------------------------------------------------------------------------------------------------------------------------------------------------------
BU-----------#U-B---B-Utt-#tt--------------------------C-B------------C---Btt-C--------B----------------------------C-tt--B#B######--###--######-#B--######-##U#################-#######-###############
-------------#---tt----tt-#tttt----------------------------------------tt--tt--------------------------tt-------------tt---#-######--####-########---######-##-#################-#######-###############
-------------#---tt----tt-#tttt----------------------------------------tt--tt--------------------------tt-------------tt-#-#-######--####-########-tt######-##-#################-#######################
--g-k-g-k-g--#-g-tt--g-tt-#ttttk-g--k-g-k-g-k-k-k-g-g---g--k-g-k-g-k-g-tt--ttg--g---g-g----k-k-gk-k-g-kttg-k-g-g-g-g--tt-#-#-######k-####-########-tt######-##-#################-######################F
XXXXXXXXXXXXXXXXXXXXXXXXX-XXXXXXXXXXXXXXXXXXXXXXXXXXXXXXXXXXXXXXXXXX-XXXXXXXXXXXXXX-XXXX---XXXXXXXXXXXXXXXXXXXXXXXXXXXXX-XXXXXXXXXXXXXXXXXXXXXXXXXXXXXXXXXXXXXXXXXXXXXXXXXXXXXXXXXXXXXXXXXXXXXXXXXXXXXXX
XXXXXXXXXXXXXXXXXXXXXXXXX-XXXXXXXXXXXXXXXXXXXXXXXXXXXXXXXXXXXXXXXXXX-XXXXXXXXXXXXXX-XXXX---XXXXXXXXXXXXXXXXXXXXXXXXXXXXX-XXXXXXXXXXXXXXXXXXXXXXXXXXXXXXXXXXXXXXXXXXXXXXXXXXXXXXXXXXXXXXXXXXXXXXXXXXXXXXX
