--------------------------------------------------------------------------------------------------------------------------------------------------------------------------------------------------------
--------------------------------------------------------------------------------------------------------------------------------------------------------------------------------------------------------
--------------------------------------------------------------------------------------------------------------------------------------------------------------------------------------------------------
--------------------------------------------------------------------------------------------------------------------------------------------------------------------------------------------------------
--------------------------------------------------------------------------------------------------------------------------------------------------------------------------------------------------------
B-------BB---------------B--------------------------------------BB--BB---------UB--------B-----------------------U------------BBBB-BBBBBBB-BBBBBBB-BBB-BU-BBBBBBBBB-B--B--B--B--------------------------
---------------------------------------C---------------CC------------------------------------C------------------C---------------------------------------------------------------------------------------
--------------------------------------------------------------------------------------------------------------------------------------------------------------------------------------------------------
--------------------------------------------------------------------------------------------------------------------------------------------------------------------------------------------------------
--------------------------------------------------------------------------------------------------------------------------------------------------------------------------------------------------------
------tt--Ctt-ttU-------C--------CB---#B------------#--BB---------tt-----------C-----------C-B-#----------------BC---------ttU----C-------#-------C-----C---------------------tt------------------------
------tt---tt-tt----tt---------------##------------##-------------tt--------------#tt--tt------#---------------------#-----tt-------------#--------------#-----------tt-tt-tt-tttttttttttttttttttttt-tt-
------tt---tt-tt--tttt--------------###------------##-------------tt--------------#tt--tt-----##------------------tt-#tt---tt-------------#--------------#-----------tt-tt-tt-tttttttttttttttttttttt-tt-
--k-g-tt---tt-tt--tttt-#--g-k-g----####-k-k-g-k-g-g##g#--k#-g-g-g-tt--#k-k-g-k--gg#tt--ttg----##k-g-k-g-k-gk-g----tt##tt-g-tt-gg-g-ggggggg#ggggggg-ggggg-#ggggggggg#gttgttgttgttttttttttttttttttttttgttF
XXXXXXXX--XXXXXXXXXXXXXXX-XXXXXXXXXXXXXXXXXXXXXXXXXXXXXXXXXXX-XXXXXX-XXXXXXXXXXXXXXXXXXXXXXXXXXXXXXXXXXXXXXXXXXXXXXXXXXXXXXXXXXXXXXXXXXXXXXXXXXXXXXXXXXXXXXXXXXXXXXXXXXXXXXXXXXXXXXXXXXXXXXXXXXXXXXXXXXX
XXXXXXXX--XXXXXXXXXXXXXXX-XXXXXXXXXXXXXXXXXXXXXXXXXXXXXXXXXXX-XXXXXX-XXXXXXXXXXXXXXXXXXXXXXXXXXXXXXXXXXXXXXXXXXXXXXXXXXXXXXXXXXXXXXXXXXXXXXXXXXXXXXXXXXXXXXXXXXXXXXXXXXXXXXXXXXXXXXXXXXXXXXXXXXXXXXXXXXX
