--------------------------------------------------------------------------------------------------------------------------------------------------------------------------------------------------------
--------------------------------------------------------------------------------------------------------------------------------------------------------------------------------------------------------
--------------------------------------------------------------------------------------------------------------------------------------------------------------------------------------------------------
--------------------------------------------------------------------------------------------------------------------------------------------------------------------------------------------------------
--------------------------------------------------------------------------------------------------------------------------------------------------------------------------------------------------------
----S-----------------------------------S--------S----------------------------S-----------U--S--S-------------------------------------------------------------------------------------------------------
--------------------------------------------------------------------------------------------------------------------------------------------------------------------------------------------------------
--------------------------------------------------------------------------------------------------------------------------------------------------------------------------------------------------------
--------------------------------------------------------------------------------------------------------------------------------------------------------------------------------------------------------
--------------------------------------------------------------------------------------------------------------------------------------------------------------------------------------------------------
--SS---------------------------U----------U---------Ctt----------------------U------------CU-----#-------------------------C-C--------------------------------------------------------------------------
-----------------------------------------------------tt-------------------------------------#----#------------------------------------------------------------------------------------------------------
#-----------------------------#----------#-----------tt----------#--------#-----------------#-tt-#------------------------------------------------------------------------------------------------------
#----k-g-k-g-k-g-k-g---k-g-g--#-g-k-k-g--#-g-k-g--g--ttgk-g-k-g-g#k-g-k---#k---#gk-g-k-g-g--#-tt-#k-g-g-g-gg-k-g-g-gg-k-g-g-g-gg-k-g-g-g-g-g-g-gg-g-g-g-g-ggg-g-g-g-g-ggggggggg-ggggg-g-gggg-g---g-g-ggF
|%%%%|%|%|%|%|%|%|%|%%%|%|%|%%|%|%|%|%|%%|%|%|%|%-|-%||||%|%|%|%|||%|%|%%%||%%-|||%|%|%|%|%%|-||-||%|%|%|%||%|%|%|%||%|%|%|%|%||%|%|%|%|%|%|%|%||%|%|%|%|%|||%|%|%|%|%|||||||||%|||||%|%||||%|%%%|%|%||%
|||||||||||||||||||||||||||||||||||||||||||||||||-|-||||||||||||||||||||||||||-||||||||||||||-||-|||||||||||||||||||||||||||||||||||||||||||||||||||||||||||||||||||||||||||||||||||||||||||||||||||||||
