--------------------------------------------------------------------------------------------------------------------------------------------------------------------------------------------------------
--------------------------------------------------------------------------------------------------------------------------------------------------------------------------------------------------------
--------------------------------------------------------------------------------------------------------------------------------------------------------------------------------------------------------
--------------------------------------------------------------------------------------------------------------------------------------------------------------------------------------------------------
--------------------------------------------------------------------------------------------------------------------------------------------------------------------------------------------------------
------S----U---SSU----SS-------------------S----------------S-----------------------SS----------------------------------------------------------------------------------------------S-------------------
--------------------------------------------------------------------------------------------------------C-C-C-C-C-C-C-CCCC----CCCCCC-CCCCCCCCCCC-C-CCCC-CC--CC-CCCCCC----CCCC-CCCCCC-CCC--CCCCCCCCCCCCCC
--------------------------------------------------------------------------------------------------------------------------------------------------------------------------------------------------------
--------------------------------------------------------------------------------------------------------------------------------------------------------------------------------------------------------
--------------------------------------------------------------------------------------------------------------------------------------------------------------------------------------------------------
----tt--ttUC-----C---S---tt-----#-----------------------------------------------------#--#tt-S--#------SSSSSSSSSSSSSSSSSSS-ttUSSSSSS-SSSSSSSSSSSSSSSSSS-SS--SS-SSSSSS----SSSS-SSSSSS-SSS--SSSSSSSSSSSSSS
----tt--tt---------------tt-----#-----------#-------------#---------------------------#--#tt----#--------------------------tt-----------------------------tt--------------------------------------------
tt--tt--tt---tt----------tt-----#-----------##--#------tt-#---------------------------#--#tt--tt#--------------------------tt-----------------------------tt----------------------------tt--------------
tt--tt--tt---ttg--g-g----ttk-g--#gg-k-g-k-gg###-#k-k-g-tt-#-gg-k-g-k-g--k-g--k-g-g---g#--#tt--tt#g-k-g---------------------tt-----------------------------tt--#------k-g------------g---tt-------------F
||%%||%%||%%%|||-%|%|%---|||%|%%|||%|%|%|%|||||-||%|%|%||-|%||%|%|%|%|%%|%|%%|%|%|%%%||%%|||%%||||%|%|%%%%%%%%%%%%%%%%%%%%-||%%%%%%%%%%%%%%%%%%%%%%%%%%-%%||%%|%%%%%%|%|%%%%%%%%%%%%|%%%||%%%%%%%%%%%%%%
||||||||||||||||-|||||---||||||||||||||||||||||-|||||||||-||||||||||||||||||||||||||||||||||||||||||||||||||||||||||||||||-||||||||||||||||||||||||||||-||||||||||||||||||||||||||||||||||||||||||||||||
