--------------------------------------------------------------------------------------------------------------------------------------------------------------------------------------------------------
--------------------------------------------------------------------------------------------------------------------------------------------------------------------------------------------------------
--------------------------------------------------------------------------------------------------------------------------------------------------------------------------------------------------------
--------------------------------------------------------------------------------------------------------------------------------------------------------------------------------------------------------
--------------------------------------------------------------------------------------------------------------------------------------------------------------------------------------------------------
-----------------B--B-------------------------U-BB--------UB---B--------U-BB-----------------------------------------------------B-------------------------------B---------------------UU---------------
-------------------------------------------------------------------------------------------------------------------C------------------------------------------------------------------------------------
--------------------------------------------------------------------------------------------------------------------------------------------------------------------------------------------------------
--------------------------------------------------------------------------------------------------------------------------------------------------------------------------------------------------------
--------------------------------------------------------------------------------------------------------------------------------------------------------------------------------------------------------
----C-----------------#---#----C-#------------C-------tt--C---C-------CBCB-----tt--B-----------------------------U-B-----CUCCCC-C-CCCC---CCCC-UCCCCCCC-CCCUCCCCCC--CCC--UCCCCUCCCCCC-CCCCCCCCCCCCCCCCCCC
tttt-----------tt-----#--##--#---#----------tt-----tt-tt-----#---tt---------tt-tt---------------------------#--------tttt-------------#-----------------------------------------------------------------
tttt-----------tt-tt--#-###tt#---#----------tt-----tt-tttt---#---tt-tt------tt#tt---------------------------#--------tttt-------------##----------------------------------------------------------------
tttt-k-g-k-g-k-ttgtt--#k###tt##-g#g-g-k-g--#tt-ggg#tt#tttt-g##-g-tt-tt------tt#tt---k-g--k-g-g-k-g-k-gg-k-g-#-k-g-g--tttt-------------###------------------------gg---#--------------------------------F
XXXXXXXXXXXXXXXXXXXX-XXXXXXXXXXXXXXXXXXXXXXXXXXXXXXXXXXXXXXXXXXX-XXXXXXXXXXXXXXXXX-XXXXXXXXXXXXXXXXXXXXXXXXXXXXXXXXXXXXXXXXXXXXXX-XXXXXXXXXXX-XXXXXXXX-XXXXXXXXXXXXXXXXXXXXXXXXXXXXXXXXXXXXXXXXXXXXXXXXX
XXXXXXXXXXXXXXXXXXXX-XXXXXXXXXXXXXXXXXXXXXXXXXXXXXXXXXXXXXXXXXXX-XXXXXXXXXXXXXXXXX-XXXXXXXXXXXXXXXXXXXXXXXXXXXXXXXXXXXXXXXXXXXXXX-XXXXXXXXXXX-XXXXXXXX-XXXXXXXXXXXXXXXXXXXXXXXXXXXXXXXXXXXXXXXXXXXXXXXXX
