--------------------------------------------------------------------------------------------------------------------------------------------------------------------------------------------------------
--------------------------------------------------------------------------------------------------------------------------------------------------------------------------------------------------------
--------------------------------------------------------------------------------------------------------------------------------------------------------------------------------------------------------
--------------------------------------------------------------------------------------------------------------------------------------------------------------------------------------------------------
--------------------------------------------------------------------------------------------------------------------------------------------------------------------------------------------------------
-----S------------------------------------------------------------S---U---------------------------------------------------S----------------------------------------------------------------------S------
--------------------------------------------------------C-----------------------------------------------------------------------------------------------------------------------------------------------
--------------------------------------------------------------------------------------------------------------------------------------------------------------------------------------------------------
--------------------------------------------------------------------------------------------------------------------------------------------------------------------------------------------------------
--------------------------------------------------------------------------------------------------------------------------------------------------------------------------------------------------------
---tt-----#---------------------------------------------S-----------CSCS----S--tttttt-------------------------U-UU------S-------------------------------------------------------------------------------
---tt-tt--#------------------------------------------------------------------tttttttt------------------------------------------tt----#----------------#---------tt--------------------------------------
-#-tt-tt--#------------------------------------------------------------------tttttttt----------------------------------#-------tt----#---#------------#---------tt--------------------------------------
-#-ttgttgg#k-g-g-g-gk-k-g-k-k-g-k-g-k-g-kk-k-g--k--k-g-g-k-k-g-k-#------k-g--ttttttttk-g-k-g-g--k-g-g-k------g----k-g-g#-------tt----#---#g--k--------#--#------tt------------------------k------------F
%|-|||||||||%|%|%|%||%|%|%|%|%|%|%|%|%|%||%|%|%%|%%|%|%|%|%|%|%|%|%%%%%%|%|%%|||||||||%|%|%|%|%%|%|%|%|%%%%%%|%%%%|%|%||%%%%%%%||%%%%|%%%||%%|%%%%%%%%|%%|%%%%%%||%%%%%%%%%%%%%%%%%%%%%%%%|%%%%%%%%%%%%%
||-|||||||||||||||||||||||||||||||||||||||||||||||||||||||||||||||||||||||||||||||||||||||||||||||||||||||||||||||||||||||||||||||||||||||||||||||||||||||||||||||||||||||||||||||||||||||||||||||||||||
