--------------------------------------------------------------------------------------------------------------------------------------------------------------------------------------------------------
--------------------------------------------------------------------------------------------------------------------------------------------------------------------------------------------------------
--------------------------------------------------------------------------------------------------------------------------------------------------------------------------------------------------------
--------------------------------------------------------------------------------------------------------------------------------------------------------------------------------------------------------
--------------------------------------------------------------------------------------------------------------------------------------------------------------------------------------------------------
------------------B----------------U----------------------------------------------------B-----U--------------------------------B--------------------------BB-BBB--BBBBB-BBBBB-BBBB-BB-BBBBBBBBB-BBBBBBBB
-----------------------C--------------------------------------------------------------------------------------------------------------------------------------------------------------------------------
--------------------------------------------------------------------------------------------------------------------------------------------------------------------------------------------------------
--------------------------------------------------------------------------------------------------------------------------------------------------------------------------------------------------------
--------------------------------------------------------------------------------------------------------------------------------------------------------------------------------------------------------
B----B-U---------#--BttBU-----tt---C----------------------------------------------------------C----------------------------B--------tt----------------------B----B-----B-----B----B--B------------------
--------#--------#-#-tt--tttt-tt-tt-----#-------------------------------------------#---------------------------------#----------#--tt------------------------------------------------------------------
-tt-----#--------#-#-tt--tttt-tt-tt---#-#-------------------------------------------##---tt-tt----------###tt##-----#-##-#--#---####tt#tt###--##-#######-#----------------------------------------------
-tt-g-g-##g-g--g-#g#-tt--ttttgtt-tt-k-#-#k-k-g-k-k-g-k-g-k-g-k-g-k--k-g-k-k-g-g-k-g-###-gtt-tt-gg-g-g-k-###tt##-k-g-#-####g-#g--####tt#tt###k###-#######g#------k--------------------------------------F
XXXXXXXXXXXXXXXXXXXXXXXXXXXXXXXXXXXXXXX-XXXXXXXXXXXXXXXXXXXXXXXXXXXXXXXXXXXXXXXXXXXXXXXXXXXXXXXXXXXXXXXXXXXXXXXXXXXXX-XXXXXXXXX-XXXXXXXXXXXXXXXXXXXXXXXXXXX-X---XX-----X-----X----X--X------------------
XXXXXXXXXXXXXXXXXXXXXXXXXXXXXXXXXXXXXXX-XXXXXXXXXXXXXXXXXXXXXXXXXXXXXXXXXXXXXXXXXXXXXXXXXXXXXXXXXXXXXXXXXXXXXXXXXXXXX-XXXXXXXXX-XXXXXXXXXXXXXXXXXXXXXXXXXXX-X---XX-----X-----X----X--X------------------
