--------------------------------------------------------------------------------------------------------------------------------------------------------------------------------------------------------
--------------------------------------------------------------------------------------------------------------------------------------------------------------------------------------------------------
--------------------------------------------------------------------------------------------------------------------------------------------------------------------------------------------------------
--------------------------------------------------------------------------------------------------------------------------------------------------------------------------------------------------------
--------------------------------------------------------------------------------------------------------------------------------------------------------------------------------------------------------
---------------------------S--------------------------------------------------S---U-------------------------U---U-----------------------------------SSS-SSUS-SS-SS--SSS-SSS--SSSSSSSSSSS-SSSSSSSSSSS-SSS
--------------------------------------------------------------------------C-----------------------------------C-----------------------------------C-----------------------------------------------------
--------------------------------------------------------------------------------------------------------------------------------------------------------------------------------------------------------
--------------------------------------------------------------------------------------------------------------------------------------------------------------------------------------------------------
--------------------------------------------------------------------------------------------------------------------------------------------------------------------------------------------------------
---------C-C------------------C-------------------------------------------S-tt--ttC-------------------------C-S-C#--------------------------------SS------C-S--S------------------------S---------------
--------#-------------------------------------------------------------------tt--tt-------------------------------#-------------------------------------#-------------------##---------------------------
--------#-------------------tt-#-------------------tt-----------------------tt--tt-----------------###-#---#-#-#-####-tt-##-####-----------------------#----------tt-------##---------------------------
g-k-g-k-#----k-g-k-k-g-g-g--tt-#ggk-k-k-g--k-g-g---ttg-g-k-g-g-k-k-g-k-g-g--tt--tt-g-g-k-g-k-g--k-g###-#kk-#-#-#-#####tt-##-####-g-g--gg-k-g-k-g-g-----#----------tt---g---##--------------------------F
|%|%|%|%|%%%%|%|%|%|%|%|%|%%||%||||%|%|%|%%|%|%|%%-|||%|%|%|%|%|%|%|%|%|%|%%||-%||%|%|%|%|%|%|%%|%||||%|||%|%|%|%|||||||%||%||||%|%|%%||%|%|%|%|%|%%--%|--%-%--%--||---|---||-----------%--------------%
||||||||||||||||||||||||||||||||||||||||||||||||||-|||||||||||||||||||||||||||-|||||||||||||||||||||||||||||||||||||||||||||||||||||||||||||||||||||--||--|-|--|--||---|---||-----------|--------------|
