--------------------------------------------------------------------------------------------------------------------------------------------------------------------------------------------------------
--------------------------------------------------------------------------------------------------------------------------------------------------------------------------------------------------------
--------------------------------------------------------------------------------------------------------------------------------------------------------------------------------------------------------
--------------------------------------------------------------------------------------------------------------------------------------------------------------------------------------------------------
--------------------------------------------------------------------------------------------------------------------------------------------------------------------------------------------------------
-----------------S-S------------------------------S-----------------------------SS--U----------------------------------------------SS--------S----------------------------------------------------------
-------------------------------------------------------------------------C------------------------------------------------------------------------------------------------------------------------------
--------------------------------------------------------------------------------------------------------------------------------------------------------------------------------------------------------
--------------------------------------------------------------------------------------------------------------------------------------------------------------------------------------------------------
--------------------------------------------------------------------------------------------------------------------------------------------------------------------------------------------------------
--#US---------------#-C------------------------tt------#-S-#--S----------SU---#S--ttC-CU--------------SUS-S-SSSS--S-S-S-SSS-SSSS-SS--SSS-SSSS-SSS-SSSSS-S-SSS-SSSSSSSSSSS-SSSSS-S--SSS-S-SSSS-SSSSSSSSSS
--#-----------------#--#-----------------------tt------#--##----------------tt#---tt--------------------------------------------------------------------------------------------------------------------
tt#-----------------#--#----------------------#tt------#--##----------------tt#---tt-#---------------------------------#---------------------------------#----------------------------------------------
tt#--k-k-k-g-k-g----#--#k-gk-g-k-k-g-kk-g-k-#-#tt--k-g-#--###--g-g-k-g-g----tt#---tt-#---g-k-g-g-k-g-k-------------g-#-#---------------------------------#-----------------------g---------------------F
|||%%|%|%|%|%|%|%-%-|%%||%||%|%|%|%|%||%|%|%|-|||%%|%|%|%%|||%%|%|%|%|%|%%%%|||%--||%|%%%|%|%|%|%|%|%|%%%%%%%%%%%-%|%|%|%%%%%%%%%%%--%%%%%%%%-%%%%%%%%%%%|%%%%%%%%%%%%%%%%%%%%%%%|%%%%%%%%%%%%%%%%%%%%%%
|||||||||||||||||-|-|||||||||||||||||||||||||-||||||||||||||||||||||||||||||||||--|||||||||||||||||||||||||||||||-|||||||||||||||||--||||||||-||||||||||||||||||||||||||||||||||||||||||||||||||||||||||
