--------------------------------------------------------------------------------------------------------------------------------------------------------------------------------------------------------
--------------------------------------------------------------------------------------------------------------------------------------------------------------------------------------------------------
--------------------------------------------------------------------------------------------------------------------------------------------------------------------------------------------------------
--------------------------------------------------------------------------------------------------------------------------------------------------------------------------------------------------------
--------------------------------------------------------------------------------------------------------------------------------------------------------------------------------------------------------
----------------------------B-----------------------------------B--------------BU---U-----------B-------------------------------------------------------------------------------------------------------
-------------------------------C----------------------------------C-----------------------------------------C-------------------------------------------------------------------------------------------
--------------------------------------------------------------------------------------------------------------------------------------------------------------------------------------------------------
--------------------------------------------------------------------------------------------------------------------------------------------------------------------------------------------------------
--------------------------------------------------------------------------------------------------------------------------------------------------------------------------------------------------------
#------------------------------B---------tt------------C----------B----tt-------C---C--------U--------------B#---------C-------------tt-C---tt-----tt--------------C------------------------------------
##----#---------------------------tt---tttt-------------#------------#-tt---------------------tt-------------#tttt-------------------tt-----tt-----tt------------------#--------------------------------
##----#--------------------#------tt#--tttt-------------#----------#-#-tt#--------------------tt-------------#tttt---tt--------------tt-----tt-----tt------------------#--------------------------------
##k-g-#k-g-g-g-g--k-k-g-k-g#------tt#--ttttk-gk-k-g-k---#k-g-k-g---#-#-tt#--k--g-###-k-g--g-k-tt--k-k-g-k--g-#tttt###tt-##########-##tt#-#k#tt#####tt####k-########-#-#################################F
XXXXXXXXXXXXXXXXXXXXXXXXXXXX-XXXXXXXXXXXXXXXXXXXXXXXXXXXXXXXXXXXX-XX-XXXXX-XXXXXXXXXXXXXXXXXXXXX-XXXXXXXXXXXXXXXXXXXXXXXXXXXXXXXXXXXXXXXXXXXXXXXXXXXXXXXXXXXXXXXXXXXX-XXXXXXXXXXXXXXXXXXXXXXXXXXXXXXXXXX
XXXXXXXXXXXXXXXXXXXXXXXXXXXX-XXXXXXXXXXXXXXXXXXXXXXXXXXXXXXXXXXXX-XX-XXXXX-XXXXXXXXXXXXXXXXXXXXX-XXXXXXXXXXXXXXXXXXXXXXXXXXXXXXXXXXXXXXXXXXXXXXXXXXXXXXXXXXXXXXXXXXXX-XXXXXXXXXXXXXXXXXXXXXXXXXXXXXXXXXX
