--------------------------------------------------------------------------------------------------------------------------------------------------------------------------------------------------------
--------------------------------------------------------------------------------------------------------------------------------------------------------------------------------------------------------
--------------------------------------------------------------------------------------------------------------------------------------------------------------------------------------------------------
--------------------------------------------------------------------------------------------------------------------------------------------------------------------------------------------------------
--------------------------------------------------------------------------------------------------------------------------------------------------------------------------------------------------------
---------------------S--------S------------------------------S------------------------------------------------------------------------------------------------------------------------------------------
-C------------------------------------------------------------------------------------------------------------------------------------------------------------------------------------------------------
--------------------------------------------------------------------------------------------------------------------------------------------------------------------------------------------------------
--------------------------------------------------------------------------------------------------------------------------------------------------------------------------------------------------------
--------------------------------------------------------------------------------------------------------------------------------------------------------------------------------------------------------
-S----------------Stt----------------------------------------------------------------------------------------------------------------------------S------------------------------------------------------
-------------------tt---#----------------------------------------------------------------------#--------------------------------------------------------------------------------------------------------
-------------------tt-tt#-----------------------------------#----------------------------------##-----------------------------------------------#-------------------------------------------------------
--k-g--k-g-k-g-g-g-tt-tt#gk-g---k-g-k-g--g-k-g-g-k-g-g-k-g-k#--k-g-k-k-g-g--g-k-g-k-g--k-g-k-g-###k-g-k-k-kk-k-k-k-k-kk-k--k-k-g-k-k-k-kk-k-g-kk#-k-k-k-gk-kkk-g-kk-k-k-kk-k-k-k-k-gk-kkkk-k-k-kkkk-kkkF
%%|%|%%|%|%|%|%|%|%||%|||||%|%-%|%|%|%|%%|%|%|%|%|%|%|%|%|%||%%|%|%|%|%|%|%%|%|%|%|%|%%|%|%|%|%||||%|%|%|%||%|%|%|%|%||%|%%|%|%|%|%|%|%||%|%|%|||%|%|%|%||%|||%|%||%|%|%||%|%|%|%|%||%||||%|%|%||||%|||%
||||||||||||||||||||||||||||||-|||||||||||||||||||||||||||||||||||||||||||||||||||||||||||||||||||||||||||||||||||||||||||||||||||||||||||||||||||||||||||||||||||||||||||||||||||||||||||||||||||||||||
