--------------------------------------------------------------------------------------------------------------------------------------------------------------------------------------------------------
--------------------------------------------------------------------------------------------------------------------------------------------------------------------------------------------------------
--------------------------------------------------------------------------------------------------------------------------------------------------------------------------------------------------------
--------------------------------------------------------------------------------------------------------------------------------------------------------------------------------------------------------
--------------------------------------------------------------------------------------------------------------------------------------------------------------------------------------------------------
---------------------S-----U-----------------------------------S--U-----------------------S------------------SSSS--SSU-SSS-SS-SSSSSSS-SSS--SS-SS-S-SSS-SS-SS-SSSS--SS-S-SSSSS-SS---SSSSSSS-SSSSSS-SSSSSS
C----------------C--------------------------------------------------------------------------------------------------------------------------------------------------------------------------------------
--------------------------------------------------------------------------------------------------------------------------------------------------------------------------------------------------------
--------------------------------------------------------------------------------------------------------------------------------------------------------------------------------------------------------
--------------------------------------------------------------------------------------------------------------------------------------------------------------------------------------------------------
S--------#-------S------tt#C-----------U--Stt-------------------CSCSC--------------------C-----------------SS----tt--CS------S-------S---C---S----S---S--S--S--------S-S-----S----S-------S------S------
---------#-------------#tt#---------tt-----tt--------------------------------------------------------------------tt----------------------------------------------tt-------------------------------------
---------#--------#tt--#tt#---------tt-----tt------------------------#---------------------tt--------------------tt-----------------------#----------------------tt-------------tt----------------------
--k-g--k-#g-k--g--#ttg-#tt#-k-g-k-g-tt--#--ttk-gg-k-g-k-g-k-g--------#k-g--g-g-k--k-k-g-g--tt-g-k-k-g-k-g--------tt-----------------------#----------------------tt-------------tt---------------------F
%%|%|%%|%||%|%%|%%||||%||||%|%|%|%|%||%%|%%|||%||%|%|%|%|%|%|%%%%%%%%||%|%%|%|%|%%|%|%|%|%-||%|%|%|%|%|%|%%%%%%%%||%%%%%%%%%%%%%%%-%-%%%%%|%%%%%%%%%%%%%%%%%%%%%%||%%%%%%%%%%%%%||%%%%%%%%%%%%%%%%%%%%%%
||||||||||||||||||||||||||||||||||||||||||||||||||||||||||||||||||||||||||||||||||||||||||-|||||||||||||||||||||||||||||||||||||||-|-|||||||||||||||||||||||||||||||||||||||||||||||||||||||||||||||||||
