--------------------------------------------------------------------------------------------------------------------------------------------------------------------------------------------------------
--------------------------------------------------------------------------------------------------------------------------------------------------------------------------------------------------------
--------------------------------------------------------------------------------------------------------------------------------------------------------------------------------------------------------
--------------------------------------------------------------------------------------------------------------------------------------------------------------------------------------------------------
--------------------------------------------------------------------------------------------------------------------------------------------------------------------------------------------------------
--------S------------------SUU---------S------S---S-----S--------S-------U---SU------S-S---------------------------------S-------SSSSSSS-S--S-SS-SSSSSSSS-S---SSSS--SS-SS-SSSSSSSSSSSSSSSSSSSSSSSSSSSSSS
--------------------------------------------------------------------------------C-------C-----C---------------------------------------------------------------------------------------------------------
--------------------------------------------------------------------------------------------------------------------------------------------------------------------------------------------------------
--------------------------------------------------------------------------------------------------------------------------------------------------------------------------------------------------------
--------------------------------------------------------------------------------------------------------------------------------------------------------------------------------------------------------
-----UU---------------------CC-S------#----tt----------U-------tt-tttt---C-SC-C-S-C-----S--SttS----------------ttU--------tt--------------tt-------------C----------------------------------------------
--------------------------------------#-tt-tt------------------tt-tttt--------------------#-tt--tt-------------tt---------tt--------------tt------------------------------------------------------------
--------------------tt----------------#-tt-tt---tt-------------tt-tttt---------#-#--------#-tt--tt-----tt------tt---------tt--------------tt----#----------tt-----tt------------------------------------
-g-------k-g-g-k-g--tt-g------#-g-g-g-#-ttgtt-g-tt-g-----k-g-k-ttgtttt-g--g----#-#-k--gg-g#-tt--ttk-g--ttk-g--gtt-k-k-g---ttk-g-gggggggg#gttgggg#gggggggg-gttkggggttgg-ggkgggggggggggggggggggggggggggggF
%|%%%%%%-|%|%|%|%|%%||%|%%--%%|%|%|%|%|-|||||%|-||%|%%%%-|%|%|%|||||||-|%%|%%-%|%|%|%%||%||%||%%|||%|%%|||%|%%|||%|%|%|%%%|||%|%|||||||||||||||||||||||||%||||||||||||%||||||||||||||||||||||||||||||||%
||||||||-|||||||||||||||||--|||||||||||-|||||||-||||||||-|||||||||||||-||||||-||||||||||||||||||||||||||||||||||||||||||||||||||||||||||||||||||||||||||||||||||||||||||||||||||||||||||||||||||||||||||
