--------------------------------------------------------------------------------------------------------------------------------------------------------------------------------------------------------
--------------------------------------------------------------------------------------------------------------------------------------------------------------------------------------------------------
--------------------------------------------------------------------------------------------------------------------------------------------------------------------------------------------------------
--------------------------------------------------------------------------------------------------------------------------------------------------------------------------------------------------------
--------------------------------------------------------------------------------------------------------------------------------------------------------------------------------------------------------
SS------S---------U---------------------S---------U---------------------------------------SSS-S---------------SS-U---------------S-S--------------------------------------S----------U------------------
-----------C-C-------------------------C--------------------------------------CC------------------------------------------------------------------------------------------------------------------------
--------------------------------------------------------------------------------------------------------------------------------------------------------------------------------------------------------
--------------------------------------------------------------------------------------------------------------------------------------------------------------------------------------------------------
--------------------------------------------------------------------------------------------------------------------------------------------------------------------------------------------------------
-------C---S-S--ttC---------------#SU--S-S--ttS---CU----SttC#-C--#U-----------SS-------------U---------#Utt-----UC-------------------------------------------------------------------C------------------
----------------tt----------------#---------tt--tt--#tt--tt-#---##----------------------tt-------------#-tt------------------------------------------#--------------------------------------------------
----------#-----tt----------------#--tt-----tt--tt--#tt--tt-#--###-tt-------------------tt-----tt------#-tttt----------------------------------------#--------------#-----------------------------------
-gk-k-g-gg#-----tt--k-g-k-gg-k-g-g#--tt---#gtt--tt--#tt--tt-#--###-ttk-gk-g-----g-k-k-g-tt-g--gtt-k-k--#-tttt-g---k-k-g-g--g-k-k---------------------#------------#-#-g--------------------------------F
%||%|%|%|||%%%-%||%%|%|%|%||%|%|%||%%||%%%||||%%||%%|||%%||%|%%|||%|||%||%|%%%%%|%|%|%|%||-|%%|||%|%|%%|%||||%|-%%|%|%|%|%%|%|%|%%-%-----------------|------------|-|-|--------------%-----------%%%%%%%
||||||||||||||-|||||||||||||||||||||||||||||||||||||||||||||||||||||||||||||||||||||||||||-||||||||||||||||||||-||||||||||||||||||-|-----------------|------------|-|-|--------------|-----------|||||||
