--------------------------------------------------------------------------------------------------------------------------------------------------------------------------------------------------------
--------------------------------------------------------------------------------------------------------------------------------------------------------------------------------------------------------
--------------------------------------------------------------------------------------------------------------------------------------------------------------------------------------------------------
--------------------------------------------------------------------------------------------------------------------------------------------------------------------------------------------------------
--------------------------------------------------------------------------------------------------------------------------------------------------------------------------------------------------------
--------B---------------------B---------------U---------------------B-B-----------------------------------------------------------------------------------------B---------------------------------------
---C----------------------------------------C------------------------------------------------------------------------------CCCCCC--CCCCCCCCCCCCC-C-C-CCCCCCC-CCC-CCCC-CCCCCCCCCC-C-------C--------------
--------------------------------------------------------------------------------------------------------------------------------------------------------------------------------------------------------
--------------------------------------------------------------------------------------------------------------------------------------------------------------------------------------------------------
--------------------------------------------------------------------------------------------------------------------------------------------------------------------------------------------------------
---B--CB-----------------------BUUU---------B-C-------------tt-----#-------------------------------------------------------BBBBBBU-BBBBBBBBBBBBBBBBBBBBBBBBBUBBB-BBBB-BBBBBBBBBB-B-------B--------------
----tt-------------------------------#----------------------tt#---##-#----------------------------------------------------------------------------------------------------------------------------------
----tt-----------------------------#-#----------------------tt#--###-#-----------------------------------------------------------------------------------------------#----------------------------------
k-g-tt---g-k-g-g-k-g-k-g-k-g-gg----#-#-k-g-k-g-k-g-k-gg-g-g-tt#g####g#gk-g-k-k-k-g-k-gk-k-g-k-k-k-g-k-g-k-k-g-k-g-g-k-k-g--------------------------------------------#----------g-gg-k-gg-g-gggg-g-g-ggF
XXXXXXXX-XXXXXXXXXXXXXXXXXXXXXXXXXXX-XXXXXXXXXXXXXXXXXXXXXXXXXXXXXXXXXXXXXXXXXXXXXXXXXXXXXXXXXXXXXXXXXXXXXXXXXXXXXXXXXXXXXXXXXXXXXXXXXXXXXXXXXXXXXXXXXXXXXXXXXXX-XXXXXXXXXXXXXXXXXXXXXXXXXXXXXXXXXXXXXXX
XXXXXXXX-XXXXXXXXXXXXXXXXXXXXXXXXXXX-XXXXXXXXXXXXXXXXXXXXXXXXXXXXXXXXXXXXXXXXXXXXXXXXXXXXXXXXXXXXXXXXXXXXXXXXXXXXXXXXXXXXXXXXXXXXXXXXXXXXXXXXXXXXXXXXXXXXXXXXXXX-XXXXXXXXXXXXXXXXXXXXXXXXXXXXXXXXXXXXXXX
