--------------------------------------------------------------------------------------------------------------------------------------------------------------------------------------------------------
--------------------------------------------------------------------------------------------------------------------------------------------------------------------------------------------------------
--------------------------------------------------------------------------------------------------------------------------------------------------------------------------------------------------------
--------------------------------------------------------------------------------------------------------------------------------------------------------------------------------------------------------
--------------------------------------------------------------------------------------------------------------------------------------------------------------------------------------------------------
-------------BU-----------------B-----B-B----UB----BB-B----------B--B------B--B---B-----------------------B----B----------BB------B-B-B-BB-BB-B-BBBB-BBBB---BBB-B--BBB----------------------------------
-C----------------------C------------C------------------------------------------------------------------------------------------------------------------------------------------------------------------
--------------------------------------------------------------------------------------------------------------------------------------------------------------------------------------------------------
--------------------------------------------------------------------------------------------------------------------------------------------------------------------------------------------------------
--------------------------------------------------------------------------------------------------------------------------------------------------------------------------------------------------------
-B------------C---------B--#---------B------UC--tt---#-C-tt-----C--------#-----------------------------------------------B-------#-----B--B--#-B----B------B--------------------------------------------
-----#-----------tt------tt#--------------------tt---#---tt-------tt-tt-##--tt-------#---------------------------tt--------------#---#-------#-------------------tt-------------------------------------
---#-#--tt-------tt-tt---tt#tttt--#------tt----#tt---#--#tt-------tt-tt-##--tt--#---##------------------tt-------tt--------------#---#-------#-----------tt------tt---#tttttttttttttttttttttttttttt-----
--g#-#-gttkk-g--gtt-tt-g-tt#tttt-##---g--tt----#ttgg-#g-#tt-#-g--gtt-tt-##ggtt-##--###-k-gg-k-k--k-k-g-kttgk-k---tt-g-k-g----gk-g#-kg#-------#-----------tt----g-tt---#tttttttttttttttttttttttttttt-gggF
XXXX-X-XXXXXXXXXXXXXXXXXXXXXXXXXXXXXXXXX-XXXXXXXXXXXXXXXXXXXXXXXXXXXXXX-XXXXXXXXXX-XXXXXXXXXXXXXXXXXXXXXXXXXXXXX-XX-XXXXXX--XXXXXX-XXX-X--X--X-X----X----XXX---X-XX---XXXXXXXXXXXXXXXXXXXXXXXXXXXXXXXXXX
XXXX-X-XXXXXXXXXXXXXXXXXXXXXXXXXXXXXXXXX-XXXXXXXXXXXXXXXXXXXXXXXXXXXXXX-XXXXXXXXXX-XXXXXXXXXXXXXXXXXXXXXXXXXXXXX-XX-XXXXXX--XXXXXX-XXX-X--X--X-X----X----XXX---X-XX---XXXXXXXXXXXXXXXXXXXXXXXXXXXXXXXXXX
