--------------------------------------------------------------------------------------------------------------------------------------------------------------------------------------------------------
--------------------------------------------------------------------------------------------------------------------------------------------------------------------------------------------------------
--------------------------------------------------------------------------------------------------------------------------------------------------------------------------------------------------------
--------------------------------------------------------------------------------------------------------------------------------------------------------------------------------------------------------
--------------------------------------------------------------------------------------------------------------------------------------------------------------------------------------------------------
----U---S-----S---S-----S-------------------U--S-----------SS--U--------------------------------U-----------S---------------------------------------------------S--------------------------S-S----------
-------------------------------------------------------------------C-------------------------------------------------------C----------------------------------------------------------------------------
--------------------------------------------------------------------------------------------------------------------------------------------------------------------------------------------------------
--------------------------------------------------------------------------------------------------------------------------------------------------------------------------------------------------------
--------------------------------------------------------------------------------------------------------------------------------------------------------------------------------------------------------
----C----SU--------------------UC-----------C-S-----------S--#UCtt-S-U---------U----------------C--------------------------S--------------#--------#-----tt-#-------C-------------U---------------------
-------------------------------------tt----------------------#--tt-------------------------------------#####-##-#######-##--##------############--##-####tt#####-###-tt###########-###--###-#-##########
-------------------#------tt---------tt--tt------------------#--tt-------------------------------------#####-##-#######-##--##------############-###-####tt#####-###-tt###########-###--###-#-##########
-g-----k---g-------#k-g--gttk-g--k-ggtt--ttg----gk-g-k-g-----#--ttg-#-k-k-g---g--k-g-k-k-k-k-g---g-k-g-#####-##k#######-##k-##k-g-g-################g####tt#####-###-tt###########-###k-###-#g#########F
%|%%%%%|-%%|%%%-%--||%|%-||||%|%%|%||||%%|||%%%%||%|%|%|%-%%%|%%|||%|%|%|%|%%%|%-|%|%|%|%|%|%|%%%|%|%|%|||||%||||||||||%|||%|||%|%|%||||||||||||||||||||||||||||%|||%|||||||||||||%||||%|||%|||||||||||%
||||||||-||||||-|--|||||-||||||||||||||||||||||||||||||||-||||||||||||||||||||||-|||||||||||||||||||||||||||||||||||||||||||||||||||||||||||||||||||||||||||||||||||||||||||||||||||||||||||||||||||||||
