--------------------------------------------------------------------------------------------------------------------------------------------------------------------------------------------------------
--------------------------------------------------------------------------------------------------------------------------------------------------------------------------------------------------------
--------------------------------------------------------------------------------------------------------------------------------------------------------------------------------------------------------
--------------------------------------------------------------------------------------------------------------------------------------------------------------------------------------------------------
--------------------------------------------------------------------------------------------------------------------------------------------------------------------------------------------------------
-S--------S--------------U-------------S-------------S-----------------------SU-----SU--------------------U----------S------S--SS------------S-----------------S----S-------------------------------S---
------------------------------C-C----------------------------------------------C-----------------------------C-----CC---C-------------------------------------------------------------------------------
--------------------------------------------------------------------------------------------------------------------------------------------------------------------------------------------------------
--------------------------------------------------------------------------------------------------------------------------------------------------------------------------------------------------------
--------------------------------------------------------------------------------------------------------------------------------------------------------------------------------------------------------
---CS-tt#---U--S--------SC-CttS-S-----S-CU#U----------tt--#--------#----------CS-----C-tt-------Ctt-------C--S-----SS--#S----US--SUC---C-UttU-UUUUUUUU-UUUUU----UUUU-UUUUUUUUUUUUUUUUUUUUUUUU-UUUUUU-UUU
------tt#-------------------tt------------#-------tt#-tt--#tt------#------------tt----#tt--------tt---------------#----#-------------#----tt------------------------------------------------------------
------tt#-----------------#-tt------------#-------tt#-tt--#tt------#------------tt----#tt--------tt---------------#----#--tt---------#--#-tt------------------------------------------------------------
kg#--gtt#-g--g--g-g-k-g---#-tt---k-g-k----#--k-g--tt#gttk-#tt-g--g-##g-k-k---g--tt----#tt-g------tt-g-g----g--k-g-#--g-#--tt---------##-#-tt----------g-----gk--------------------------------------g--F
|||%%||||%|%%|%%|%|%|%|%%%|%||%%%|%|%|%-%%|%-|%|%%|||||||%|||%|%%|%|||%|%|%-%|%%||%-%%|||%|%%%--%||%|%|%%%%|%%|%|%|%%|-|%-||-%%%%%%%%||%|%||%%%%%%%%%%|%%%%%||%-%%%%%%%%%%%%%%%%%%%%%%%%%%%%%%%%%%%%|%%%
|||||||||||||||||||||||||||||||||||||||-||||-||||||||||||||||||||||||||||||-|||||||-||||||||||--||||||||||||||||||||||-||-||-||||||||||||||||||||||||||||||||||-||||||||||||||||||||||||||||||||||||||||
