--------------------------------------------------------------------------------------------------------------------------------------------------------------------------------------------------------
--------------------------------------------------------------------------------------------------------------------------------------------------------------------------------------------------------
--------------------------------------------------------------------------------------------------------------------------------------------------------------------------------------------------------
--------------------------------------------------------------------------------------------------------------------------------------------------------------------------------------------------------
--------------------------------------------------------------------------------------------------------------------------------------------------------------------------------------------------------
---B---B--------------B--------------------------------U---U-------B--B------------------------B-------------------------UU--------------------B------------U----------B---------------U----------------
-------------------C------------------------------------------C---------C-------------------------------------------C--------------------------------------------------------------------C--------------
--------------------------------------------------------------------------------------------------------------------------------------------------------------------------------------------------------
--------------------------------------------------------------------------------------------------------------------------------------------------------------------------------------------------------
--------------------------------------------------------------------------------------------------------------------------------------------------------------------------------------------------------
B---tt---B--ttB----B------C-----------U--------------C-C---C--B---U--U--BC----------------------#-------U-----------BCUCCCCCUCCCCCUCCCCUCCCCC-----------CCCCCCCCCCUCCCC-CCCCUCCCC-UCCCCCCBCCCCC-CCCCCCCC
----tt----tttt----#--------------------------------------#---#-#--------------------------------#--------------------------------------------tt-----#---------------------------------------------------
-#--tt----tttt----#--------tt-----------tt---------------#---#-##-------------------------------#tt------------------------------------------tt-tt--#---------------------------------------------------
-#--tt-g--tttt-#g-#-k#g#-g-tt-g-k-g-k---tt-k--g-k-gk-----##--#-###--g-gg--k-g--g-g-k-g-g-g-k-g-g#tt-k-g--k-g-g-k-g-g-------------------------tt-ttg-#k-g---------------------------------------k-------F
XXX-XXXX-XXXXXXXXXXXXXXXXXXXXXXXXXXXXXXXXXXXXXXXXXXXXXXXXXXXXXXXXXXXXXXXXXXXXXXXXXXXXXXXXXXXXXXXXXXXXXXXXXXXXXXXXXXXXXXXXXXXXXXXXXXXXXXXXXXXXXX-XXXXXXXXXXXXXXXXXXXXXXXXXXXXXXXXX-XXXXXXXXXXXXXXXXXXXXXX
XXX-XXXX-XXXXXXXXXXXXXXXXXXXXXXXXXXXXXXXXXXXXXXXXXXXXXXXXXXXXXXXXXXXXXXXXXXXXXXXXXXXXXXXXXXXXXXXXXXXXXXXXXXXXXXXXXXXXXXXXXXXXXXXXXXXXXXXXXXXXXX-XXXXXXXXXXXXXXXXXXXXXXXXXXXXXXXXX-XXXXXXXXXXXXXXXXXXXXXX
