--------------------------------------------------------------------------------------------------------------------------------------------------------------------------------------------------------
--------------------------------------------------------------------------------------------------------------------------------------------------------------------------------------------------------
--------------------------------------------------------------------------------------------------------------------------------------------------------------------------------------------------------
--------------------------------------------------------------------------------------------------------------------------------------------------------------------------------------------------------
--------------------------------------------------------------------------------------------------------------------------------------------------------------------------------------------------------
--------------------------------------SS--SS------------------------S------------------U------------------S----------------------U------------------------------------------------------S---------------
---------------C----------------------------------------------------------------------C-------------------------------------------------------------------------------------C---------------------------
--------------------------------------------------------------------------------------------------------------------------------------------------------------------------------------------------------
--------------------------------------------------------------------------------------------------------------------------------------------------------------------------------------------------------
--------------------------------------------------------------------------------------------------------------------------------------------------------------------------------------------------------
-#-S---tt------SS---S--------------------S---------------------------------C#--------#SCC----------------------------------------C-U-------------------------------#--------S---------------------------
-#----#tt-------------------------------------------------------------------#--------#----------------------#------------------------------------------------------#------------------------------------
-#----#tt------------------------------------------------------------tt-----#--------#----------------------#------------------------------------------------------#---------------tt-------------------
-#k--##ttg-g-g---g-k---g-k-g-g-k-g-k--g-g---g-g-k-g-k-g-gk-g-g--gg--gttk-k--#k-g-gg--#----k-k-g-k-k-g-g-----#---k-g-k-g-------g--------------------------------#g--#----------g----tt------------------F
%||%%|||||%|%|%%%|%|%%%|%|%|%|%|%|%|%%|%|%%%|%|%|%|%|%|%||%|%|%%||%%||||%|%%||%|%||%%|%%%%|%|%|%|%|%|%|%%%-%|%%%|%|%|%|%%%%%%%|%%%%%%%%%%%%%%%%%%%-%%%%%%%%%%%%||%%|%%%%%%%%%%|%%%%||%%%%%%%%%%%%%%%%%%%
||||||||||||||||||||||||||||||||||||||||||||||||||||||||||||||||||||||||||||||||||||||||||||||||||||||||||-|||||||||||||||||||||||||||||||||||||||-|||||||||||||||||||||||||||||||||||||||||||||||||||||
