--------------------------------------------------------------------------------------------------------------------------------------------------------------------------------------------------------
--------------------------------------------------------------------------------------------------------------------------------------------------------------------------------------------------------
--------------------------------------------------------------------------------------------------------------------------------------------------------------------------------------------------------
--------------------------------------------------------------------------------------------------------------------------------------------------------------------------------------------------------
--------------------------------------------------------------------------------------------------------------------------------------------------------------------------------------------------------
-----------U------------B--BU------U-----------B--------------------------B----BB--U--BU-----B---------------------------------------------B------B-----------------------------B-----------------------
-------------------------------------------------------------------------------------------------------------------------------------C------------------------------------------------------------------
--------------------------------------------------------------------------------------------------------------------------------------------------------------------------------------------------------
--------------------------------------------------------------------------------------------------------------------------------------------------------------------------------------------------------
--------------------------------------------------------------------------------------------------------------------------------------------------------------------------------------------------------
-------#---C-----------U-UC-C------C#--------tt----------------------------BC-B--UCC---C------tt----------------------U-UU--UUUUUUUU#BUU-U--UUUUUU-UUUUUUUUUUUUU-UUUtt-UUUUUUUUU-#UUUUU----UUUUUUUUUUUUU
-------#--#------------------tttt---#--------tt-----------------------------------------------tt--------------------------tt--------#-------------------------------tt-----------#----------------------
-------#--#------------------tttt---#--------tt----tt-------------------------------tt--------tt------------tt------------tt--------#-------------------------------tt#----------#----------------------
-g-g--##g-#-k-g-k-g-k--------ttttg--#g-gkk-g-ttg-k-tt-k-g-k-k-k-k-g-k-g-k----k-gg---tt---g-k-gtt-g-k-g-g-gk-tt-k-g-g------tt--------#-----k---------------------k---tt#----------#------k-g------------F
XXXXXXXXXXXXXXXXXXXXXXXXXXX-XXXXXXXXXXXXXXXXXXXXXXXXXXXXXXXXXXXXXXXXXXXXXX-XXXXXXXXXXXXXXXXXXXXXXXXXXXXXXXXXXXXXXXXXXXXXXXXXXXXXXXXXXXXXXXXXXXXXXXXXXXXXXXXXXXXXXXXXXXXXXXXXXXXXXXXXXXXXXXXXXXXXXXXXXXXX
XXXXXXXXXXXXXXXXXXXXXXXXXXX-XXXXXXXXXXXXXXXXXXXXXXXXXXXXXXXXXXXXXXXXXXXXXX-XXXXXXXXXXXXXXXXXXXXXXXXXXXXXXXXXXXXXXXXXXXXXXXXXXXXXXXXXXXXXXXXXXXXXXXXXXXXXXXXXXXXXXXXXXXXXXXXXXXXXXXXXXXXXXXXXXXXXXXXXXXXX
