--------------------------------------------------------------------------------------------------------------------------------------------------------------------------------------------------------
--------------------------------------------------------------------------------------------------------------------------------------------------------------------------------------------------------
--------------------------------------------------------------------------------------------------------------------------------------------------------------------------------------------------------
--------------------------------------------------------------------------------------------------------------------------------------------------------------------------------------------------------
--------------------------------------------------------------------------------------------------------------------------------------------------------------------------------------------------------
-------------------------------SU----------S-----------------S---------------------SS-----------------------------------------------S-----------U-------------------------------------------------------
--------------------C-----------------------------------------------------------------------------------------------------------------------------------------------------------------------------------
--------------------------------------------------------------------------------------------------------------------------------------------------------------------------------------------------------
--------------------------------------------------------------------------------------------------------------------------------------------------------------------------------------------------------
--------------------------------------------------------------------------------------------------------------------------------------------------------------------------------------------------------
-------------------US-----------Ctt---------S---------------S--U----------#---------------tttt#-------------------------------------------------C---------tt##-#----------------------------------------
---------------------tt----------tt---------------------------------------#--tt#-------#tttttt#-----------------------------------------------------------tt##-#----------------------------------------
--#------------------tt----------tt-----------------------tt----#---------#--tt#------##tttttt##-------------#--------------------------------------------tt##-#-tt-------------------------------------
k-#-k-g-g-k-k-g---g--tt-g-k-g----tt-g-g-g-g--k-g----g-k-g-tt-gk-#g-g-k-g--#--tt##-gg-###tttttt##k-g-gg-gggggg#g#gggggggg-ggggggggggg-ggggggg#gg--gggggggggtt##g#gttggggggggggggggkk-k-k-g-k-gk-k-kkkkkkF
|%|-|%|%|%|%|%|%%-|%%||%|%|%|%%-%||%|%|%|%|-%|%|%%%%|%|%|%||%||%||%|%|%|%%|%-||||%||%||||||||||||%|%||%|||||||||||||||||-|||||||||||%||||||||||-%||||||||||||||||||||||||||||||||||%|%|%|%|%||%|%||||||%
|||-|||||||||||||-|||||||||||||-|||||||||||-||||||||||||||||||||||||||||||||-|||||||||||||||||||||||||||||||||||||||||||-||||||||||||||||||||||-||||||||||||||||||||||||||||||||||||||||||||||||||||||||
