--------------------------------------------------------------------------------------------------------------------------------------------------------------------------------------------------------
--------------------------------------------------------------------------------------------------------------------------------------------------------------------------------------------------------
--------------------------------------------------------------------------------------------------------------------------------------------------------------------------------------------------------
--------------------------------------------------------------------------------------------------------------------------------------------------------------------------------------------------------
--------------------------------------------------------------------------------------------------------------------------------------------------------------------------------------------------------
---------------B--------BB---------U--------------BB---B---B-------B-----------------------U--------------B-----------------B-U------------------------------B------------------------------------------
-------------------------------C----------------------------------------------------------------------------------------------------------------------------------------C-------------------------------
--------------------------------------------------------------------------------------------------------------------------------------------------------------------------------------------------------
--------------------------------------------------------------------------------------------------------------------------------------------------------------------------------------------------------
--------------------------------------------------------------------------------------------------------------------------------------------------------------------------------------------------------
-----U-C--------Utt------------B---C---------#--BB--tt--U----------------------------------C------------tt-------UB-----------C------C--------#----------#-----------#--B---------#---------------------
--#--------------tt-#--#--#-----#------------#------tt--------------------------------------------------tt---------tt----------tt------------##----------#-----------#------------#-----tt--------------
--#--------------tt##--#--#-----#------------#------tt---#----#-----------------------------------------tt---------tt-----tt---tttt---------###----------#-----------#------------#-----tt--------------
--#-----g-k-g-gg-tt##g##--#k-g#-#g--k-k-g-g--##g----tt---#-g#-#g-k-gg-k-g--gk-k-g-k-g-k-g-g-#k-k-g-k-g--tt-g-k-g---tt#####tt-#-tttt##-##########-#######-####-##########-###############tt#############F
XXXXXX-XXXXXXXXXXXXXXXXXX-XXXXXXXXXXXXXXXXXXXXXXXX--XXX-XX-XX-XXXXXXXXXXXXXXXXXXXXXXXXXXXXXXXXXXXXXXXXXXXXXXXXXXXXXXXXXXXXXXXXXXXXXXXXXXXXXXXXXX-XXXXXXXXXXXX-XXXXXXXXXXXXXXXXXXXXXXXXXXXXXXXXXXXXXXXXXX
XXXXXX-XXXXXXXXXXXXXXXXXX-XXXXXXXXXXXXXXXXXXXXXXXX--XXX-XX-XX-XXXXXXXXXXXXXXXXXXXXXXXXXXXXXXXXXXXXXXXXXXXXXXXXXXXXXXXXXXXXXXXXXXXXXXXXXXXXXXXXXX-XXXXXXXXXXXX-XXXXXXXXXXXXXXXXXXXXXXXXXXXXXXXXXXXXXXXXXX
