--------------------------------------------------------------------------------------------------------------------------------------------------------------------------------------------------------
--------------------------------------------------------------------------------------------------------------------------------------------------------------------------------------------------------
--------------------------------------------------------------------------------------------------------------------------------------------------------------------------------------------------------
--------------------------------------------------------------------------------------------------------------------------------------------------------------------------------------------------------
--------------------------------------------------------------------------------------------------------------------------------------------------------------------------------------------------------
-U--------------BB-B---------------------------------------------B-------------------------------------------B----------------------------------------------------------------B----------B--------------
C-----------------------------------------------------------------------------------------C-------------------------------------------------------------------------------------------------------------
--------------------------------------------------------------------------------------------------------------------------------------------------------------------------------------------------------
--------------------------------------------------------------------------------------------------------------------------------------------------------------------------------------------------------
--------------------------------------------------------------------------------------------------------------------------------------------------------------------------------------------------------
BCtttt----------------------------------------------------------U-----------------------C-B-------------------------------------------------------------------------------C-----------------------------
--tttt--------------------------------------------------------------------------------------#---------------------------------------------------------------------------------------------------########
--tttt-tt-----------------------------------------------------tt----------------------------#--tt-----------------------------------------------------------------------------------------------########
--tttt-tt-g-k-g-----k-k-g--k-k-k-g--k-g--g-k-g-k-g-k-gk-g-k-g-tt-g-g-k-k-g-g-g-k-g-g-k-g-#--#k-tt-k-k-g-k-kk-gk-k--k-g-k-k-kk-kk-k-k-k-kk-k-k-kk-k-g--k-k-k-k-g###########-##g-##########g##----#######F
XXXXXX-XXXXXXXXX----XXXXXXXXXXXXXXXXXXXXXXXXXXXXXXXXXXXXXXXXX-XXXXXXXXXXXXXXXXXXXXXXXXXXXXXXXX-XXXXXXXXXXXXX-XXXXXXXXXXXXXXXXXXXXXXXXXXXXXXXXXXXXXXXXXXXXXXXXXXXXXXXXXXXXXXXXX-XXXXXXXXXXXXXXXXXXXXXXXXX
XXXXXX-XXXXXXXXX----XXXXXXXXXXXXXXXXXXXXXXXXXXXXXXXXXXXXXXXXX-XXXXXXXXXXXXXXXXXXXXXXXXXXXXXXXX-XXXXXXXXXXXXX-XXXXXXXXXXXXXXXXXXXXXXXXXXXXXXXXXXXXXXXXXXXXXXXXXXXXXXXXXXXXXXXXX-XXXXXXXXXXXXXXXXXXXXXXXXX
