--------------------------------------------------------------------------------------------------------------------------------------------------------------------------------------------------------
--------------------------------------------------------------------------------------------------------------------------------------------------------------------------------------------------------
--------------------------------------------------------------------------------------------------------------------------------------------------------------------------------------------------------
--------------------------------------------------------------------------------------------------------------------------------------------------------------------------------------------------------
--------------------------------------------------------------------------------------------------------------------------------------------------------------------------------------------------------
--S-S---S-------------S---------U---S---S--S----------S---------US---------------------U-----U------------------------S--S-----------S---------S----UU--------------------------------------------------
-----------------------------------------------C--------------------------------------------------------------------C---------------C--------------------------------C----------------------------------
--------------------------------------------------------------------------------------------------------------------------------------------------------------------------------------------------------
--------------------------------------------------------------------------------------------------------------------------------------------------------------------------------------------------------
--------------------------------------------------------------------------------------------------------------------------------------------------------------------------------------------------------
---S---#-----------ttC-S----SS--CUS----C-------S-----S-#tt------C--S#-CC---U----#------Ctt---C-------------CC-------S---------tt--C-S--tt--S-tt-----CC---------------S-#--------------------------------
-------#---tt------tt----tt---#-------#---#---#-tt--#--#tt----------#-------tt--#tt--tt-tt--------------#--------------tt-#---tt-#-----tt----tt-#----------------------#--------------------------------
-------#---tt------tt----tt#--#-------#---#--##-tt-##--#tt----tt----#-------tt--#tt#-tt-tttt------------##-------------tt-#---tt-#-#--#tt----tt-#----------------------#--------------------------------
g----gg#g--tt-k-g-ktt----tt#--#----g--#---#-###-ttg##--#ttk-g-tt-g--#g--k-g-ttk-#tt#gtt-tttt---k-g-g-g-g###--k-gk-gk---tt-#k--tt-#-#--#tt-#-gtt-#g-g------gg-----------#------------------------------gF
|%-%-||||%-||%|%|%|||%-%%|||%%|%%%%|-%|%-%|%|||%|||||%%||||%|%||%|-%||%%|%|%|||%|||||||%||||%%%|%|%|%|%||||%%|%||%||%%%||-||%-||-|%|%%|||-|%|||-||%|%%%%%%||%%%%%%%%%%%|%%%%%%%%%%%%%%%%%%%%%%%%%%%%%%|%
||-|-|||||-|||||||||||-|||||||||||||-|||-|||||||||||||||||||||||||-||||||||||||||||||||||||||||||||||||||||||||||||||||||-|||-||-||||||||-|||||-||||||||||||||||||||||||||||||||||||||||||||||||||||||||
