--------------------------------------------------------------------------------------------------------------------------------------------------------------------------------------------------------
--------------------------------------------------------------------------------------------------------------------------------------------------------------------------------------------------------
--------------------------------------------------------------------------------------------------------------------------------------------------------------------------------------------------------
--------------------------------------------------------------------------------------------------------------------------------------------------------------------------------------------------------
--------------------------------------------------------------------------------------------------------------------------------------------------------------------------------------------------------
-----------------------------------------------------------------------------B-U--------------------------------------------------------------------------------------------------------------------U-UU
-----------------------------------------------------C-------C------------------------------------------------------------------------------------------------------------------------------------------
--------------------------------------------------------------------------------------------------------------------------------------------------------------------------------------------------------
--------------------------------------------------------------------------------------------------------------------------------------------------------------------------------------------------------
--------------------------------------------------------------------------------------------------------------------------------------------------------------------------------------------------------
B----------------------------------------------CC#---Btt-----BBB---------------CB--------------------------U----------------------------------------------------------------------------------------C#CC
---------------------------#---------------------#----tt---------------------------------------------------------------------------------------------------------------------------------------------#--
-#--#----------------------##--------------------#-#--tt---------------------------------------------------------------------------##-----------------------------------tttttttttttttttttttttttttttt-#--
-#g-#kg-k-g-k-k-g-k-k-g-g--###g-g-k-g--#g-k-g----#-#--tt-k-gg---k-g-k-k-g-k--g#--g-g---g-kg-k-k-g-k-k-g-k-#-k-k-kk-k-kk-k-g--k-kk-k##kkk-kk-k-k-k-k-kk-k-k-k--k-k-k-k-k-tttttttttttttttttttttttttttt-#-F
XXXXXXXXXXXXXXXXXXXXXXXXXXXXXXXXXXXXXXXXXXXXXXXXXX-XXXXXXXXXXXXXXXXXXXXXXXX-XXXXXXXXXX-XXXXXXXXXXXXXXXXXXXXXXXXXXXXXXXXXXXXXXXXXXXXXXXXXXXXXXXXXXXXXXXXXXXXXXXXXXXXXXXXXXXXXXXXXXXXXXXXXXXXXXXXXXXXXXXXX
XXXXXXXXXXXXXXXXXXXXXXXXXXXXXXXXXXXXXXXXXXXXXXXXXX-XXXXXXXXXXXXXXXXXXXXXXXX-XXXXXXXXXX-XXXXXXXXXXXXXXXXXXXXXXXXXXXXXXXXXXXXXXXXXXXXXXXXXXXXXXXXXXXXXXXXXXXXXXXXXXXXXXXXXXXXXXXXXXXXXXXXXXXXXXXXXXXXXXXXX
