--------------------------------------------------------------------------------------------------------------------------------------------------------------------------------------------------------
--------------------------------------------------------------------------------------------------------------------------------------------------------------------------------------------------------
--------------------------------------------------------------------------------------------------------------------------------------------------------------------------------------------------------
--------------------------------------------------------------------------------------------------------------------------------------------------------------------------------------------------------
--------------------------------------------------------------------------------------------------------------------------------------------------------------------------------------------------------
----------------S-------------------S-----------------------U----------------S-------S----------U--------------------------------------------S-----S----------------------S----------------------U--S---
-----------------------------------------------------------------------------------------------------------------------------------------------------------------------------------------------------CCC
--------------------------------------------------------------------------------------------------------------------------------------------------------------------------------------------------------
--------------------------------------------------------------------------------------------------------------------------------------------------------------------------------------------------------
--------------------------------------------------------------------------------------------------------------------------------------------------------------------------------------------------------
U----------------Ctt-------------S#S-S--C---#----tt---------C----S-----#--#U--#-Ctt#--U---------C--------------------------#-####--######C-##-#####-###########---##-#####-######UUUUUUUUUUUUUUUUCUU-SSS
---------------#--tt--------------#---------#----tt--------------------#--#---#--tt#----------#----------------------------#-####--######--##-#####-###########tt-##-#####-######-----------------------
-------------#-#--tt-------tt-tt--#----#----#----tt----------##--------#--#---#--tt#----------#--------#-------------------######--######--##-#####-###########tt-##-#####-######-----------------------
-kk-g-k-g-g#-#-#g-tt-g-k-g-tt-tt--#-g--#---##-k-gtt-k-k-g-g--##-----g#-#-g#-g-#k-tt#g---k-g-g-#k--g-g--#ggg-g-k-g--k-k-k-k-######g-######--##g#####-###########tt-##k#####g######-------------------g--F
%||%|%|%|%||-|-||%||%|%|%|%||-||%%|%|%-|%%%||%|%|||%|%|%|%|%%||%%%--||%|%||%|-||%||||-%%|%|%|%||%-|%|%%||||%|%|%|%%|%|%|%|%|||||||%||||||%%||||||||%|||||||||||||%|||||||||||||||%%%%%%%%%%%%%%%%%%%|%%%
||||||||||||-|-||||||||||||||-||||||||-|||||||||||||||||||||||||||--|||||||||-|||||||-|||||||||||-||||||||||||||||||||||||||||||||||||||||||||||||||||||||||||||||||||||||||||||||||||||||||||||||||||||
