--------------------------------------------------------------------------------------------------------------------------------------------------------------------------------------------------------
--------------------------------------------------------------------------------------------------------------------------------------------------------------------------------------------------------
--------------------------------------------------------------------------------------------------------------------------------------------------------------------------------------------------------
--------------------------------------------------------------------------------------------------------------------------------------------------------------------------------------------------------
--------------------------------------------------------------------------------------------------------------------------------------------------------------------------------------------------------
-------------------------------------B---BB--B---B-----U--------------------BU----------B------------------------U-------------------------------------B-----------------B------------------------------
--C--------------------------------------------------------------------------------------------------------C-------------------CCCCCCCCCCCC-CCCCCCCCCCC-CCCCCCC--CCC--CCC-CCCCCCCCCCCCCCC-CCCCCC-CCCCCCC
--------------------------------------------------------------------------------------------------------------------------------------------------------------------------------------------------------
--------------------------------------------------------------------------------------------------------------------------------------------------------------------------------------------------------
--------------------------------------------------------------------------------------------------------------------------------------------------------------------------------------------------------
--B-tt-------------------------U-B----B-------U--------C---------------------C--------tt------tt-----------B#CU--CU------------BBBBBBBBBBBB-BBBBBBBBBBB-BBBBBBB-UBBB--BBB-BBBBBBBBBBBBBBB-BBBBBB-BBBBBBB
----tt-----------------------------tt---------------------tt------------------##--tt#-tt------tt------------#-------------------------------------------------------------------------------------------
----tt-----------------------------tt----------#--------tttt-----------tt##---##--tt#-tt------tttt----------#-------------------------------------------------------------------------------------------
-#--ttg-k-g-g-g--k-k-g-k--k-g-g---gtt----ggg#--##gk-g-g-ttttg-k-g-g-g-#tt##-g-##g-tt##tt-k-g-ktttt-g-kg-k---#-------k-g-k-g-g--------------g-----------g------------#--------------------g------g------F
XXXXXXXXXXXXXXXXXXXXXXXXXXXXXXXXXXXXX-XXXXXXX-XXXXXXXXXXXXXXXXXXXXXXXXXXXXXXXXXXXXXXXXXX-XXXXXXXXXXXXXXXXXXXXXXX-XXXXXXXXXXXXXXXXXXXXXXXXXXXXXXXXXXXXXXXXXXXXXXXXXXXXXXXXXXXXXXXXXXXXXXXXXXXXXXXXXXXXXXX
XXXXXXXXXXXXXXXXXXXXXXXXXXXXXXXXXXXXX-XXXXXXX-XXXXXXXXXXXXXXXXXXXXXXXXXXXXXXXXXXXXXXXXXX-XXXXXXXXXXXXXXXXXXXXXXX-XXXXXXXXXXXXXXXXXXXXXXXXXXXXXXXXXXXXXXXXXXXXXXXXXXXXXXXXXXXXXXXXXXXXXXXXXXXXXXXXXXXXXXX
