--------------------------------------------------------------------------------------------------------------------------------------------------------------------------------------------------------
--------------------------------------------------------------------------------------------------------------------------------------------------------------------------------------------------------
--------------------------------------------------------------------------------------------------------------------------------------------------------------------------------------------------------
--------------------------------------------------------------------------------------------------------------------------------------------------------------------------------------------------------
--------------------------------------------------------------------------------------------------------------------------------------------------------------------------------------------------------
UU-----------B--------------U-----------BU--------------------B-------------B----------B-------------------BB--B----B------U------BBB-------------------------------------------------------------------
----------------C-----------------------------------------------------------------------------------------------------------C---------------------------------------------------------------------------
--------------------------------------------------------------------------------------------------------------------------------------------------------------------------------------------------------
--------------------------------------------------------------------------------------------------------------------------------------------------------------------------------------------------------
--------------------------------------------------------------------------------------------------------------------------------------------------------------------------------------------------------
CCU--B-----#---UB----BC---##C------------CttU-------------tt---Utt--------------------------------------------B------U--U#-CB--------tttttttttttttttttttttttttt-tttttt-ttttttttttUtttttttttttttttttttttt
----------##--#--tt------###--------------tt--------------tt----tt-------------------------#-----------------------------#-----------tttttttttttttttttttttttttt-tttttt-tttttttttt-tttttttttttttttttttttt
---------###--#--tt-----####--------------tt-#-#----------tttt--tt-------------------------#-----------------#--------tt-#---tt-tt---tttttttttttttttttttttttttt-tttttt-tttttttttt-tttttttttttttttttttttt
------g-####--#--ttg---#####-g#-g-k-k-k---tt-#-#-k-k---gggtttt--ttk-g-k-g-g#-----g-g-g-g---#gg-kg-g-g-k-g-gg-#-g-g--g-tt-#---tt-tt---ttttttttttttttttttttttttttktttttt-tttttttttt-tttttttttttttttttttttF
XXXXXXXXXXXX-XXXXXXXXXXXXXXXXXXXXXXXXXXX-XXXXXXXXXXXXXXXXXXXXXXXXXXXXXXXXXXXXXXX-XXXXXXXXXXXXXXXXXXXXXXXXXXXXXXXXXXXXXXXXXXXXXXXXX---XXXXXXXXXXXXXXXXXXXXXXXXXXXXXXXXXXXXXXXXXXXXXXXXXXXXXXXXXXXXXXXXXXX
XXXXXXXXXXXX-XXXXXXXXXXXXXXXXXXXXXXXXXXX-XXXXXXXXXXXXXXXXXXXXXXXXXXXXXXXXXXXXXXX-XXXXXXXXXXXXXXXXXXXXXXXXXXXXXXXXXXXXXXXXXXXXXXXXX---XXXXXXXXXXXXXXXXXXXXXXXXXXXXXXXXXXXXXXXXXXXXXXXXXXXXXXXXXXXXXXXXXXX
