--------------------------------------------------------------------------------------------------------------------------------------------------------------------------------------------------------
--------------------------------------------------------------------------------------------------------------------------------------------------------------------------------------------------------
--------------------------------------------------------------------------------------------------------------------------------------------------------------------------------------------------------
--------------------------------------------------------------------------------------------------------------------------------------------------------------------------------------------------------
--------------------------------------------------------------------------------------------------------------------------------------------------------------------------------------------------------
----------------------------------------------------------------------------------------------------------------------------------B-----------------------B---------------------------------------------
--------------------------------------------------------------------------------------------------C-C-C-CC-CCC--CC--C-CCC---CCCC-C-----C-C--C-C-C-C-C-C-C-----------------------------------------------
--------------------------------------------------------------------------------------------------------------------------------------------------------------------------------------------------------
--------------------------------------------------------------------------------------------------------------------------------------------------------------------------------------------------------
--------------------------------------------------------------------------------------------------------------------------------------------------------------------------------------------------------
-------------------------------------------------------------------------------C#-#---------tt----BBBBBBBB-BBB-CBBttBUBBB-B-BBBB-B---BUBBBBBBBBBBBBBBBBBBB-#######CU#####-#####-###tt###################
--------------------------------------------------------#-----------------------#-#----#-#--tt--------------------tt---------------------------------------#######--#####-#####-###tt###################
------------------------------------------------------#-#-----------------------#-#---##-#--tt---#----------------tt-----#------#--tt----------------------#######--#####-#####-###tt###################
k-k-g-k-g-k-g--k-g-k-g-k-g-g-k-g-g-k-gk-g--k-g-g-k-g-g#-#k-g-k-g-k-k-g-k-g-k-g--###--###-#--tt-#-#------------g---tt-----#------#--tt---------------------g#######--#####g#####g###tt##################F
XXXXXXXXXXXXXXXXXXXXXXXXXXXXXXXXXXXXXXXXXXXXXXXXXXXXXXX-XXXXXXXXXXXXXXXXXXXXXXXXXXXX-XXXXXX-XX-X-XXXXXXXXXXXXXXXXXXXXXXXXXXXXXXXXXXXXXXXXXXXXXXXXXXXXXXXXXXXXXXXXXXXXXXXXXXXXXXXXXXXXXXXXXXXXXXXXXXXXXXX
XXXXXXXXXXXXXXXXXXXXXXXXXXXXXXXXXXXXXXXXXXXXXXXXXXXXXXX-XXXXXXXXXXXXXXXXXXXXXXXXXXXX-XXXXXX-XX-X-XXXXXXXXXXXXXXXXXXXXXXXXXXXXXXXXXXXXXXXXXXXXXXXXXXXXXXXXXXXXXXXXXXXXXXXXXXXXXXXXXXXXXXXXXXXXXXXXXXXXXXX
