--------------------------------------------------------------------------------------------------------------------------------------------------------------------------------------------------------
--------------------------------------------------------------------------------------------------------------------------------------------------------------------------------------------------------
--------------------------------------------------------------------------------------------------------------------------------------------------------------------------------------------------------
--------------------------------------------------------------------------------------------------------------------------------------------------------------------------------------------------------
--------------------------------------------------------------------------------------------------------------------------------------------------------------------------------------------------------
-S-------------------------U-------S--------S------S--------S------------S------SS--------UU-S-----------------------U-USS-S-S-----------------------------------S--------------------------------------
----------------------------------------------------C-----C-------C---------------------------------------------------------------------------C---------------------------------------------------------
--------------------------------------------------------------------------------------------------------------------------------------------------------------------------------------------------------
--------------------------------------------------------------------------------------------------------------------------------------------------------------------------------------------------------
--------------------------------------------------------------------------------------------------------------------------------------------------------------------------------------------------------
---------ttS---------C--#UCC--#-----C--------U------S-#---S-------S-----#---------tt------CC--tt-------#---U----tt-ttCCC--U------Utt------U-ttSttU----------------------------S------UU-----------------
---------tt-----tt-tt---#-----#---------------#-------#---------------tt#---------tt--------#-tt-------#----tt--tt-tt----------tt-tttt-tt#--tt-tt-#-----------#-----------------------------------------
--tt----#tt-----tt#tt-tt#-----#---------------#-tt----#--#------------tt#---------tt---#tt--#-tt-------#----tt--tt-tt----------tt-tttt-tt#--tt-tt-#-----------##----------------tt----------------------
--tt-kg-#tt-k---tt#tt-tt#---k-#-k-gg-k--k-g-g-#gttg--g##-#---k-k-k----tt#--g-g----ttk-g#tt--#-tt-k-k-g-#-k--tt-gtt#tt----g-g-g-tt-tttt#tt#-ktt-tt-#g-g-g-k---g###g#####-######-#tt###--################F
%%||-||%|||%|%%%|||||%|||%%%|%|%|%||%|%%|%|%|%|||||-%|||-|%%%|%|%|%-%%|||%%|%|%-%%|||%||||%%|%||%|%|%|%|-|%%||%||||||%%%%|%|%|-||%||||||||%|||%||%||%|%|%|%%%||||||||||%||||||%||||||%%||||||||||||||||%
||||-||||||||||||||||||||||||||||||||||||||||||||||-||||-||||||||||-|||||||||||-||||||||||||||||||||||||-|||||||||||||||||||||-|||||||||||||||||||||||||||||||||||||||||||||||||||||||||||||||||||||||||
