--------------------------------------------------------------------------------------------------------------------------------------------------------------------------------------------------------
--------------------------------------------------------------------------------------------------------------------------------------------------------------------------------------------------------
--------------------------------------------------------------------------------------------------------------------------------------------------------------------------------------------------------
--------------------------------------------------------------------------------------------------------------------------------------------------------------------------------------------------------
--------------------------------------------------------------------------------------------------------------------------------------------------------------------------------------------------------
------------B----B-------------------------------B---U--------U---B----------------------U-UB---B---------------------------BB----------BB-B-BB---------------------------U--------------B--------------
----------------------------------------C-----------------------------------------------------------------------------C-------------------------CC------------------------------------------------------
--------------------------------------------------------------------------------------------------------------------------------------------------------------------------------------------------------
--------------------------------------------------------------------------------------------------------------------------------------------------------------------------------------------------------
--------------------------------------------------------------------------------------------------------------------------------------------------------------------------------------------------------
--C-------B----------------tt-----------B-----tt-----C----CU--Ctt------------------------C#C---U--------U-----#--B----B---C----------Btt--C-----BB---C-----------#--------C-----------------------------
-----------#------#--------tt-------------#tt-tt------------#--tt-----------#----#--------#------tt-----------#-#-----------------#---tt-------------------------#--------------------------------------
tt-#-----#-#------#--------tt-------------#tt-tt---tt-tttt--#--tt-----------#----##--#----#--tt--tt-----------#-#------tt------#tt#---tt----#--------------------#--------------------------------------
tt-#g-k-g#-#-k-g--#-k-k-g-gttg-g-k-k-g----#tt-ttgg#tt-tttt--#--tt-g--k-g-g-g#----###-#k-g-#-gtt--tt-g-g---g-g-###-k-g--tt--g--##tt#-#-tt---g#--g--ggg-ggggggggggg#gggggggg-ggggggggggggg--gggggggggggggF
XXXXXXXXXXXX-XXXXXXXXXXXXXXXXXXXXXXXXXXXXXXXXXXXXXXXXXXXXXXXXXXXXXXXXXXXXX-XXX-XXXXX-XXXXXXXXXXXXXXXXXXXXXXXXXXXXXXXXXXXX-XXX-XXXXX-XXXX--XXXXXXXXXXXXXXXXXXXXXXXXXXXXXXXXXXXXXXXXXXXXXXX-XXXXXXXXXXXXXX
XXXXXXXXXXXX-XXXXXXXXXXXXXXXXXXXXXXXXXXXXXXXXXXXXXXXXXXXXXXXXXXXXXXXXXXXXX-XXX-XXXXX-XXXXXXXXXXXXXXXXXXXXXXXXXXXXXXXXXXXX-XXX-XXXXX-XXXX--XXXXXXXXXXXXXXXXXXXXXXXXXXXXXXXXXXXXXXXXXXXXXXX-XXXXXXXXXXXXXX
