--------------------------------------------------------------------------------------------------------------------------------------------------------------------------------------------------------
--------------------------------------------------------------------------------------------------------------------------------------------------------------------------------------------------------
--------------------------------------------------------------------------------------------------------------------------------------------------------------------------------------------------------
--------------------------------------------------------------------------------------------------------------------------------------------------------------------------------------------------------
--------------------------------------------------------------------------------------------------------------------------------------------------------------------------------------------------------
----S-----------S--------S---------S-US-------------SS---------S---S---SS----------------------S-----------------------------------------S-S------------------------------------------------------------
--------------------------------------------------------------------------------------------------------------------------------------------------------------------------------------------------------
--------------------------------------------------------------------------------------------------------------------------------------------------------------------------------------------------------
--------------------------------------------------------------------------------------------------------------------------------------------------------------------------------------------------------
--------------------------------------------------------------------------------------------------------------------------------------------------------------------------------------------------------
---------------U----------##-----U---C-------------S------------------#-------------------------------------#SSS-SS---SS-SSS-----------------tt--------------C--------#-----tt--------------------------
-tt-----------------------##-tt-#---#----------#--------------#------##-----------------------------------tt#--------------------------------tt-----------------------#-----tt--------------------------
-tt-----------------------##-tt-#---#--------#-##-----tt-----##--tt-###-----------------------------------tt#--------------------------------tt-tt--------------------#-----tt--------------------------
#tt-gk-k-g--k-k---k-g-g-g-###tt-#--g#--k-g-g-#-###g---ttk-g-###--tt-###-g-k-g-k-g-k-#g-k-g-k-g--k-k-g-k-g-tt#------k-g------k----g-------g-g-tt-tt------k-k-g------g--#-----ttk------------------------F
|||%||%|%|%%|%|%-%|%|%|%|%|||||-|%%||%%|%|%|%|-||||%%%|||%|%|||--||%|||-|%|%|%|%|%|%||%|%|%|%|%%|%|%|%|%|%|||%%%%%%|%|%%%%%%|%%%%|%%%%%%%|%|%||%||%%%%%%|%|%|%%%%%%|%%|%%%%%|||%%%%%%%%%%%%%%%%%%%%%%%%%
||||||||||||||||-||||||||||||||-||||||||||||||-||||||||||||||||--||||||-||||||||||||||||||||||||||||||||||||||||||||||||||||||||||||||||||||||||||||||||||||||||||||||||||||||||||||||||||||||||||||||||
