--------------------------------------------------------------------------------------------------------------------------------------------------------------------------------------------------------
--------------------------------------------------------------------------------------------------------------------------------------------------------------------------------------------------------
--------------------------------------------------------------------------------------------------------------------------------------------------------------------------------------------------------
--------------------------------------------------------------------------------------------------------------------------------------------------------------------------------------------------------
--------------------------------------------------------------------------------------------------------------------------------------------------------------------------------------------------------
-------------S--S----------U-----------S---------------------S------------------------S-----------------------UU-------------S----------------S---------------------------U-----------------------------
------------C---------------------------------------------------------C-----------------------------------------C---------------------------------------------------------------------------------------
--------------------------------------------------------------------------------------------------------------------------------------------------------------------------------------------------------
--------------------------------------------------------------------------------------------------------------------------------------------------------------------------------------------------------
--------------------------------------------------------------------------------------------------------------------------------------------------------------------------------------------------------
tt----------S-----#------##C-----U--U------------------#C#-----ttUC--USC--------Utt#---##---------------------CCS-------U--U-----------C----------------------------------C-----------------------------
tt---------#------#------##----------------------------#-#-----tt--tt------------tt##--##-------------------------tttttt-tt---tttttt-tt-tttttt-#tttttttttttttttttttt--tttt-tttttttttttttttttt-----------
tt---------#------#------##----------------------------#-#-tt--tt--tt----tt------tt##--##-------------------#-----tttttt-tt---tttttt-tt-tttttt-#tttttttttttttttttttttttttt-tttttttttttttttttt-----------
ttk-g-k--g-#--#---#g-k---##-k-k-g-#g----k-g-k--k-k-g---#-##ttg-tt--tt----ttk-k---tt##--##g-k-g-g-k--k-g-k-g-#-----tttttt-tt-ggtttttt-tt-tttttt-#tttttttttttttttttttttttttt-tttttttttttttttttt##########F
|||%|%|%%|%|%%|--%||%|--%||%|%|%|%||%%%%|%|%|%%|%|%|%%%|%|||||%||%%||%%%%|||%|%%%||||%-|||%|%|%|%|%%|%|%|%|%|%%%%%||||||%||%||||||||%||%||||||%|||||||||||||||||||||||||||%||||||||||||||||||||||||||||%
|||||||||||||||--|||||--||||||||||||||||||||||||||||||||||||||||||||||||||||||||||||||-|||||||||||||||||||||||||||||||||||||||||||||||||||||||||||||||||||||||||||||||||||||||||||||||||||||||||||||||||
