--------------------------------------------------------------------------------------------------------------------------------------------------------------------------------------------------------
--------------------------------------------------------------------------------------------------------------------------------------------------------------------------------------------------------
--------------------------------------------------------------------------------------------------------------------------------------------------------------------------------------------------------
--------------------------------------------------------------------------------------------------------------------------------------------------------------------------------------------------------
--------------------------------------------------------------------------------------------------------------------------------------------------------------------------------------------------------
-----B--------------------------------------------------------B-B---------------------B-----B-BU---------------------------------B-----B------------------------------------------B---------------------
-------------------------------------------------------------------------------------------C------------------------------------------------------------------------------------------------------------
--------------------------------------------------------------------------------------------------------------------------------------------------------------------------------------------------------
--------------------------------------------------------------------------------------------------------------------------------------------------------------------------------------------------------
--------------------------------------------------------------------------------------------------------------------------------------------------------------------------------------------------------
tt----------------------------#-------------tt----U----------U----C--------------------ttBUB-B-C---------####--##U######-###--##--####--###---####--###--######B##C###############-#####################
tt---------------------------##-------------tt------tt---tt--------tt----------------#-tt----------------####--##-######-###--##--####--###--#####--###--######-##-###############-#####################
tt-#------------------------###-------------tttt----tt#tttt--------tt----------------#-tt----------------####tt##-######-###--##--####--###-######tt###tt######-##-###############-#####################
tt-#g--k-g-k-g-g-k-g-k-k-g-####-g-k-g--k-g-ktttt-#--tt#tttt-----g--ttkk-g-k--k-k-g-g-#-tt-----g-k-g-k-g-g####tt##-######g###k-##g-#####-##########tt###tt######-##-###############g####################F
XX-XX-XXXXXXXXXXXXXXXXXXXXXXXXXXXXXXXXXXXXXXXXXX-XXXXXXXXXXX-X--XXXXXXXXXXXXXXXXXXXXXX-XXXXXXXXXXXXXXXXXXXXXXXXXXXXXXXXXXXXXXXXXXXXXXXX-XXXXXXXXXXXXXXXXXXXXXXXXXXXXXXXXXXXXXXXXXXXXXXXXXXXXXXXXXXXXXXXX
XX-XX-XXXXXXXXXXXXXXXXXXXXXXXXXXXXXXXXXXXXXXXXXX-XXXXXXXXXXX-X--XXXXXXXXXXXXXXXXXXXXXX-XXXXXXXXXXXXXXXXXXXXXXXXXXXXXXXXXXXXXXXXXXXXXXXX-XXXXXXXXXXXXXXXXXXXXXXXXXXXXXXXXXXXXXXXXXXXXXXXXXXXXXXXXXXXXXXXX
