--------------------------------------------------------------------------------------------------------------------------------------------------------------------------------------------------------
--------------------------------------------------------------------------------------------------------------------------------------------------------------------------------------------------------
--------------------------------------------------------------------------------------------------------------------------------------------------------------------------------------------------------
--------------------------------------------------------------------------------------------------------------------------------------------------------------------------------------------------------
--------------------------------------------------------------------------------------------------------------------------------------------------------------------------------------------------------
----------UU-U--B-------------------------B-----B--------B--B-----------U--------------------U--------------U------------B---B----------B---------BBBB--BBB-BBBBBBBBB-BB-BBB-BBB-BBBB-BBBBBBBBBBBBBBBBBB
----------------------------C----------------------------------------------------------------------------C----------------------------------------------------------------------------------------------
--------------------------------------------------------------------------------------------------------------------------------------------------------------------------------------------------------
--------------------------------------------------------------------------------------------------------------------------------------------------------------------------------------------------------
--------------------------------------------------------------------------------------------------------------------------------------------------------------------------------------------------------
----------CCBC-#-----C#-U#--B-------UCU-------------C--CC--------B---B--C--C---#-------CB----CBB-B------UBB-C-C--U--------#-U-U----------B---tt-------CB---B---------B--B---B---B----B------------------
--------tt-----#------#--#---#-----#-------#-----#-----------#-tt--#-----------#--#tt-----------------tt-------tt-------#-#------------------tt-tt------------------------------------------------------
--------tt-----#--tt--#--#tt-#-----#-------##----#-----------#-tt--#-----------#--#tt-----------------tt---#---tt---tt-##-#---------------tt#tt-tt------------------------------------------------------
-g-k-g-gtt-----#-gttg-#--#tt-#g-g-g#-------###gk-#g--k----k-g#ktt--#--##-g--k-g#-g#ttk---k-g------k-g-tt---#---tt-g-tt###-#--g---k-g-g----tt#tt-tt-----------------------------------------------------F
XXXXXXXXXXXXXXXX-XXXXXXXXXXXXXXXXXXXXXXXXX-XXXXXXXXXXX-XXXXXXXXXXXXXXXXXXXXXXXXXXXXXXX-XXXXXXXXXXXXXXXXXXXXXX-XXXXXXXXXXX-XXXXXX-XXXXXXX-XXXXXXXXXXX--XXXXXXXXXXXXXXXXXXXXXXXXXXXXXXXXXXXXXXXXXXXXXXXXXX
XXXXXXXXXXXXXXXX-XXXXXXXXXXXXXXXXXXXXXXXXX-XXXXXXXXXXX-XXXXXXXXXXXXXXXXXXXXXXXXXXXXXXX-XXXXXXXXXXXXXXXXXXXXXX-XXXXXXXXXXX-XXXXXX-XXXXXXX-XXXXXXXXXXX--XXXXXXXXXXXXXXXXXXXXXXXXXXXXXXXXXXXXXXXXXXXXXXXXXX
