--------------------------------------------------------------------------------------------------------------------------------------------------------------------------------------------------------
--------------------------------------------------------------------------------------------------------------------------------------------------------------------------------------------------------
--------------------------------------------------------------------------------------------------------------------------------------------------------------------------------------------------------
--------------------------------------------------------------------------------------------------------------------------------------------------------------------------------------------------------
--------------------------------------------------------------------------------------------------------------------------------------------------------------------------------------------------------
---BB-------------------------------------------------------------------U----B-BB---B------BB--BB-------------------------------------------------------------------------B-----------------------------
-------------------------------------------------------------------------------------------------------------------------C------------------------------------------------------------------------------
--------------------------------------------------------------------------------------------------------------------------------------------------------------------------------------------------------
--------------------------------------------------------------------------------------------------------------------------------------------------------------------------------------------------------
--------------------------------------------------------------------------------------------------------------------------------------------------------------------------------------------------------
#-B--#tt--------------B------------#C----------------------------------CCtt-#-B---------#-B--UB--C-------tt--------#-----B--------------------B------------C--------------------------------------------
#----#tt---------------------------#-------------------------------------tt-#----tt----##----------------tt--------#---#-------------tt-----------------------------------------------------------------
#----#tt---tt----------------------#-------------------------------------tt-#----tt---###----------------tt--------#---#--------tt---tt---------------------tt------------------------------------------
#----#tt-ggttk-k-g-k---g-k-kk-g----#--k-g-g--k--g-k-g-g-k-k-g-g-g-k-g----ttg#----tt--####g--------kg-k-g-tt-g############--###-#tt###tt#-#####-#####-######-tt############-#k-k###g####################F
XXX--XXXXXXXXXXXXXXXXXXXXXXXXXXXXXXXXXXXXXXXXXXXXXXXXXXXXXXXXXXXXXXXXXXXXXXXX-XXXXXXXXXXXXXXXXX--XXXXXXXXXXXXXXXXXXXXXXXXX-XXXXXXXXXXXXXXXXXXXXXXXXXXXXXXXXXXXXXXXXXXXXXXXXXXXXXXXXXXXXXXXXXXXXXXXXXXXXX
XXX--XXXXXXXXXXXXXXXXXXXXXXXXXXXXXXXXXXXXXXXXXXXXXXXXXXXXXXXXXXXXXXXXXXXXXXXX-XXXXXXXXXXXXXXXXX--XXXXXXXXXXXXXXXXXXXXXXXXX-XXXXXXXXXXXXXXXXXXXXXXXXXXXXXXXXXXXXXXXXXXXXXXXXXXXXXXXXXXXXXXXXXXXXXXXXXXXXX
