--------------------------------------------------------------------------------------------------------------------------------------------------------------------------------------------------------
--------------------------------------------------------------------------------------------------------------------------------------------------------------------------------------------------------
--------------------------------------------------------------------------------------------------------------------------------------------------------------------------------------------------------
--------------------------------------------------------------------------------------------------------------------------------------------------------------------------------------------------------
--------------------------------------------------------------------------------------------------------------------------------------------------------------------------------------------------------
-------S--U--------------------SS----S---------------S-----------------SSS------S----SS---------S-------------------------------------S-----------------------------------------------------------------
--------C-----------------------------------------------------------------------------------------------------------------------------------------------------------------------------------------------
--------------------------------------------------------------------------------------------------------------------------------------------------------------------------------------------------------
--------------------------------------------------------------------------------------------------------------------------------------------------------------------------------------------------------
--------------------------------------------------------------------------------------------------------------------------------------------------------------------------------------------------------
--------S-C-------------------S----------U--------CU--CS#-#------###U-U-----tt-#---tt----------------------------------------------------------------------------------------------------------------#--
----------------------------------#---------------------#-#-----####--------tt##--#tt--tt----#-------------------------------------------------------------------------------------------------------#--
-----------tt---------------------##--------------------#-#----#####--------tt##--#tt--tt-##-##------------------------------------------------------------------------------------------------------#--
-k-g-gg----tt-k-g--k-g-g-k-g-----k###ggg--g-k-k-g---#g--#-#k--######-#--g-ggtt##--#ttggtt-##-###gk-g-k-g--g-k-k-g-g-k-k--k-g--k-g-g---gk-k--k-k-g---g-g--g-g--k--g-k-k-g--k--k-k-k-g-g---k-g---k-g---#-F
%|%|%||%%%%||%|%|%%|%|%|%|%|%%%--|||||||%%|%|%|%|%%%||%%|-||-%||||||%|%-|-||||||-%|||||||%||-|||||%|%|%|%%|%|%|%|%|%|%|%%|%|%%|%|%|%%%||%|%%|%|%|%%%|%|%%|%|%%|%%|%|%|%|%%|%%|%|%|%|%|%%%|%|%%%|%|%%%|%%
|||||||||||||||||||||||||||||||--||||||||||||||||||||||||-||-||||||||||-|-||||||-|||||||||||-|||||||||||||||||||||||||||||||||||||||||||||||||||||||||||||||||||||||||||||||||||||||||||||||||||||||||||
