--------------------------------------------------------------------------------------------------------------------------------------------------------------------------------------------------------
--------------------------------------------------------------------------------------------------------------------------------------------------------------------------------------------------------
--------------------------------------------------------------------------------------------------------------------------------------------------------------------------------------------------------
--------------------------------------------------------------------------------------------------------------------------------------------------------------------------------------------------------
--------------------------------------------------------------------------------------------------------------------------------------------------------------------------------------------------------
-------------------------------------------------------------------------------------------------------------------------B---------------U---UUU-U-----------------------------B------------------------
--------------------------------------------------------------------------------------------------------------------------------------------------------------------------------------------------------
--------------------------------------------------------------------------------------------------------------------------------------------------------------------------------------------------------
--------------------------------------------------------------------------------------------------------------------------------------------------------------------------------------------------------
--------------------------------------------------------------------------------------------------------------------------------------------------------------------------------------------------------
-------------Btt---------------------------U---------------------------------------------------------------------------BB--B-B#BBB-BBUBBBC---CCC-C------------------------------------------------------
#-------------tt------------------------------tt------------------------------------------------------------------------------#-----------#-------tt-tttttttttttttt#tt#tttttttt-tttttttttttttttttttttttt
#-------------tt------------------------------tt------------------------------------------------------------------------------#-----------##------tt#tttttttttttttt#tt#tttttttt-tttttttttttttttttttttttt
#k-g-k-g-k-g--ttg-g-k-k-gk-k-g--k--k-g-g-g--k-tt-k-g--k-g-k-g-k----k-k-g-k-g-g-g--k--k-k-g-g-k-g--g-g-g-k-g-k-g-k-g--g----g---#-----------###---#-tt#tttttttttttttt#tt#tttttttt-tttttttttttttttttttttttF
XXXXXXXXXXXXXXXXXXXXXXXXXXXXXXXXXXXXXXXXXXXXXXXXXXXXXXXXXXXXXXXXX--XXXXXXXXXXXXXXXXXXXXXXXXXXXXXXXXXXXXXXXXXXXXXXXXXXXXXXXXXXXXXXXXXXXXXXXXXXXXXXXXXXXXXXXXXXXXXXXXXXXXXXXXXXXX-XXXXXXXXXXXXXXXXXXXXXXXX
XXXXXXXXXXXXXXXXXXXXXXXXXXXXXXXXXXXXXXXXXXXXXXXXXXXXXXXXXXXXXXXXX--XXXXXXXXXXXXXXXXXXXXXXXXXXXXXXXXXXXXXXXXXXXXXXXXXXXXXXXXXXXXXXXXXXXXXXXXXXXXXXXXXXXXXXXXXXXXXXXXXXXXXXXXXXXX-XXXXXXXXXXXXXXXXXXXXXXXX
