--------------------------------------------------------------------------------------------------------------------------------------------------------------------------------------------------------
--------------------------------------------------------------------------------------------------------------------------------------------------------------------------------------------------------
--------------------------------------------------------------------------------------------------------------------------------------------------------------------------------------------------------
--------------------------------------------------------------------------------------------------------------------------------------------------------------------------------------------------------
--------------------------------------------------------------------------------------------------------------------------------------------------------------------------------------------------------
-----------------------------------S--SSU----------------------------------------------S--U------S-------------------------------S-----S----------------S-----U---S-------------------------------------
--------------------------------------------------------------------------------------------------------------------------------------------------------------------------------------------------------
--------------------------------------------------------------------------------------------------------------------------------------------------------------------------------------------------------
--------------------------------------------------------------------------------------------------------------------------------------------------------------------------------------------------------
--------------------------------------------------------------------------------------------------------------------------------------------------------------------------------------------------------
---------tt-------#--------------#---S--C----------------SS-----------------------------UUC-tt----------------U-----------------#------------------------#---#C-----------------------------------------
---------tt-tt#--##--------------#-------tt-------------------------------------------------tt----------------------------------#------------tt----------#--##------------------------------------------
---------tt-tt#-###--------------#-------tt-------------------------------------------------tt-tt-----------##-#--###-----#tt####-###-#-#####tt#########-#-###-##--#########################-###########
k-g-g-k-gtt-tt#####g-k-k-g-k-g--g#g------tt-k-g-k-k--g-----k-g-k--k-g-g-k--g-g-k--k--g------tt-tt-g-k-k-k-g-##-#g-###g-k-g#tt####-###-#g#####tt#########g#####-##--#########################-##########F
|%|%|%|%|||%||||||||%|%|%|%|%|%%|||%%%--%||%|%|%|%|%%|%%%%%|%|%|%%|%|%|%|%%|%|%|%%|%%|%%%%%%||-||-|%|%|%|%|%||%||%||||%|%||||||||-|||%||||||||||||||||||||||||%||%-|||||||||||||||||||||||||-||||||||||%
||||||||||||||||||||||||||||||||||||||--||||||||||||||||||||||||||||||||||||||||||||||||||||||-||-|||||||||||||||||||||||||||||||-||||||||||||||||||||||||||||||||-|||||||||||||||||||||||||-|||||||||||
