--------------------------------------------------------------------------------------------------------------------------------------------------------------------------------------------------------
--------------------------------------------------------------------------------------------------------------------------------------------------------------------------------------------------------
--------------------------------------------------------------------------------------------------------------------------------------------------------------------------------------------------------
--------------------------------------------------------------------------------------------------------------------------------------------------------------------------------------------------------
--------------------------------------------------------------------------------------------------------------------------------------------------------------------------------------------------------
---------------------------------------------------------------------------------------------------------------------------------------B--B---------------U---------------------------------------------
--------------------------------------------------------------------------------------------------------------------------------------------------------------------------------------------------------
--------------------------------------------------------------------------------------------------------------------------------------------------------------------------------------------------------
--------------------------------------------------------------------------------------------------------------------------------------------------------------------------------------------------------
--------------------------------------------------------------------------------------------------------------------------------------------------------------------------------------------------------
------------------------tt------------------------------------------------------------------------------------------------tt--------#-----------U----C----C---tt---#U---------B-----------------#-------
------------------------tt----------------------------------------#------------------------------------------------------#tt--------#---tt--------------------tt---#----------------------------#-------
------------------------tt----------------------------------------#------------------------------------------------------#tt--------#---tt--------------##-###tt####-###-#tt##-#########################
k-k-g--k-g-k-k-g-k-k-k-gttg-k-g-k-g-k-g-k-k-g-k--g--k-g-g-k-k-g-g-#g-k-g-g-k-k-g-g-g-k-g-k-g-g-g--k-g--------------------#tt--------#--gttg---------g-gg##-###tt####-###k#tt##-########################F
XXXXXXXXXXXXXXXXXXXXXXXXXXXXXXXXXXXXXXXXXXXXXXXXXXXXXXXXXXXXXXXXXXXXXXXXXXXXXXXXXXXXXXXXXXXXXXXXXXXXXX--XX--XX--XX--XX--XXXX--XXX--XXX-XXXX-----X-X-XXXXXXXXXXXXXXXXXXXXXXXXXXXXXXXXXXXXXXXXXXXXXXXXXXXX
XXXXXXXXXXXXXXXXXXXXXXXXXXXXXXXXXXXXXXXXXXXXXXXXXXXXXXXXXXXXXXXXXXXXXXXXXXXXXXXXXXXXXXXXXXXXXXXXXXXXXX--XX--XX--XX--XX--XXXX--XXX--XXX-XXXX-----X-X-XXXXXXXXXXXXXXXXXXXXXXXXXXXXXXXXXXXXXXXXXXXXXXXXXXXX
