--------------------------------------------------------------------------------------------------------------------------------------------------------------------------------------------------------
--------------------------------------------------------------------------------------------------------------------------------------------------------------------------------------------------------
--------------------------------------------------------------------------------------------------------------------------------------------------------------------------------------------------------
--------------------------------------------------------------------------------------------------------------------------------------------------------------------------------------------------------
--------------------------------------------------------------------------------------------------------------------------------------------------------------------------------------------------------
------------------------------------------------------------------------------------BB------------------------------------------------------------------------------------------------------------------
-----C--------------------------------------------------------------------------------------------------------------------------------------------------------------------------------------------------
--------------------------------------------------------------------------------------------------------------------------------------------------------------------------------------------------------
--------------------------------------------------------------------------------------------------------------------------------------------------------------------------------------------------------
--------------------------------------------------------------------------------------------------------------------------------------------------------------------------------------------------------
-----B-----------------------------------------------------------------------------B-------------------------------------------------------------------------------------------------------------tt-----
--------------------------------------------------------------------------------------#----------------------------------------------------------------------------------------------------------tt-----
--------------------------------------------------------------------------------------#----------------------------------------------------------------------------------------------------------tt-----
-k-g--#-k-k-g-g-g-g-k-g-k-g--k-g-k-g-kk-g-g--k-g--k-g-k-g--k-g--k-g-g-k-g-k-g--g-k----#gk-k-g-g--g-k-g-k-g--k--g-k-k-g-g-k-g-k-k-g--k-g-k-k-k-k--k-g-g-g-k-g-k-g-k-k-g--k-g-k-g-g-g-k-k-g-k-k-g--tt----F
XXXXXXXXXXXXXXXXXXXXXXXXXXXXXXXXXXXXXXXXXXXXXXXXXXXXXXXXXXXXXXXXXXXXXXXXXXXXXXXXXXXXXXXXXXXXXXXXXXXXXXXXXXXXXXXXXXXXXXXXXXXXXXXXXXXXXXXXXXXXXXXXXXXXXXXXXXXXXXXXXXXXXXXXXXXXXXXXXXXXXXXXXXXXXXXXXXX-----
XXXXXXXXXXXXXXXXXXXXXXXXXXXXXXXXXXXXXXXXXXXXXXXXXXXXXXXXXXXXXXXXXXXXXXXXXXXXXXXXXXXXXXXXXXXXXXXXXXXXXXXXXXXXXXXXXXXXXXXXXXXXXXXXXXXXXXXXXXXXXXXXXXXXXXXXXXXXXXXXXXXXXXXXXXXXXXXXXXXXXXXXXXXXXXXXXXX-----
