--------------------------------------------------------------------------------------------------------------------------------------------------------------------------------------------------------
--------------------------------------------------------------------------------------------------------------------------------------------------------------------------------------------------------
--------------------------------------------------------------------------------------------------------------------------------------------------------------------------------------------------------
--------------------------------------------------------------------------------------------------------------------------------------------------------------------------------------------------------
--------------------------------------------------------------------------------------------------------------------------------------------------------------------------------------------------------
-----------------------S-----------------------------------------------------------------------S---------------------------------------------------S----------------------------------------------------
------------------------------------------------------------------------------------------------C-----C--CCC--CC--C-C--C---CCC------CCCCCCC-----CCC--CC--CC--CCCC-CCCC--C--CCCCCCCCC--CCCCCCC-----------
--------------------------------------------------------------------------------------------------------------------------------------------------------------------------------------------------------
--------------------------------------------------------------------------------------------------------------------------------------------------------------------------------------------------------
--------------------------------------------------------------------------------------------------------------------------------------------------------------------------------------------------------
------------------------------------------------------------------------------------------------S-----S--SSS--SS--S-S--S---SSS------SSSSSSStt---SSS--SS--SS--SSSS-SSSS--SttSSSSSSSSS--SSSSSSS-----------
-------------------------------------------------------------------#-----------------------------#--------------tt-------------tt----------tt----------tt----------------tt-----------------------------
-----------------------------------------------------------------#-#-------------#---------------#-----tt-------tt-------------tt----------tt----------tt---#----------#-tt----------#------------------
k-k-k-g-k-g-g-k-g--g-g--k-g-k-g-k-g-k--k-g-k-g-g-k-g-g--g-k-g-k--#-#k-k-g-k-g-k--#g-g-k-g--k-g---#k-g--tt-------tt---k--g------ttgg--------tt-g--------tt--##---------k#-tt----------#-------##########F
|%|%|%|%|%|%|%|%|%%|%|%%|%|%|%|%|%|%|%%|%|%|%|%|%|%|%|%%|%|%|%|%%|-||%|%|%|%|%|%-||%|%|%|%%|%|-%%||%|%%||%%%%%%%||%%%|%%|%%%%%%||||%%%%%%%%||%|%%%%-%%%||%%||%%%%%%%%%||%||%%%%%%%%%%|%%%%%%%||||||||||%
||||||||||||||||||||||||||||||||||||||||||||||||||||||||||||||||||-|||||||||||||-|||||||||||||-||||||||||||||||||||||||||||||||||||||||||||||||||||-||||||||||||||||||||||||||||||||||||||||||||||||||||
