--------------------------------------------------------------------------------------------------------------------------------------------------------------------------------------------------------
--------------------------------------------------------------------------------------------------------------------------------------------------------------------------------------------------------
--------------------------------------------------------------------------------------------------------------------------------------------------------------------------------------------------------
--------------------------------------------------------------------------------------------------------------------------------------------------------------------------------------------------------
--------------------------------------------------------------------------------------------------------------------------------------------------------------------------------------------------------
BB-----U---BB----B---B-------B-----------B-------B------------B-----------------------------------------BBB-BBB--BBB--BBBB-BB-BBB-------B-BBUBBBBU-BBB-BBB-BB-B-BBB-BBBB-BBBB--BBB-BBBBBBBBBBBBBBBBBBBBB
-------------------------CC-----------------------------------------------------------------------------------------------------------------------------------------------------------------------------
--------------------------------------------------------------------------------------------------------------------------------------------------------------------------------------------------------
--------------------------------------------------------------------------------------------------------------------------------------------------------------------------------------------------------
--------------------------------------------------------------------------------------------------------------------------------------------------------------------------------------------------------
-------C-#B--------------BB---#-------------------Btt----------------------------------B---------------B---B----B----B----B--B-----------B--C----CB---B---B--B-B---B----B---------B---------------------
-----tt--#--------tt#-#-------#tt------------------tt------------------------------------------------------------------------------------------------------------------------tt-------------------------
---tttt-##--------tt#-##------#tt------------------tttt---------------------tt-----------------------------------------------------------------------------------------------tt-------------------------
g--tttt-##---g--#gtt#g###--k-g#ttk-k-g-g--k-g-g-gg-ttttk-k-g----kg-k-k-g-g#-ttg-kk-g-g---k-g-k-g-g-g-g---------k-----------------#g-k-g-----------------------g--------------tt------------------------F
XX-XXXXXXXXXXXXXXXXXXXXXXXXXXXXXXXXXXXXXX-XXXXXXXXXXXXXXXXXXXXXXXXXXXXXXXXXXXXXXXXXXXXXXXXXXXXXXXXXXXXXX---X---XX---XX----X--X---XXXXXXX-X--X----XX---X---X--XXX---X----X----XX---X---------------------
XX-XXXXXXXXXXXXXXXXXXXXXXXXXXXXXXXXXXXXXX-XXXXXXXXXXXXXXXXXXXXXXXXXXXXXXXXXXXXXXXXXXXXXXXXXXXXXXXXXXXXXX---X---XX---XX----X--X---XXXXXXX-X--X----XX---X---X--XXX---X----X----XX---X---------------------
