--------------------------------------------------------------------------------------------------------------------------------------------------------------------------------------------------------
--------------------------------------------------------------------------------------------------------------------------------------------------------------------------------------------------------
--------------------------------------------------------------------------------------------------------------------------------------------------------------------------------------------------------
--------------------------------------------------------------------------------------------------------------------------------------------------------------------------------------------------------
--------------------------------------------------------------------------------------------------------------------------------------------------------------------------------------------------------
----------------B-----B----U---------------------------BU------BB--------------B-----U------------------------------------B-------------------------------------B---------------------------------------
-----------------------------------------------------------------C--------------------------------------------------------------------------------------------------------------------------------------
--------------------------------------------------------------------------------------------------------------------------------------------------------------------------------------------------------
--------------------------------------------------------------------------------------------------------------------------------------------------------------------------------------------------------
--------------------------------------------------------------------------------------------------------------------------------------------------------------------------------------------------------
tt-------------------------CUtt-#--BCB--------------##--C-tt-----B-C----------C------C---------------------------------tt----C-C------------------------------------------------------------------------
tt---------------tt----------tt-#-------------------##----tt#-----------------------------------------------#-tt---#---tt-------------------------------------------------------------------------------
tt-----------#---tt#tt-tt----tt-#-------------------##----tt#-----------------------#---------------------#-#-tt-#-####tt#-##-#-#tt--#######-#-#################-#-####-###-#####-#######-##############
tt-----gg-k-g#--gtt#ttgttk---tt-#-----g-k-g-k-g-k-g-##---ktt#g-gg----kg-k-g-k--g-##-#-g-k-g--g-g-k-g-k-g--#-#-tt-#-####tt#-##-#-#tt-g#######k#g#################-#g####-###-#####-#####################F
XXX--XXXXXXXXXXXXXXXXXXXXXXXXXXXX-XXXXXXXXXXXXXXXXXXXXX-XXXXXXXXXXXXXXXXXXXXXXXX-XX-XXXXXXXXXXXXXXXXXXXXXXX-XXXX-X-XXXXXXXXXXXXXXXXXXXXXXXXXXXXXXXXXXXXXXXXXXXXX-XXXXXX-XXXXXXXXXXXXXXXXXXXXXXXXXXXXXXXX
XXX--XXXXXXXXXXXXXXXXXXXXXXXXXXXX-XXXXXXXXXXXXXXXXXXXXX-XXXXXXXXXXXXXXXXXXXXXXXX-XX-XXXXXXXXXXXXXXXXXXXXXXX-XXXX-X-XXXXXXXXXXXXXXXXXXXXXXXXXXXXXXXXXXXXXXXXXXXXX-XXXXXX-XXXXXXXXXXXXXXXXXXXXXXXXXXXXXXXX
