--------------------------------------------------------------------------------------------------------------------------------------------------------------------------------------------------------
--------------------------------------------------------------------------------------------------------------------------------------------------------------------------------------------------------
--------------------------------------------------------------------------------------------------------------------------------------------------------------------------------------------------------
--------------------------------------------------------------------------------------------------------------------------------------------------------------------------------------------------------
--------------------------------------------------------------------------------------------------------------------------------------------------------------------------------------------------------
---------------------------------------S-----------------------------------------------S----------------------------------------------------------------------------------------------------------------
--------------------------------------C-----------------------------------------------------------------------------------------------------------------------------------------------------------------
--------------------------------------------------------------------------------------------------------------------------------------------------------------------------------------------------------
--------------------------------------------------------------------------------------------------------------------------------------------------------------------------------------------------------
--------------------------------------------------------------------------------------------------------------------------------------------------------------------------------------------------------
---------------------------------ttS--S-ttU-C--------------------------------------------C--------------------------------------------------------------------------------------------------------------
---------------------------------tt-----tt----------------------tt---------------------------------------------------------------------------------------------------------------------------------#----
---------------------------------tt-----tt----------------------tt----------------------#---------------------------------------------------------------------#--------------------#---------------#----
k-g-g-g-k-g-g-k-g-k-g-k-g-g-k-g--tt-g---tt---g-k-k-g-gk-g-k-g-g-tt-k-gk-g-g-k-g--k-g----#-g-k-g-k-k-k-g-g-g-k-k-g-g-k-g-g-k-k-g-g-g-k-k--k-g--k--k-g-g-g-k-g--#g-k-k-g---k-k-g---gg#ggggggggggggggg#gggF
|%|%|%|%|%|%|%|%|%|%|%|%|%|%|%|%-||%|%%%||%%%|%|%|%|%||%|%|%|%|%||%|%||%|%|%|%|%%|%|%%%%|%|%|%|%|%|%|%|%|%|%|%|%|%|%|%|%|%|%|%|%|%|%|%|%%|%|%%|%%|%|%|%|%|%|%%||%|%|%|%%%|%|%|%%%||||||||||||||||||||||%
||||||||||||||||||||||||||||||||-|||||||||||||||||||||||||||||||||||||||||||||||||||||||||||||||||||||||||||||||||||||||||||||||||||||||||||||||||||||||||||||||||||||||||||||||||||||||||||||||||||||||
