--------------------------------------------------------------------------------------------------------------------------------------------------------------------------------------------------------
--------------------------------------------------------------------------------------------------------------------------------------------------------------------------------------------------------
--------------------------------------------------------------------------------------------------------------------------------------------------------------------------------------------------------
--------------------------------------------------------------------------------------------------------------------------------------------------------------------------------------------------------
--------------------------------------------------------------------------------------------------------------------------------------------------------------------------------------------------------
-------BU--B------------U-----------------BB------------U------------------------------------UB---------B------------------------------------------------------------------B----------------------------
---------------------------------------------------------------------C----C-----------------------------------------------------------------------------------------------------------------------------
--------------------------------------------------------------------------------------------------------------------------------------------------------------------------------------------------------
--------------------------------------------------------------------------------------------------------------------------------------------------------------------------------------------------------
--------------------------------------------------------------------------------------------------------------------------------------------------------------------------------------------------------
-----B--C------------#U-C-------------#--#--#-----------C------------B--UBBtt----U-------ttUUC---#-------UB--------------------------------tt---------------U-------------------------------------------
--#------------------#----------------#tt#--#------------tt-----------tt---tt-----tt-----tt-----##----------------tt-tt-tttt#--tttttttttttttt-----------#--------------tt-------------------tt----------
#-##-----tt----------#----------------#tt#--#------------tt-----------tt---tt-----tt-----tt----###----------------tt-tt-tttt##-tttttttttttttt-----------#-#------------tt---tt--------------tt----------
#-###-g--tt-k-g-g-g--#---g-k-k-g-k-g--#tt#g-#-k-k-g-g----ttg-k-g------tt---ttk----tt-k-g-tt----###k-g---g--k-k-g--tt-tt-tttt###ttttttttttttttgggg-gggggg###g-ggggggggggttgg-ttgggggggg-gggggttgggggggggF
X-XXXXXXXXXXXXXXXXXXXXXXXXXXXXXXXXXXXXXXXXX-XXXXXXXXXXX-XXXXXXXXXXX--XXXXXXXXXXXXXXXXXXXXXXXXXXXXXXXXXXXXXXXXXXXXXXXXXXXXXXXXXXXXXXXXXXXXXXXXXXXX-XXXXXXXXXXXXXXXXXXXXXXXXX-XXXXXXXXXX-XXXXXXXXXXXXXXXXX
X-XXXXXXXXXXXXXXXXXXXXXXXXXXXXXXXXXXXXXXXXX-XXXXXXXXXXX-XXXXXXXXXXX--XXXXXXXXXXXXXXXXXXXXXXXXXXXXXXXXXXXXXXXXXXXXXXXXXXXXXXXXXXXXXXXXXXXXXXXXXXXX-XXXXXXXXXXXXXXXXXXXXXXXXX-XXXXXXXXXX-XXXXXXXXXXXXXXXXX
