--------------------------------------------------------------------------------------------------------------------------------------------------------------------------------------------------------
--------------------------------------------------------------------------------------------------------------------------------------------------------------------------------------------------------
--------------------------------------------------------------------------------------------------------------------------------------------------------------------------------------------------------
--------------------------------------------------------------------------------------------------------------------------------------------------------------------------------------------------------
--------------------------------------------------------------------------------------------------------------------------------------------------------------------------------------------------------
---------------------------------------------------------------------------------------------------------------------------------------B-------------------B--------------------------------------------
-----------------------------------------------------------------------------------------------------------C-------------------C---C--------------------------------------------------------------------
--------------------------------------------------------------------------------------------------------------------------------------------------------------------------------------------------------
--------------------------------------------------------------------------------------------------------------------------------------------------------------------------------------------------------
--------------------------------------------------------------------------------------------------------------------------------------------------------------------------------------------------------
tt---------------------------------------------------------------------------------------------------------B-------------------B---B-----------tt-B----------------------#------------------------------
tt------------#---------------------------------------------------------------------------------------------------------#--------tt------------tt-----------------------##------------------------------
tt--------tttt#---------------------------------------------------------------------------------------------###########-##-####-#tt-#-#-#-#####tt#-#tt#####-######-----#################################
tt-g--#-#-tttt#-k-k-k-g-k-g--k-g-k-g-k-k-g-k-g-k-g-k-g----k-k-g-k-g-g--k-g--k-g--k-g-k-k-g--g-k-k-g-k-g-k---###########-#######-#tt-#k#-#######tt#-#tt#####g######g-k-g################################F
XXXXXXXXXXXXXXXXXXXXXXXXXXXXXXXXXXXXXXXXXXXXXXXXXXXXXXXXXXXXXXXXXXXXXXXXXXXXXXXXXXXXXXXXXXXXXXXXXXXXXXXXXXXXXXXXXXXXXXX-XXXXXXXXXXXXXXXXXXXXXXXXXXXXXXXXXXXXXXXXXXXXXXXXXXXXXXXXXXXXXXXXXXXXXXXXXXXXXXXX
XXXXXXXXXXXXXXXXXXXXXXXXXXXXXXXXXXXXXXXXXXXXXXXXXXXXXXXXXXXXXXXXXXXXXXXXXXXXXXXXXXXXXXXXXXXXXXXXXXXXXXXXXXXXXXXXXXXXXXX-XXXXXXXXXXXXXXXXXXXXXXXXXXXXXXXXXXXXXXXXXXXXXXXXXXXXXXXXXXXXXXXXXXXXXXXXXXXXXXXX
