--------------------------------------------------------------------------------------------------------------------------------------------------------------------------------------------------------
--------------------------------------------------------------------------------------------------------------------------------------------------------------------------------------------------------
--------------------------------------------------------------------------------------------------------------------------------------------------------------------------------------------------------
--------------------------------------------------------------------------------------------------------------------------------------------------------------------------------------------------------
--------------------------------------------------------------------------------------------------------------------------------------------------------------------------------------------------------
---------------B----------U---U---------B---------------------------------------------------------------------------------BUU--UBU-U--UUUU-U------------------------------------------------------------
---------------------------------------------------------------------------------------------------------------------------------------------CCC-C--CC--CCCCCCCCCCC--CCCCCCCCCCCCCCCCCC--CCC-CCCCCCCC-CC
--------------------------------------------------------------------------------------------------------------------------------------------------------------------------------------------------------
--------------------------------------------------------------------------------------------------------------------------------------------------------------------------------------------------------
--------------------------------------------------------------------------------------------------------------------------------------------------------------------------------------------------------
--------------#-----------C--CC#------------tt-----------------------------------------------------------------------------CCttC-C-C--CCCCBC-BBB-BttBB--BBBBBBBBBBB--BBBBBBBBBBBBBBBBBB--BBB-BBBBBBBB-BB
-----------tt-#----------------#------------tt--#----------------------------------------------#-----------------------------tt-----tt------------tt--tt-------------------------------tt---------------
----------#tt-#---------#--tt--#------#---tttt-##--------------------------------------------#-#-----------------------------tt-----tt----------#-tt--tt-----------tt------------------tt---------------
k-k-g-g--g#tt##-g-k-g-g-#g-tt--#g-k-g-#---tttt###gk-g-k-g-k-g-k-k-g-k-g-k-g-g--k-k-g-g-g-k-k-#-#k-k-k-gk-g--k-g-gk-g-k-g-----tt-g-g-tt------k---#-tt--tt-----------tt------------------tt--------------F
XXXXXXXXXXXXXXX-XXXXXXXXXXXXXXXXXXXXXXXX-XXXXXXXXXXXXXXXXXXXXXXXXXXXXXXXXXXXXXXXXXXXXXXXXXXXXX-XXXXXXXXXXXXXXXXXXXXXXXXXXXXXXXXXXXXXXXXXXXXXXXXXXXXXXXXXXXXXXXXXXXXXXXXXXXXXXXXXXXXXXXXXXXXXXXXXXXXXXXXX
XXXXXXXXXXXXXXX-XXXXXXXXXXXXXXXXXXXXXXXX-XXXXXXXXXXXXXXXXXXXXXXXXXXXXXXXXXXXXXXXXXXXXXXXXXXXXX-XXXXXXXXXXXXXXXXXXXXXXXXXXXXXXXXXXXXXXXXXXXXXXXXXXXXXXXXXXXXXXXXXXXXXXXXXXXXXXXXXXXXXXXXXXXXXXXXXXXXXXXXX
