--------------------------------------------------------------------------------------------------------------------------------------------------------------------------------------------------------
--------------------------------------------------------------------------------------------------------------------------------------------------------------------------------------------------------
--------------------------------------------------------------------------------------------------------------------------------------------------------------------------------------------------------
--------------------------------------------------------------------------------------------------------------------------------------------------------------------------------------------------------
--------------------------------------------------------------------------------------------------------------------------------------------------------------------------------------------------------
-------U-----BB--------------B--BB-B--U---U-------U-----------------U----------------------------------------------------------------------------B---------------------------B--------------------------
------------------------------------------------------------------------------------------------------C--------------------------------------C----------------------------------------------------------
--------------------------------------------------------------------------------------------------------------------------------------------------------------------------------------------------------
--------------------------------------------------------------------------------------------------------------------------------------------------------------------------------------------------------
--------------------------------------------------------------------------------------------------------------------------------------------------------------------------------------------------------
-------C#UC-----------ttCC--C--B--B-CBCBC-C-C-----C----------------UC----------------------------B----B-U--tttt-----B---------------------#--B------tt---------------------------------#----------------
--------#-------------tt---------------------------------------------------------------------------------tttttt------------##-###-#--#--#####--##-##tt-######################-##########################
--------#-------------tt-------------------------#--------------------tt---------------------------------tttttt------------##-###-##-#--#####--##-##tt-######################-##########################
k-g-k---#--g--gk-k-g-gtt--g------------------k-#-#-k-g-k-g-g-k-k-g---#tt-g-k-g-g-k-g-k-k-g--k-k-g-k-g--g-tttttt------------##-###-##-#g-#####-g##g##ttg######################-#########################F
XXXXXXXXXXXXX-XXXXXXXXXXXXXXXX-XXXXXXXXXXXXXXXXX-XXXXXXXXXXXXXXXXXXXXXXXXXXXXXXXXXXXXXXXXXXXXXXXXXXXXXXXXXXXXXXXXXXXXXXXXXXXXXXXXXXX-XXXXXXXXXXXXXXXXXXXXXXXXXXXXXXXXXXXXXXXX-XXXXXXXXXXXXXXXXXXXXXXXXXX
XXXXXXXXXXXXX-XXXXXXXXXXXXXXXX-XXXXXXXXXXXXXXXXX-XXXXXXXXXXXXXXXXXXXXXXXXXXXXXXXXXXXXXXXXXXXXXXXXXXXXXXXXXXXXXXXXXXXXXXXXXXXXXXXXXXX-XXXXXXXXXXXXXXXXXXXXXXXXXXXXXXXXXXXXXXXX-XXXXXXXXXXXXXXXXXXXXXXXXXX
