--------------------------------------------------------------------------------------------------------------------------------------------------------------------------------------------------------
--------------------------------------------------------------------------------------------------------------------------------------------------------------------------------------------------------
--------------------------------------------------------------------------------------------------------------------------------------------------------------------------------------------------------
--------------------------------------------------------------------------------------------------------------------------------------------------------------------------------------------------------
--------------------------------------------------------------------------------------------------------------------------------------------------------------------------------------------------------
----------------------------BBU----------U------------------------------------B-----U-------------------------------------------------------------------------------------------------------------------
----------------------------------------------------------C-----------------------------------------------------------------------------------------------------C---------------------------------------
--------------------------------------------------------------------------------------------------------------------------------------------------------------------------------------------------------
--------------------------------------------------------------------------------------------------------------------------------------------------------------------------------------------------------
--------------------------------------------------------------------------------------------------------------------------------------------------------------------------------------------------------
---U--------------------------C-B-----tt-C-------------tt-B---B------------------CC-C------------------------------------------------------------------------###B-################-##########-######tttt
---------------------------#----------tt---#-----------tt----------------------------------------------------------------------------------------------------###--################-##########-######tttt
tt-------------------------#----------tt---#-----------tt----#-----------------tt----------------------------------------------------------------------------###--################-##########-######tttt
tt--g-k-g-k-g-k-g-k-k-k-k-k#---#-g-g--tt--g#g-k--k-g---tt#-#-#-#k-g-k-gk-g-k-ggtt-----k-k-g--k-g-k-g-k-g-g-k-g-g-g-k-g-k-g--g-g-k-g-g-g-gk-g--g-gg-gg-g--g-#g###-g################-##########k######tttF
XXXXXXXXXXXXXXXXXXXXXXXXXXXX-XXXXXXXXXXXXXXXXXXXXXXXXXXXXXXX-XXXXXXXXXXXXXXXXXXXXXXXXXXXXXXXXXXXXXXXXXXXXXXXXXXXXXXXXXXXXXXXXXXXXXXXXXXXXXXXXXXXXXXXXXXXXXXXXXXXXXXXXXXXXXXXXXXXXXXXXXXXXXXXXXXXXXXXXXXX
XXXXXXXXXXXXXXXXXXXXXXXXXXXX-XXXXXXXXXXXXXXXXXXXXXXXXXXXXXXX-XXXXXXXXXXXXXXXXXXXXXXXXXXXXXXXXXXXXXXXXXXXXXXXXXXXXXXXXXXXXXXXXXXXXXXXXXXXXXXXXXXXXXXXXXXXXXXXXXXXXXXXXXXXXXXXXXXXXXXXXXXXXXXXXXXXXXXXXXXX
