--------------------------------------------------------------------------------------------------------------------------------------------------------------------------------------------------------
--------------------------------------------------------------------------------------------------------------------------------------------------------------------------------------------------------
--------------------------------------------------------------------------------------------------------------------------------------------------------------------------------------------------------
--------------------------------------------------------------------------------------------------------------------------------------------------------------------------------------------------------
--------------------------------------------------------------------------------------------------------------------------------------------------------------------------------------------------------
-------B------UBB---B---B-------B-------------------------------B---------BBB----------------------------------U-------B--------------------------------------------------------------------------------
------------------------------------------------------------------------------------------------------------------------------------------------------------C-------------------------------------------
--------------------------------------------------------------------------------------------------------------------------------------------------------------------------------------------------------
--------------------------------------------------------------------------------------------------------------------------------------------------------------------------------------------------------
--------------------------------------------------------------------------------------------------------------------------------------------------------------------------------------------------------
C-------------C---#B---#-tt-BCtt-U-----------------B----------B--C-B#C---B---tt------------C---------------B---C-----CC-------#----CC-----------------------B-------------------------------------------
------#----------##---##-tt---tt-----------------#--------tt#-------#--------tt-----------------------------------------------#--##------------------------------------------#--------------------------
-tt#--#--tt-tt---##--###-tt---tt--tt-------------#--------tt#--#----#-tt-----tt-------------#--------------------tt-----------#--##--tttttttttttttt-tttttttt-tttttttttttttttt#tttttttttttttt-tttttttttt-
-tt#g-#-#ttgtt---##-g###-tt#--tt--ttk-k-g-kk-k-g-#g--k-g--tt#--#----#-tt#-gg-tt-k-g--k-k-g--#g-k-g-k-g-g----gg--gtt-#--gk-g---#kg##--tttttttttttttt-tttttttt-tttttttttttttttt#tttttttttttttt#ttttttttttF
XXXXXXX-XXXXXXXXXXXXXXXX-XXXXXXXXXXXXXXXXXXXXXXXXXXXXXXXXXXXXXXXXXXXXXXXXXXXXXXXXXXXXXXXXXXXXXXXXXXXXXXXXXXXXXXXXXXXXXXXXXXXXXXXXXXXXXXXXXXXXXXXXXXXXXXXXXXXXXXXXXXXXXXXXXXXXXXXXXXXXXXXXXXXXXXXXXXXXXXX
XXXXXXX-XXXXXXXXXXXXXXXX-XXXXXXXXXXXXXXXXXXXXXXXXXXXXXXXXXXXXXXXXXXXXXXXXXXXXXXXXXXXXXXXXXXXXXXXXXXXXXXXXXXXXXXXXXXXXXXXXXXXXXXXXXXXXXXXXXXXXXXXXXXXXXXXXXXXXXXXXXXXXXXXXXXXXXXXXXXXXXXXXXXXXXXXXXXXXXXX
