--------------------------------------------------------------------------------------------------------------------------------------------------------------------------------------------------------
--------------------------------------------------------------------------------------------------------------------------------------------------------------------------------------------------------
--------------------------------------------------------------------------------------------------------------------------------------------------------------------------------------------------------
--------------------------------------------------------------------------------------------------------------------------------------------------------------------------------------------------------
--------------------------------------------------------------------------------------------------------------------------------------------------------------------------------------------------------
-------U--------S---------S--S---S-----------------U-----U---------------------U---S--S--UU--S------------S-------------S--S------U---------------------------------------------------------------------
-----C----------------------C--C----------------------------------------------------C-----------------------------------------------------------------------C-------------------------------------------
--------------------------------------------------------------------------------------------------------------------------------------------------------------------------------------------------------
--------------------------------------------------------------------------------------------------------------------------------------------------------------------------------------------------------
--------------------------------------------------------------------------------------------------------------------------------------------------------------------------------------------------------
-----SUC---------#C------S-#S--S#-------#-#SC----#-C---CSCS--S-----------------C--#-S----CCtt---------------------tt-ttS-CC-S-----C--------------------#----S----------------------------------#----tttt
-----------------#---------#----#-------#-#------#--------------------------------#--------tt---------------------tt-tt------#####---#######--#-----tt-#--------------------------------------##----tttt
-----------------#--tt--#--#----#--tttt-#-#---#--#------------tt------------------#--------tt--------------tt-----tt-tt------#####---########-#-----tt-#-------------------------------------###----tttt
k-g------k-g--g--#-ktt#g#-g#--k-#-gtttt-#k#---#kk#---------g#-ttk-g--k-k--g-g-----#g-------tt-g-g-k-g-k-gg-tt-k---ttktt------#####-g-##########--###tt######-###############k#######################tttF
|%|%%%%%%|%|%%|%%|%||||||%||%-|%|-|||||%|||%%%||||%%%%%%%%%||%|||%|%%|%|%%|%|%%%%%||%%%%%%%||-|%|%|%|%|%||-||%|%%%|||||%%%%%%|||||%|%||||||||||-%|||||||||||%||||||||||||||||||||||||||||||||||||||||||%
|||||||||||||||||||||||||||||-|||-|||||||||||||||||||||||||||||||||||||||||||||||||||||||||||-||||||||||||-||||||||||||||||||||||||||||||||||||-||||||||||||||||||||||||||||||||||||||||||||||||||||||||
