--------------------------------------------------------------------------------------------------------------------------------------------------------------------------------------------------------
--------------------------------------------------------------------------------------------------------------------------------------------------------------------------------------------------------
--------------------------------------------------------------------------------------------------------------------------------------------------------------------------------------------------------
--------------------------------------------------------------------------------------------------------------------------------------------------------------------------------------------------------
--------------------------------------------------------------------------------------------------------------------------------------------------------------------------------------------------------
--------------------------------------------------------------------S----------------SS-S-----------------------------------------S-----S----SS--------S---S--------------------------------------------
---------------------------------------------------------------------C----------------------------------------------------------------------------------------------------------------------------------
--------------------------------------------------------------------------------------------------------------------------------------------------------------------------------------------------------
--------------------------------------------------------------------------------------------------------------------------------------------------------------------------------------------------------
--------------------------------------------------------------------------------------------------------------------------------------------------------------------------------------------------------
---S-------------------C---------------------------U-----------------S-----------------S----------------#-----------tt----------------------------------#-U-------------------U-------------------------
-#--tt-------------------------------------------#-----------tttt-------------------------tt------------#-----------tt-----#----------------------------#-----------------------------------------------
-#--tt-------------------------------------------#--tt-------tttt------tt-----------------tt------------#-----------tt--tt-#--tt------------------------#-----------------------------------------------
g#g-tt-k-k-g--g-k-g-k---g-k-g-g-k---k--g-k-g-g-k-#--ttk-k-g--tttt------tt-g-k-g-g-k---g-ggttk-k-g-g-k-g-#gggggggggggttggtt-#ggttgg-g-ggg-ggk-g-ggggg-gg-#g-gggggk-ggggggggg-gg-ggggggggggggggggggggggggF
|||%||%|%|%|%%|%|%|%|%%%|%|%|%|%|%%%|%%|%|%|%|%|%|%%|||%|%|%%||||%%%-%%||-|%|%|%|%|%%%|%|||||%|%|%|%|%|%||||||||||||||||||-|||||||-|%|||%|||%|%|||||%||-||%||||||%|||||||||%||%||||||||||||||||||||||||%
||||||||||||||||||||||||||||||||||||||||||||||||||||||||||||||||||||-||||-||||||||||||||||||||||||||||||||||||||||||||||||-|||||||-||||||||||||||||||||-||||||||||||||||||||||||||||||||||||||||||||||||
