--------------------------------------------------------------------------------------------------------------------------------------------------------------------------------------------------------
--------------------------------------------------------------------------------------------------------------------------------------------------------------------------------------------------------
--------------------------------------------------------------------------------------------------------------------------------------------------------------------------------------------------------
--------------------------------------------------------------------------------------------------------------------------------------------------------------------------------------------------------
--------------------------------------------------------------------------------------------------------------------------------------------------------------------------------------------------------
----U-S-S-S--SS-SS------------S---------US-------------S-----S--------------------------------------------U-UU-SU---UU-----US-U--UUUUUUUUUUUSU-SSSS-S--S-SSSSS-SS-SS-SS---------------------------------
--------------------------------------------------------------------------------------------------------------------------------------------------------------------------------------------------------
--------------------------------------------------------------------------------------------------------------------------------------------------------------------------------------------------------
--------------------------------------------------------------------------------------------------------------------------------------------------------------------------------------------------------
--------------------------------------------------------------------------------------------------------------------------------------------------------------------------------------------------------
-ttUC------tt--S--S----------C----------C---------------C---U--C------------------------------------------C-CC--C---CC-----C--C-CCCCCCCCCCCC-CS----S----S-----S--S--S--UUUUUU--UUUUU-UUUUUUUUUUUUUUUUUUU
-tt--------tt--------------tt--tt---------------------#-------#-----------#---------------------------------------------tt------------------------------------------------------------------------------
-tt--------tt--------------tt--tt-------------------tt#-------#-#---------#-------------------------------------------tttt-----#------------------------------------------------------------------------
gtt--#ggg--tt------g-k-g--#tt--ttk-g-k-g--k-g-g--#g-tt#g-ggg-g#-#k-g--g---#g-k-g--g-k-g-k-k-g-k-g-k-k-g-g--------#g---tttt-----#------------g--------------------------------gg------------------------F
|||%%||||%%||%%%--%|%|%|%-|||%-|||%|%|%|%-|%|%|%%||%||||%|||%||%||%|%%|%%%||%|%|%%|%|%|%|%|%|%|%|%|%|%|%|%%%%%--%||-%%||||-%%%%|%%%%%%%%%%%%|%%%%%%%%%%%%%%%%%%%%%%%%%%%%%%%%||%%%%%%%%%%%%%%%%%%%%%%%%%
||||||||||||||||--|||||||-||||-||||||||||-||||||||||||||||||||||||||||||||||||||||||||||||||||||||||||||||||||--|||-||||||-|||||||||||||||||||||||||||||||||||||||||||||||||||||||||||||||||||||||||||||
