--------------------------------------------------------------------------------------------------------------------------------------------------------------------------------------------------------
--------------------------------------------------------------------------------------------------------------------------------------------------------------------------------------------------------
--------------------------------------------------------------------------------------------------------------------------------------------------------------------------------------------------------
--------------------------------------------------------------------------------------------------------------------------------------------------------------------------------------------------------
--------------------------------------------------------------------------------------------------------------------------------------------------------------------------------------------------------
-----------------------------------------SU---S----------------------------------------------------------------------------S--------S-------------------------------------------------------------------
----------------------------------------------------------------------------------------------------------------------------------------------------C---------------------------------------------------
--------------------------------------------------------------------------------------------------------------------------------------------------------------------------------------------------------
--------------------------------------------------------------------------------------------------------------------------------------------------------------------------------------------------------
--------------------------------------------------------------------------------------------------------------------------------------------------------------------------------------------------------
#---------------------------------------C-CU----SU--C---------------------------------------------------------------------C--------#------------tt--S----tt---------------------------------------------
#----------#------------------------------------------#-----------------------------------------------------------tttt------tt-tttt#--tttttttttttttt-tttttttttttttt-tttttt-tttttt-tttttttttttttttttttttt
#----------##--------------------------------#-#--tt--#----------------------------------------------------------#tttt--tt--tt-tttt#--tttttttttttttt-tttttttttttttt-tttttt-tttttt-tttttttttttttttttttttt
#g-k-g-k-g-###k-g-k-g-g--k-g-k-g-g-k-g-g----##-#--tt-g#-k-k-k-g-k-g-k-k-g-g-k-gk-g-k-k-g-k-g-g--g-k-k-g-k-g-k-k-g#tttt--tt--ttgtttt#g-tttttttttttttt-tttttttttttttt-tttttt#tttttt-tttttttttttttttttttttF
||%|%|%|%|%||||%|%|%|%|%%|%|%|%|%|%|%|%|%%%%||-|%%||%||%|%|%|%|%|%|%|%|%|%|%|%||%|%|%|%|%|%|%|%%|%|%|%|%|%|%|%|%||||||%%||%%|||||||||%||||||||||||||%||||||||||||||-|||||||||||||%|||||||||||||||||||||%
||||||||||||||||||||||||||||||||||||||||||||||-||||||||||||||||||||||||||||||||||||||||||||||||||||||||||||||||||||||||||||||||||||||||||||||||||||||||||||||||||||-||||||||||||||||||||||||||||||||||||
