--------------------------------------------------------------------------------------------------------------------------------------------------------------------------------------------------------
--------------------------------------------------------------------------------------------------------------------------------------------------------------------------------------------------------
--------------------------------------------------------------------------------------------------------------------------------------------------------------------------------------------------------
--------------------------------------------------------------------------------------------------------------------------------------------------------------------------------------------------------
--------------------------------------------------------------------------------------------------------------------------------------------------------------------------------------------------------
----S---------SS---U-----------------SS-U-------------U-S-U--------------------------S-------U--------------------------------------------------------------------------U-------------------------------
------------------C--------------------------------------------------------------------------------------------C----------------------------------------------------------------------------------------
--------------------------------------------------------------------------------------------------------------------------------------------------------------------------------------------------------
--------------------------------------------------------------------------------------------------------------------------------------------------------------------------------------------------------
--------------------------------------------------------------------------------------------------------------------------------------------------------------------------------------------------------
-----S--tt---S----SC-----tt---------S---C-U----------CC---CS-------------tt------------------C-tt-------------CS-UCCCCC-#UCCCCCCCCC-#UCCCCCUCCCCC--CCCC----#------------C-------------------------SSSSSS
--------tt--#----#-------tt----------------------------------------------tttt---#tt--------#--#tt-----------------------#-----------#----------------------#--------------------------------------------
--#-----tt--#----#--#---#tt------------------------------#------#--------tttt---#tttt----#-#--#tt-----------------------#-----------#------------tt----tttt#tttttttttttt-tttttttttttttttt-tttttttt------
--#---g-tt--#----#--#gg-#ttg-k-g--g------#--g-k-g-g-g---g#-----##-g-k-k-#ttttk-g#tttt----#-#--#tt-k-g-k-k-g-gk----------#-----------#------------tt----tttt#tttttttttttt-ttttttttttttttttktttttttt-----F
%-|%%%|%||%%|%%%%|%%|||%||||%|%|%%|%%%%-%|%-|%|%|%|%|%%%||%%%-%||%|%|%|%||||||%||||||%%%%|-|%%|||%|%|%|%|%|%||%%%%%%%%%%|%%%%%%%%%%%|%%%%%%%%%%%%||%%%%|||||||||||||||||%|||||||||||||||||||||||||%%%%%%
|-|||||||||||||||||||||||||||||||||||||-|||-|||||||||||||||||-||||||||||||||||||||||||||||-|||||||||||||||||||||||||||||||||||||||||||||||||||||||||||||||||||||||||||||||||||||||||||||||||||||||||||||
