--------------------------------------------------------------------------------------------------------------------------------------------------------------------------------------------------------
--------------------------------------------------------------------------------------------------------------------------------------------------------------------------------------------------------
--------------------------------------------------------------------------------------------------------------------------------------------------------------------------------------------------------
--------------------------------------------------------------------------------------------------------------------------------------------------------------------------------------------------------
--------------------------------------------------------------------------------------------------------------------------------------------------------------------------------------------------------
-U------------------U------------------------------------------S----------------------------------------------------------------------------------------------------------------------------------------
--------------------------------------------------------------------------------------------------------------------------------------------------------------------------------------------------------
--------------------------------------------------------------------------------------------------------------------------------------------------------------------------------------------------------
--------------------------------------------------------------------------------------------------------------------------------------------------------------------------------------------------------
--------------------------------------------------------------------------------------------------------------------------------------------------------------------------------------------------------
#C------------C-----C---------------------------------------------------------------------------------------------------------------------------------------------------------##-######--#######-#######
#------------------#----------------------------------------------------------------------------------------------------------------------------------------------------------##-######--#######-#######
#---#--------------#----------------------------------------------------------------------------------------------------------------------------------------------------------##-######tt#######-#######
#-#-#k-k-g-k---kg-g#-g-g-k-g-k-g-k-g-k-g-k-g-k--k-g-k--g-k-g--#-g-k-g-k-g-k-g-gk-g-k-g-k-g--g-g-k-g-k-g--k-g-k-g-k-g-k-k-k-g-k-g--k-g-k--k-g-g-k--g-g--k--g-k-g-k-g-k-g-k-g-k-##-######tt#######-######F
|%|-||%|%|%|%%%||%||%|%|%|%|%|%|%|%|%|%|%|%|%|%%|%|%|%%|%|%|%%|-|%|%|%|%|%|%|%||%|%|%|%|%|%%|%|%|%|%|%|%%|%|%|%|%|%|%|%|%|%|%|%|%%|%|%|%%|%|%|%|%%|%|%%|%%|%|%|%|%|%|%|%|%|%|%||%|||||||||||||||%||||||%
|||-|||||||||||||||||||||||||||||||||||||||||||||||||||||||||||-||||||||||||||||||||||||||||||||||||||||||||||||||||||||||||||||||||||||||||||||||||||||||||||||||||||||||||||||||||||||||||||||||||||||
