--------------------------------------------------------------------------------------------------------------------------------------------------------------------------------------------------------
--------------------------------------------------------------------------------------------------------------------------------------------------------------------------------------------------------
--------------------------------------------------------------------------------------------------------------------------------------------------------------------------------------------------------
--------------------------------------------------------------------------------------------------------------------------------------------------------------------------------------------------------
--------------------------------------------------------------------------------------------------------------------------------------------------------------------------------------------------------
---------------------------S-------SU----SS-------U---S-S-------------------S--------------S------------U---------U-----S------S--------------------S----------------------------------S---------S-S----
-----------------------------------------------------------------------------C-----------------------------------------------------------------C--------------------------------------------------------
--------------------------------------------------------------------------------------------------------------------------------------------------------------------------------------------------------
--------------------------------------------------------------------------------------------------------------------------------------------------------------------------------------------------------
--------------------------------------------------------------------------------------------------------------------------------------------------------------------------------------------------------
tt--------------------------C-------C---S---------CC-----------------------C-S---S-----tt---------------C--S------C----------------------------S----------------------------------U---#-#---#-----------
tt----#----------------------#------------------------------------------------tt--tt---tttt-----------------tt--------tt------------tt------------------------------------------------#-#---#-----------
tt----##---------------------#--tt---------------------#----------------------tt--tt-tttttt-----------------tt--------tt------------tt------------------------------------------------#-#---#-----------
ttk-g-###g-k-g-k-g-k-g-k-g-g-#g#tt---g-g----k-g-k-----g#-#k-g-----k-g-k-g---g-tt--tt#tttttt-g-k-g-k-k-g-----tt--g-----tt------------tt--------------g--------g-g----------------------#g#---#----------F
|||%|%||||%|%|%|%|%|%|%|%|%|%|||||%-%|%|%%%%|%|%|%%%%%||-||%|%%--%|%|%|%|%%%|%||%%|||||||||-|%|%|%|%|%|%%%%%||%%|%%%%%||%%%%%%--%%%%||%%%%%%%%%%%%%%|%%%%%%%%|%|%%%%%%%%%%%%%%%%%%%%%%|||%%%|%%%%-%-%%%%
|||||||||||||||||||||||||||||||||||-||||||||||||||||||||-||||||--||||||||||||||||||||||||||-||||||||||||||||||||||||||||||||||--|||||||||||||||||||||||||||||||||||||||||||||||||||||||||||||||||-|-||||
