--------------------------------------------------------------------------------------------------------------------------------------------------------------------------------------------------------
--------------------------------------------------------------------------------------------------------------------------------------------------------------------------------------------------------
--------------------------------------------------------------------------------------------------------------------------------------------------------------------------------------------------------
--------------------------------------------------------------------------------------------------------------------------------------------------------------------------------------------------------
--------------------------------------------------------------------------------------------------------------------------------------------------------------------------------------------------------
-------------------------------------B-----------------B---------------------B-B------------B---------------------BBBBBBBBBBB-BB-BBU-BBB-BBBBBBB--BBBBBBBBB-BBBBBB-BBBBB-BBBBB-BBBB-B-BBBBBBBBBBBBBBBBBB
------------------------------------------------------------------------------------------------------------------------------------------------------------------------C-------------------------------
--------------------------------------------------------------------------------------------------------------------------------------------------------------------------------------------------------
--------------------------------------------------------------------------------------------------------------------------------------------------------------------------------------------------------
--------------------------------------------------------------------------------------------------------------------------------------------------------------------------------------------------------
----------------B---U----tt-----------tt---tt-------------CU#-----------------C---------------B#-----------------------------U--#--C------------------------------------B-------------------------------
-----tt------------------tt-----------tt---tt--#------------#-------------------#-#------------#--------------------------------#-----------------------------------------------------------------------
-----tt-------tt--------#tt-----------tt---tt#-#------------#-------------------#-#--------#-#-#--------------------------------#--------------------------#------#-------------------------------------
-k-g#ttk-g-k--tt-k-g----#tt-k-k-k-k-g-tt-k-tt#-#k-gg-g------#-g-k-g-k-k-g--##---#-#k-gk-g-g#g#-#g-k-k-k-k-g--#-#--gggg-gggggg-gg#gg--ggg-ggggggg--ggggggggg#gggggg#ggggg-gggggggggg-g-gggggggggggggggggF
XXXXXXXXXXXXXXXXXXXXXXXXXXXXXXXXXXXXX-XXXXXXXX-XXXXXXXXXXXXXXXXXXXXXXXXXXXXXX-X-XXXXXXXXXXXXXXXXXXXXXXXXXXXXXXXXXXXXXX-XXXXXXXXXXXXX-XXXXXXXXXXXXXXXXXXXXXXXXXXXXXXXXXXXXXXXXXXXXXXXXXXXXXXXXXXXXXXXXXXX
XXXXXXXXXXXXXXXXXXXXXXXXXXXXXXXXXXXXX-XXXXXXXX-XXXXXXXXXXXXXXXXXXXXXXXXXXXXXX-X-XXXXXXXXXXXXXXXXXXXXXXXXXXXXXXXXXXXXXX-XXXXXXXXXXXXX-XXXXXXXXXXXXXXXXXXXXXXXXXXXXXXXXXXXXXXXXXXXXXXXXXXXXXXXXXXXXXXXXXXX
