--------------------------------------------------------------------------------------------------------------------------------------------------------------------------------------------------------
--------------------------------------------------------------------------------------------------------------------------------------------------------------------------------------------------------
--------------------------------------------------------------------------------------------------------------------------------------------------------------------------------------------------------
--------------------------------------------------------------------------------------------------------------------------------------------------------------------------------------------------------
--------------------------------------------------------------------------------------------------------------------------------------------------------------------------------------------------------
B-------U---------------------------------------------B---B-----B-----B------BU--B----------------------------------------------------------------------------------------------B-----------------------
-----------C--------------------------------------------------------------------------------------------------------------------------------------------------------------------------------------------
--------------------------------------------------------------------------------------------------------------------------------------------------------------------------------------------------------
--------------------------------------------------------------------------------------------------------------------------------------------------------------------------------------------------------
--------------------------------------------------------------------------------------------------------------------------------------------------------------------------------------------------------
-#------C--B----#-------------------------------------------------tt----------C---------------------------------------------------------------------------------------------C---------------------------
-#------------#-#--------------------------------------#tt-#------tt------------------------------------------------------------------------------------------------------------------------------------
-#----------#-#-#--------------------------------------#tt-#--tt--tttt-#tttt--------------------------------------------------------------------------------------#-------------------------------------
g#gg-k-g--g-#-#g#-k-g--g-k-k--k-g-k-g-k-g-k-g-k-g-k-g--#tt-#--ttggtttt-#tttt-g----#g-k-g--k-g--k-g-k-g-k-k-k--k-k-kk-kk-gk-g-kk-g-kk-g-k-k-k-k-k-k-k-k-k-k-kk-k-k-#------------------------------------F
XXXXXXXXXXXXX-XXXXXXXXXXXXXXXXXXXXXXXXXXXXXXXXXXXXXXXX-XXXXX-XXXXXXXXXXXXXXXXXXXX-XXXXXXXXXXXXXXXXXXXXXXXXXXXXXXXXXXXXXXXXXXXXXXXXXXXXXXXXXXXXXXXXXXXXXXXXXXXXXXXXXXXXXXXXXXXXXXXXXXXXXXXXXXXXXXXXXXXXXX
XXXXXXXXXXXXX-XXXXXXXXXXXXXXXXXXXXXXXXXXXXXXXXXXXXXXXX-XXXXX-XXXXXXXXXXXXXXXXXXXX-XXXXXXXXXXXXXXXXXXXXXXXXXXXXXXXXXXXXXXXXXXXXXXXXXXXXXXXXXXXXXXXXXXXXXXXXXXXXXXXXXXXXXXXXXXXXXXXXXXXXXXXXXXXXXXXXXXXXXX
