--------------------------------------------------------------------------------------------------------------------------------------------------------------------------------------------------------
--------------------------------------------------------------------------------------------------------------------------------------------------------------------------------------------------------
--------------------------------------------------------------------------------------------------------------------------------------------------------------------------------------------------------
--------------------------------------------------------------------------------------------------------------------------------------------------------------------------------------------------------
--------------------------------------------------------------------------------------------------------------------------------------------------------------------------------------------------------
---BB------------B--------U----UBBB--U--BUB-B-B--B-B-------BB-------B-----------B-B--B-B---------------BB---U-------------------------------------U-----------------------------------------------------
-----------------------------------------------------------------------------------------------------------------------------------------C-C------------------------------------------------------------
--------------------------------------------------------------------------------------------------------------------------------------------------------------------------------------------------------
--------------------------------------------------------------------------------------------------------------------------------------------------------------------------------------------------------
--------------------------------------------------------------------------------------------------------------------------------------------------------------------------------------------------------
--B------------B----------CC---C-----C---C-----tt---C--C-------------------------B---------tt------------tt-CU---tt---------CU-------#---B-B------C--------C--------------------------------------------
------------------tt---------------------------tt-#------tt------------------------tt---tt-tt------------tt----tttt------------------#----------------------------------------tt-#----------------------
------tt----------tt---------------------------tt-#--tt--tt---#-tt-----------------tt---tt-tt------------tt----tttt------------------#-#-----------#-------------#------------tt-#----------------------
-----#tt-k-g--g-g-tt-g-g----gg#--g-----gg---g-gtt-#g-tt--tt--k#-tt---#-k-g-g-gg----tt---tt-tt-g-k-k-g----tt---#ttttk-k-k-g-#--k-kk-g-#k#-----------#-------------#------------tt-#----------#----------F
XXXXXXXXXXXXXXXXX-XXXXXXXXXXXXXX-XXXXXXXXX--XXXXX-XXXXXXXXXX-XXXXXXXXXXXXXXXXXXXXXXXXXX-XXXXXXXXXXXXXXXX-XXXXXXXXXXXXXXXXXXXXXXXXXXXXXXXXXXXXXXXXXXXXXXXXXXXXXXXXXXXXXXXXXXXX-XXXXXXXXXXXXXXXXXXXXXXXXXX
XXXXXXXXXXXXXXXXX-XXXXXXXXXXXXXX-XXXXXXXXX--XXXXX-XXXXXXXXXX-XXXXXXXXXXXXXXXXXXXXXXXXXX-XXXXXXXXXXXXXXXX-XXXXXXXXXXXXXXXXXXXXXXXXXXXXXXXXXXXXXXXXXXXXXXXXXXXXXXXXXXXXXXXXXXXX-XXXXXXXXXXXXXXXXXXXXXXXXXX
