--------------------------------------------------------------------------------------------------------------------------------------------------------------------------------------------------------
--------------------------------------------------------------------------------------------------------------------------------------------------------------------------------------------------------
--------------------------------------------------------------------------------------------------------------------------------------------------------------------------------------------------------
--------------------------------------------------------------------------------------------------------------------------------------------------------------------------------------------------------
--------------------------------------------------------------------------------------------------------------------------------------------------------------------------------------------------------
-S----S-------------S---S-----U------S--S------U----U-----S------------------------S-------SUU---------------------UU--------S-------S----S-----SS-SS------------------------------U--------------------
-------------------------------------------C--------------------------------------C---------------------------------------------------------------------------------------------------------------------
--------------------------------------------------------------------------------------------------------------------------------------------------------------------------------------------------------
--------------------------------------------------------------------------------------------------------------------------------------------------------------------------------------------------------
--------------------------------------------------------------------------------------------------------------------------------------------------------------------------------------------------------
--C--U---------------S---C---CC-#C-tt------S---C----C#S-SU-S-------------------tt-S--tt---U-CCC#-----------US--S--#CC-U---S-----#U-----SS---------S----###-####-##-##--#########--#C-#######S###########
#--------------tt---------------#--tt-------------tt-#-------tt----------------tt----tt--------#------------------#--------tt-tt#-tt-------------------###-####-##-##--#########--#--#######-###########
#--tt----------tt---------------#--tt-tt--------tttt-#-------tttt--------------tt#---tt-tt-----#------------------#----tt--tt-tt#-tt-------tt----------###-####-##-##tt#########--#--#######-###########
#g-tt-g#k-g-g--ttk-g--#---k-g---#-gtt-tt-g--k-g-tttt-#-g--g--ttttg-g-k-g-k-g---tt#---tt-tt-----#-k-k-g-k-g---gk---#----tt--tt-tt#-ttg----k-tt-g#g-----####k####-##k##tt#########k-#--#######-##########F
||%||%|||%|%|%%|||%|%%|%%%|%|%%%|%|||%||%|-%|%|%||||%|%|%%|%%|||||%|%|%|%|%|%%-|||%-%||-||%%%%%|%|%|%|%|%|%%%||%-%|%%%%||-%||-|||%|||-%%%|%||-|||-%%%%|||||||||-|||||||||||||||||%|%%|||||||%||||||||||%
||||||||||||||||||||||||||||||||||||||||||-|||||||||||||||||||||||||||||||||||-||||-|||-||||||||||||||||||||||||-||||||||-|||-|||||||-|||||||-|||-|||||||||||||-||||||||||||||||||||||||||||||||||||||||
