--------------------------------------------------------------------------------------------------------------------------------------------------------------------------------------------------------
--------------------------------------------------------------------------------------------------------------------------------------------------------------------------------------------------------
--------------------------------------------------------------------------------------------------------------------------------------------------------------------------------------------------------
--------------------------------------------------------------------------------------------------------------------------------------------------------------------------------------------------------
--------------------------------------------------------------------------------------------------------------------------------------------------------------------------------------------------------
--------------------------S---------S-S-U--S----S---S-SS-----U------------------------------------------------------------------------------------------------------------------------------------------
---------------C-----C--------------------------------------------------------------------------------------------------C-------------------------------------------------------------------------------
--------------------------------------------------------------------------------------------------------------------------------------------------------------------------------------------------------
--------------------------------------------------------------------------------------------------------------------------------------------------------------------------------------------------------
--------------------------------------------------------------------------------------------------------------------------------------------------------------------------------------------------------
---------------Stt---SU-C-------#------CC---C-S--S#--S--S--S-C---------------------------------ttU----tt-----UUUUUUUUUUUSUUUUUUUUUUUUUCCS-UU--UUU#UUU-UUUUUUUUUU-U-UUUUUUUUU---UUUUUUUUUUUUUUU--UUUUUUUU
----------------tt--#------tt-tt#--------tt-------#--------------------------------------------tt-----tt-----------------------------------------#---#------------#---------------------------tt--------
----------------tt#-#------tt-tt##tt-----tt-------#------tt----tt--------tt--------------------tt-----tt-----------------------------------------#---#------------#---------------------------tt--------
k-g-k-g--k-g--#-tt#-#--#-g-tt-tt##tt-----tt----g--#------tt----tt-g-k-g-kttk-g-k-g--k-gk-g-k-g-tt-k-g-tt--k-k----------------------------#-------#---#------------#----------g----------------tt-------F
|%|%|%|%%|%|%%|%|||-|%%|%|%||%||||||%%-%%||%%%%|%%|%%%%%%||%%%-||%|%|%|%||||%|%|%|%%|%||%|%|%|%||%|%|%||%%|%|%%%%%%%%%%%%%%%%%%%%%%%%%%%%|%%-%%%%|%%%|%%%%%%%%%%%%|%%%%%%%%%%|%%%%%%%%%%%%%%%%||%%%%%%%%
|||||||||||||||||||-||||||||||||||||||-|||||||||||||||||||||||-|||||||||||||||||||||||||||||||||||||||||||||||||||||||||||||||||||||||||||||-|||||||||||||||||||||||||||||||||||||||||||||||||||||||||||
