--------------------------------------------------------------------------------------------------------------------------------------------------------------------------------------------------------
--------------------------------------------------------------------------------------------------------------------------------------------------------------------------------------------------------
--------------------------------------------------------------------------------------------------------------------------------------------------------------------------------------------------------
--------------------------------------------------------------------------------------------------------------------------------------------------------------------------------------------------------
--------------------------------------------------------------------------------------------------------------------------------------------------------------------------------------------------------
----------------------------------SS---S--------------------SU-------------------------------S-------------------S------------------SS------------------------------------------------------------------
-----------------------------------------------------------C-------C------------------C----------C------------------------------------------------------------------------------------------------------
--------------------------------------------------------------------------------------------------------------------------------------------------------------------------------------------------------
--------------------------------------------------------------------------------------------------------------------------------------------------------------------------------------------------------
--------------------------------------------------------------------------------------------------------------------------------------------------------------------------------------------------------
--tt-SU--#--------C--U--------------------ttS--------------S-C-----S-----------UU----SSS#-----C-#S------------------S----S---------------------------------U--------------------------------------------
--tt-----#---------tt-----------------#---tt---------------------------------#----tt----#tt-----#-----------------tt----------tt----------------------------------------------------tt------------------
--tt-----#---------tt----------------##---tt-------------------------------tt#---#tt----#tt-----#------tt---------tt----#-tttttttt----tttttt-tttttttttttttt-tt---tttt-tttttttttttttttttttttttttttttttttt
-gtt#--g-#--g-g-k--tt-k-g-g--k-g--g-###-k-tt--k-g--k-g-k----g--#g---k-k-g-gtt##--#tt----#tt-g--##-k-g-kttk-g-k-g--tt---g#-tttttttt--g-tttttt-tttttttttttttt-ttk-gttttgtttttttttttttttttttttttttttttttttF
%||||%%|-|%%|%|%|%%||%|%|%|%%|%|%%|%|||%|-||%%|%|-%|%|%|%%%%|%%||%%%|%|%|%|||||%%|||%%%%|||-|-%||%|%|%||||%|%|%|%%||%%-||%||||||||%%|-||||||%||||||||||||||%|||%|||||||||||||||||||||||||||||||||||||||%
||||||||-||||||||||||||||||||||||||||||||-|||||||-|||||||||||||||||||||||||||||||||||||||||-|-||||||||||||||||||||||||-||||||||||||||-||||||||||||||||||||||||||||||||||||||||||||||||||||||||||||||||||
