--------------------------------------------------------------------------------------------------------------------------------------------------------------------------------------------------------
--------------------------------------------------------------------------------------------------------------------------------------------------------------------------------------------------------
--------------------------------------------------------------------------------------------------------------------------------------------------------------------------------------------------------
--------------------------------------------------------------------------------------------------------------------------------------------------------------------------------------------------------
--------------------------------------------------------------------------------------------------------------------------------------------------------------------------------------------------------
----------------------------S----S----S-S----------------------------------------------------------------------------------U-------------S--------------------------------------------------------------
--------------------------C-----------------------------------------------------------------------------------------------------------------------------------------------------------------------------
--------------------------------------------------------------------------------------------------------------------------------------------------------------------------------------------------------
--------------------------------------------------------------------------------------------------------------------------------------------------------------------------------------------------------
--------------------------------------------------------------------------------------------------------------------------------------------------------------------------------------------------------
--------------------------S#-U----S----------#--------------------------------------------------------------------------U--C---------S--------#---------------------------#-#---------------------------
---------------------------#---------#-----#-#----tt-----------#------------------------------------------------------------##-----#----------#-----------------------tt--#-#-tt------------------------
#--------------------------#--tt----##---#-#-#----tt----------##------------------------------------------------------#-----##-----#----------#-----------------------tt--#-#-tt------------------------
#g--g-k-g-g-g-kk-g-g-k-k-#-#g-tt----##-g-#-###-g-gtt-g-g-k--#-##---g-k-gk-g-g-g-gk-g-g-k-gk-g-k-g-k-g-g-g-k-g-##-g-##-#-----##-----#----------#g----------------------tt--#-#-tt-----------------------F
||%-|%|%|%|%|%||%|%|%|%|%|%||%||--%%||%|-|-|||-|%|||%|%|%|%%|-||%%%|%|%||%|%|%|%||%|%|%|%||%|%|%|%|%|%|%|%|%|%||%|%||-|%%%%%||%%%%%|%%%%%-%%%%||%%%%%%%%%%%%%%%%%%%%%%||%%|%|%||%%%%%%-%%%%%%%%%%%%%%%%%
|||-||||||||||||||||||||||||||||--||||||-|-|||-||||||||||||||-|||||||||||||||||||||||||||||||||||||||||||||||||||||||-|||||||||||||||||||-||||||||||||||||||||||||||||||||||||||||||||-|||||||||||||||||
