--------------------------------------------------------------------------------------------------------------------------------------------------------------------------------------------------------
--------------------------------------------------------------------------------------------------------------------------------------------------------------------------------------------------------
--------------------------------------------------------------------------------------------------------------------------------------------------------------------------------------------------------
--------------------------------------------------------------------------------------------------------------------------------------------------------------------------------------------------------
--------------------------------------------------------------------------------------------------------------------------------------------------------------------------------------------------------
-----U-----------------B---B-BB--------U-------B-B-------------BB----------------------------------------------U-----U-----UUUUUUB--UU-U--------------------------------B--U----------------------------
-----------------------------------C----------------------------------------------------------------------------------------------------CC-------CCCCCCCCCC-CCCCCCCCCCCC-CC--CCCCC--CCCCCCCCCCCCCCC-CCCC
--------------------------------------------------------------------------------------------------------------------------------------------------------------------------------------------------------
--------------------------------------------------------------------------------------------------------------------------------------------------------------------------------------------------------
--------------------------------------------------------------------------------------------------------------------------------------------------------------------------------------------------------
#---BC---------------tt-B------tt--B---C-tt-------tt----------C-----------------------------------------------#CC----C-----CCCCCC---CCCCBB-------BBBBBBBBBB-BBBBBBBBBBBB-BBC-BBBBB--BBBBBBBBBBBBBBBBBBBB
#----------------tt--tt-----#--tt--------tt-------tt-------------tttt-----------------------------------------#---------------------------tt---------------#----------------#---------------------------
#----------------tt--tt--tt-#--tttt------tt---#---tt-------------tttt-----------------------------------------#---------#-----------------tt---#-----------#----------------#-----tt--------------------
#g----g-g-k-g-g-gttg-tt--ttg#--tttt--gg--tt-g-#g--ttg-k-k-g--#---ttttk-g-k-g-k-g-g--g-k-g-k-g-k-k-g-g-k-gk-g--#--k-g--gg#g--------gk------ttk-g#g----------#------------g---#-----tt-------------------F
XXXXXXXXXXXXXXXXXXXXXXXXXXXXX--XXXXXXXXXXXXXXXXXX-XXXXXXXXXXXXXX-XXXXXXXXXXXXXXXXXXXXXXXXXXXXXXXXXXXXXXXXXXXXXXXXXXXXXXXXXXXXXXXXXXXXXXXXXXXXXXXXXXXXXXXXXXXXXXXXXXXXXXXXXXXXXXXXXXXXXXXXXXXXXXXXXXXXXXX
XXXXXXXXXXXXXXXXXXXXXXXXXXXXX--XXXXXXXXXXXXXXXXXX-XXXXXXXXXXXXXX-XXXXXXXXXXXXXXXXXXXXXXXXXXXXXXXXXXXXXXXXXXXXXXXXXXXXXXXXXXXXXXXXXXXXXXXXXXXXXXXXXXXXXXXXXXXXXXXXXXXXXXXXXXXXXXXXXXXXXXXXXXXXXXXXXXXXXXX
