--------------------------------------------------------------------------------------------------------------------------------------------------------------------------------------------------------
--------------------------------------------------------------------------------------------------------------------------------------------------------------------------------------------------------
--------------------------------------------------------------------------------------------------------------------------------------------------------------------------------------------------------
--------------------------------------------------------------------------------------------------------------------------------------------------------------------------------------------------------
--------------------------------------------------------------------------------------------------------------------------------------------------------------------------------------------------------
-BBB-------------------------------------------------------------------------------------B------------------------------------------------------------B-------------------------------------------------
--------------------------------------------------------------------------------------------------------------------------------------------------------------------------------------------------------
--------------------------------------------------------------------------------------------------------------------------------------------------------------------------------------------------------
--------------------------------------------------------------------------------------------------------------------------------------------------------------------------------------------------------
--------------------------------------------------------------------------------------------------------------------------------------------------------------------------------------------------------
B------------------------------------------------------------------------------------C----tt----------------------------------------------------------------------#-------------------------------------
--------------------------#--------------------------------------------------tt-----------tt--------------------------------------------------------------tttttttt#-tttttttttttttttttttt-tttttttt-tttttt
-------------------tt---#-#--------------------------------------------------tt-------tt--tt-------------------------------------------------------------#tttttttt#-tttttttttttttttttttt-tttttttt-tttttt
----#k-g-k-g-k-k-g-tt---#-#k-k-k-g-k-g-kg-k-g-k-g-g-k-g-g-k-g-k-g-k-k-g----#-ttg-k-g#-ttk-tt-#k-g-k-k-g-gg-k-g-gk-g-gg-g-k-g-g--g-k-g-g-gg-g-gg-g-g-g--gg#tttttttt#-tttttttttttttttttttt#tttttttt-tttttF
XXXXXXXXXXXXXXXXXXXXXXX-X-XXXXXXXXXXXXXXXXXXXXXXXXXXXXXXXXXXXXXXXXXXXXXXXXXX-XXXXXXXXXXXX-XXXXXXXXXXXXXXXXXXXXXXXXXXXXXXXXXXXXXXXXXXXXXXXXXXXXXXXXXXXXXXXXXXXXXXXXXXXXXXXXXXXXXXXXXXXXXXXXXXXXXXXXXXXXXX
XXXXXXXXXXXXXXXXXXXXXXX-X-XXXXXXXXXXXXXXXXXXXXXXXXXXXXXXXXXXXXXXXXXXXXXXXXXX-XXXXXXXXXXXX-XXXXXXXXXXXXXXXXXXXXXXXXXXXXXXXXXXXXXXXXXXXXXXXXXXXXXXXXXXXXXXXXXXXXXXXXXXXXXXXXXXXXXXXXXXXXXXXXXXXXXXXXXXXXXX
