--------------------------------------------------------------------------------------------------------------------------------------------------------------------------------------------------------
--------------------------------------------------------------------------------------------------------------------------------------------------------------------------------------------------------
--------------------------------------------------------------------------------------------------------------------------------------------------------------------------------------------------------
--------------------------------------------------------------------------------------------------------------------------------------------------------------------------------------------------------
--------------------------------------------------------------------------------------------------------------------------------------------------------------------------------------------------------
--------------------------------------------------------------------------------------------------------------------------------------------------------------------------------------------------------
--------------------------------------------------------------------------------------------------------------------------------------------------------------------------------------------------------
----------------------------------------------------------------------------------------------------------------------------------------------------U---------------------------------------------------
------------------------------------------------------------------------------------------------------------------------------------------------------------CBC-----------------------------------------
--------------------------g--------------------------------------------------------2BBCCCBBB----------------g-------------------------------------------------------------------------------------------
----------------------------------------------------------------------------------gkkkgkkkggggg---------------------------------------------------------ggggggggg--------------------g------------------
--------------------------------------------------------------------------------r----------------------------------------------CBBBCB2C---%%%%%%%%%%%%%%------------------------------------------------
---------------------------------------------------------------%%%%%-%%%%%%%%%%%%--------------%%%%%%%%%%%%-------------------------------||||||||||||||---------%%%%%%%%---%%%%%%%%%%------------------
-----------------------------------------------g--g--g---------|||||-||||||||||||--------------||||||||||||-------------------g--------g-g||||||||||||||---------||||||||---||||||||||------------------
------%%%%%----------------------------------------------------|||||-||||||||||||%%%%%%%%%%%%%%||||||||||||-------------------------------||||||||||||||%%%%%%%%%||||||||---||||||||||------------------
%%%%%%|||||%%%%%%%%%%%%%%-----%%%%%%%%%%%%%---%%%%%%%%%%%----%%%%%%%%||||||||||||||||||||||||||||||||||||||----%%%%%%%%%%%%%%%%%%%%%%%%%%%|||||||||||||||||||||||||||||||---||||||||||----%%%%%%%%%%%F%%
