--------------------------------------------------------------------------------------------------------------------------------------------------------------------------------------------------------
--------------------------------------------------------------------------------------------------------------------------------------------------------------------------------------------------------
--------------------------------------------------------------------------------------------------------------------------------------------------------------------------------------------------------
--------------------------------------------------------------------------------------------------------------------------------------------------------------------------------------------------------
--------------------------------------------------------------------------------------------------------------------------------------------------------------------------------------------------------
--------------------------------------------------------------------------------------------------------------------------------------------------------------------------------------------------------
--------------------------------------------------------------------------------------------------------------------------------------------------------------------------------------------------------
------------------------------------------------------------------------------------------------------------g-------------------------------------------------------------------------------------------
-----------------------------------------------------------------------------------------g-----g--------------------------------------------------------------------------------------------------------
-----------------------------------------------------------------SSSCSCCSC--------------------------------%%%%%%%%--------------------------g-----------------------------------------------------------
----------------------------------------g----------------------kggggggkkgggg------------%%%%%%%%%%%%------||||||||--------------------------------------------------------------------------------------
--------------------------------%%%%%------------------------r--------------------------||||||||||||----%%%%%%%%%%%%%%------------------------------------------------------------------%%%%%%%---------
--------------------------------|||||----------------%%%%%%%%%--------------%%%%%%%%%%%%||||||||||||----||||||||||||||----------------tt-----------------g------------------------------|||||||---------
--------------------------------|||||--------XX%%%%--|||||||||--------------||||||||||||||||||||||||----||||||||||||||-----%%%--------tt-------------------------k---k--------k-------%%%%%%%%%%%%%-----
------%%%%%---------------------|||||-------XXX||||--|||||||||%%%%%%%%%%%%%%||||||||||||||||||||||||----||||||||||||||-----|||--------tt----------------------------------------------|||||||||||||-----
XXXXXX|||||XXXXXXXXXXXXXX-----XXXXXXXXX----XXXXXXXXXX|||||||||||||||||||||||||||||||||||||||||||||||----||||||||||||||-----|||----XXXXXXXXX---XXXXXXXXXXX-----XXXXXXXXXX-----XXXXXXXXX|||||||||||||XXFXX
