--------------------------------------------------------------------------------------------------------------------------------------------------------------------------------------------------------
--------------------------------------------------------------------------------------------------------------------------------------------------------------------------------------------------------
--------------------------------------------------------------------------------------------------------------------------------------------------------------------------------------------------------
--------------------------------------------------------------------------------------------------------------------------------------------------------------------------------------------------------
-----------------------------------------------------------------------------------------------------------------------------------------------C2SCUS-%%%%%%%%%-----------------------------------------
------------------------------------------------------------------------------------------------------------------------------------------------------|||||||||-----------------------------------------
-----------------------------------------------------------------------------------------------------------------------------------------2CU2C--------|||||||||-----------------------------------------
------------------------------------------------------------------------------------------------------------------------------------------------------|||||||||---------tt------------------------------
------------------------------------------------------------------------gg-----------------kggggggg---------------------------------------------------|||||||||---------tt-------%%%%%%-----------------
-----------------------------------------------------------------------------------------r--||||||----------------------------------------------------|||||||||---------tt-------||||||-----------------
----------------------------------------------------gkkkgggg----------------------%%%%%%%%--||||||-%%%%%%%%%%%-------------------%%%%%%%%%%%%%%%%%%%%%|||||||||---%%%%%%%%%%%%%%%%%%%%%%%---------------
-------------------------------%%%%%--------------r--||||||-----------------------||||||||--||||||-|||||||||||------g---k--------||||||||||||||||||||||||||||||---|||||||||||||||||||||||%%%%%%%%%%%%F%%
-------------------------------|||||-%%%%%%%%%%%%%%--||||||-%%%%%%%%%-----%%%%%%%%||||||||%%%%%%%%%|||||||||||-------------------||||||||||||||||||||||||||||||---|||||||||||||||||||||||||||||||||||%||
--------------------------gg---|||||-||||||||||||||--||||||-|||||||||-----||||||||||||||||||||||||||||||||||||-----%%%%%%%%%%%%%%||||||||||||||||||||||||||||||---||||||||||||||||||||||||||||||||||||||
------%%%%%--------------------|||||-||||||||||||||%%%%%%%%%|||||||||-----||||||||||||||||||||||||||||||||||||-----||||||||||||||||||||||||||||||||||||||||||||---||||||||||||||||||||||||||||||||||||||
XXXXXX|||||XXXXXXXXXXXXXX----XXXXXXXX||||||||||||||||||||||||||||||||-----||||||||||||||||||||||||||||||||||||-----||||||||||||||||||||||||||||||||||||||||||||---||||||||||||||||||||||||||||||||||||||
