--------------------------------------------------------------------------------------------------------------------------------------------------------------------------------------------------------
--------------------------------------------------------------------------------------------------------------------------------------------------------------------------------------------------------
--------------------------------------------------------------------------------------------------------------------------------------------------------------------------------------------------------
--------------------------------------------------------------------------------------------------------------------------------------------------------------------------------------------------------
--------------------------------------------------------------------------------------------------------------------------------------------------------------------------------------------------------
--------------------------------------------------------------------------------------------------------------------------------------------------------------------------------------------------------
--------------------------------------------------------------------------------------------------------------------------------------------------------------------------------------------------------
--------------------------------------------------------------------------------------------------------------------------------------------------------------------------------------------------------
--------------------------------------------------------------------------------------------%%%%%-------------------------------------------------------------------------------------------------------
--------------------------------------------------------------------------------------------|||||-------------------------------------------------------------------------------------------------------
---------------------------------U------------------------------g---------------------------|||||-------------------------------------------------------------------------------------------------------
-------------------------------------gkgggkggggkgg--------------------------g--------------%%%%%|--g----------BB2C--------------------2UB------------------------------r--r-----k---CBUB----------------
------------------------------------------------------------------------------------------%%%%%%%%------------------------------------------------------------------------------------------------------
--------------------------------------------------%%%%%%%%%%%%%-----%%%%%-----------------||||||||%%%%%%%%%----------------------------------gk-----------------------%%%%%%%%%%%%----------------------
------%%%%%------------------%%%%%%%%-------------|||||||||||||-----|||||-----------------|||||||||||||||||-----------------------------------------------------------||||||||||||----------------------
%%%%%%|||||%%%%%%%%%%%%%%----||||||||%%%%%%%%%%%%%|||||||||||||---%%%%%%%%-----%%%%%%%%%%%|||||||||||||||||%%%%%%%%%---%%%%%%%%%%%%%%%%%%%%%----%%%%%%%%%%%%%%%%%%%%%%||||||||||||%%%%%%%%%%%%%%%%%%%F%%
