--------------------------------------------------------------------------------------------------------------------------------------------------------------------------------------------------------
--------------------------------------------------------------------------------------------------------------------------------------------------------------------------------------------------------
--------------------------------------------------------------------------------------------------------------------------------------------------------------------------------------------------------
--------------------------------------------------------------------------------------------------------------------------------------------------------------------------------------------------------
--------------------------------------------------------------------------------------------------------------------------------------------------------------------------------------------------------
--------------------------------------------------------------------------------------------------------------------------------------------------------------------------------------------------------
--------------------------------------------------------------------------------------------------------------------------------------------------------------------------------------------------------
--------------------------------------------------------------------------------------------------------------------------------------------------------------------------------------------------------
--------------------------------------------------------------------------------------------------------------------------------------------------------------------------------------------------------
--------------------------------------------------------------------------------------------------------------------------------------------------------------------------------------------------------
-------------------------g-------------U------------------------------------------------------------------------------------------------------------------------rr--------------------------------------
-------------------------------------------kgkggkgggkgk-----------------------------2SCC-----------------------------------%%%%-------------------------------------------------------------------------
-----------------------------------------------------------------------------------------------------------------%%%%%%----|%%%%%%----------------------tt-----%%%%%%%%%%%%%%---%%%%%%%%%%%%%%%%%%%%%F%%
-------------------------------------------------------%%%%%%%%%%%%%---%%%%%%%%%%----------------g------g--------||||||----|||||||--------%%%-----------tt-----||||||||||||||---|||||||||||||||||||||%||
------%%%%%------------------%%%%%%%%%%%%%%------------|||||||||||||---||||||||||--------------------------------||||||----|||||||--------|||-----------tt-----||||||||||||||---||||||||||||||||||||||||
XXXXXX|||||XXXXXXXXXXXXXX----||||||||||||||XXXXXXXXXXXX|||||||||||||---||||||||||XXXXXXXXXX-----XXXXXXXXXXX----XXXXXXXXXXXXXXXXXXXXXX-----|||----XXXXXXXXXXXXXX||||||||||||||---||||||||||||||||||||||||
