--------------------------------------------------------------------------------------------------------------------------------------------------------------------------------------------------------
--------------------------------------------------------------------------------------------------------------------------------------------------------------------------------------------------------
--------------------------------------------------------------------------------------------------------------------------------------------------------------------------------------------------------
--------------------------------------------------------------------------------------------------------------------------------------------------------------------------------------------------------
--------------------------------------------------------------------------------------------------------------------------------------------------------------------------------------------------------
--------------------------------------------------------------------------------------------------------------------------------------------------------------------------------------------------------
--------------------------------------------------------------------------------------------------------------------------------------------------------------------------------------------------------
--------------------------------------------------------------------------------------------------------------------------------------------------------------------------------------------------------
---------------------------------------------------------------------------U--------------------------------------------------------------------------------------------g---g---------------------------
--------------------------------------------------------------------------------------------------------------------------------------------------------------------------------------------------------
---------------------------------------------------------------------------------%%%%%%%%%%---------------------------------------------------------------------------%%%%%%%%%%%%%---------------------
-------------------------------------------------------------------------------gkggkggggkggkk------------------------------------------------------%%%%%--------------|||||||||||||---------------------
-----------------------------------------------------g------------%%%%%%%%%%%%%--XXXXXXXXXX--------------------------------------------------------|||||---g---g--g---|||||||||||||-----k----------r----
--------------------------gg---g---tt-----------------------------|||||||||||||--XXXXXXXXXX--%%%%%%%%------------------g---g-g---------------------|||||--------------|||||||||||||-----------------%F%%
------%%%%%------------------------tt--------%%%----%%%%%%%%%%%%%%|||||||||||||--XXXXXXXXXX--||||||||--------------------------------------------%%%%%%%%%%%%%%%%%%%%%|||||||||||||----%%%%%%%%%%%%%|X||
%%%%%%|||||%%%%%%%%%%%%%%-----%%%%%%%%%%-----|||----|||||||||||||||||||||||||||%%%%%%%%%%%%%%||||||||---%%%%%%%%%%%%%%----%%%%%%%%%%%%%%%%%%%%%%%||||||||||||||||||||||||||||||||||----||||||||||||||X||
