--------------------------------------------------------------------------------------------------------------------------------------------------------------------------------------------------------
--------------------------------------------------------------------------------------------------------------------------------------------------------------------------------------------------------
--------------------------------------------------------------------------------------------------------------------------------------------------------------------------------------------------------
--------------------------------------------------------------------------------------------------------------------------------------------------------------------------------------------------------
--------------------------------------------------------------------------------------------------------------------------------------------------------------------------------------------------------
--------------------------------------------------------------------------------------------------------------------------------------------------------------------------------------------------------
--------------------------------------------------------------------------------------------------------------------------------------------------------------------------------------------------------
--------------------------------------------------------------------------------------------------------------------------------------------------------------------------------------------------------
-------------------------------------------------------------------------------------------------------------------------------------k----------k-------%%%-----k---k-----------------------------------
----------------------------------------------------------------------------------------------------------------CBCBBCUBB--%%%%%%%%%--------------------|%%%%%-------------------%%%%%------------------
---------------------------------------------------------------------------------------------%%%%%%%-----------------------|||||||||%%%%%%%%%%%%%%------||||||-%%%%%%%%%%%-------|||||--%%%%%%%%%%%%%F%%
--------------------------------------------------------------------gggkkggg-----------------|||||||--------CU-------------|||||||||||||||||||||||-----%%%%%%%%|||||||||||-------|||||--|||||||||||||X||
--------------------------------------------%%%%%%%%-----------------------------------------|||||||-----------------------|||||||||||||||||||||||-----|||||||||||||||||||-----%%%%%%%%%|||||||||||||X||
--------------------------------------------||||||||--------------r---------%%%%%%%%%%-----%%%%%%%%%%%%--------------------|||||||||||||||||||||||-----|||||||||||||||||||-----||||||||||||||||||||||X||
------%%%%%---------------------------------||||||||----%%%%%%%%%%%---------||||||||||-----||||||||||||--------------------|||||||||||||||||||||||-----|||||||||||||||||||-----||||||||||||||||||||||X||
%%%%%%|||||%%%%%%%%%%%%%%---%%%%%%%%%%%---%%%%%%%%%%%%%%|||||||||||%%%%%%%%%||||||||||-----||||||||||||%%%%%%%%%%%%%%%%%%%%|||||||||||||||||||||||-----|||||||||||||||||||-----||||||||||||||||||||||X||
