--------------------------------------------------------------------------------------------------------------------------------------------------------------------------------------------------------
--------------------------------------------------------------------------------------------------------------------------------------------------------------------------------------------------------
--------------------------------------------------------------------------------------------------------------------------------------------------------------------------------------------------------
--------------------------------------------------------------------------------------------------------------------------------------------------------------------------------------------------------
--------------------------------------------------------------------------------------------------------------------------------------------------------------------------------------------------------
--------------------------------------------------------------------------------------------------------------------------------------------------------------------------------------------------------
------------------------------------------------------------------------------------------------------------------------------------------------------------------------------SU2SSCCS------------------
--------------------------------------------------------------------------------------------------------------------------------------------------------------------------------------------------------
-------------------------------------------------------------------------------------------------------------------------------------------------------ggggggggggg--------------------------------------
-------------------------------------------------------------------------g---------------------------------------------------------------------------r--|||||||||---------------------------------------
--------------------------------------------------------------------------------------------------------------------------------------------%%%%%%%%%%--|||||||||-%%%%%%%%%%%%%%%%%%%%%%%%%%%%%%%%%%%F%%
------------------------------------------------kgggkkgkgk----------------------------------------------------------------------------------||||||||||--|||||||||-|||||||||||||||||||||||||||||||||||%||
-------------------------------------------------%%%%%%%%--------------------%%%%%---------------------------------tt-----------------------||||||||||%%%%%%%%%%%%||||||||||||||||||||||||||||||||||||||
-------------------------------g----g---------r--||||||||-%%%%%%%%%%%%-------|||||---------------------------------tt---g-------------------||||||||||||||||||||||||||||||||||||||||||||||||||||||||||||
------%%%%%---------------------------%%%%%%%%%--||||||||-||||||||||||-------|||||---------------------------------tt----------%%%%%%%%%%%%%||||||||||||||||||||||||||||||||||||||||||||||||||||||||||||
XXXXXX|||||XXXXXXXXXXXXXX-----XXXXXXXX|||||||||XXXXXXXXXXX||||||||||||-----XXXXXXXXX----XXXXXXXXXXX-----XXX----XXXXXXXXXXXXXXXX|||||||||||||||||||||||||||||||||||||||||||||||||||||||||||||||||||||||||
