--------------------------------------------------------------------------------------------------------------------------------------------------------------------------------------------------------
--------------------------------------------------------------------------------------------------------------------------------------------------------------------------------------------------------
--------------------------------------------------------------------------------------------------------------------------------------------------------------------------------------------------------
--------------------------------------------------------------------------------------------------------------------------------------------------------------------------------------------------------
--------------------------------------------------------------------------------------------------------------------------------------------------------------------------------------------------------
--------------------------------------------------------------------------------------------------------------------------------------------------------------------------------------------------------
--------------------------------------------------------------------------------------------------------------------------------------------------------------------------------------------------------
--------------------------------------------------------------------------------------------------------------------------------------------------------------------------------------------------------
-----------------------------------------------------------g-----g-----------------------------------------%%%%%----------------------------------------------------------------------------------------
--------------------------------------gggkgkg--------------------------------------------------------------|||||----------------------------------------------------------------------------------------
------------------------------------r--XXXXX---------------------------------------------------------------|||||-----------------------------BBBBBCU----------------------------------------------------
-------------------------%%%%%%%%%%%%--XXXXX-%%%%%%%%%%%%%------%%%%%%%--------%%%-----------------------%%%%%%%%%-------------g----r-------------------2BB2C--------------------------------%%%%%%%%F%%
-------------------------||||||||||||--XXXXX-|||||||||||||------|||||||--------|||--------------%%%%%%---|||||||||---------------------------------------------------------------------------||||||||X||
-------------------------||||||||||||%%%%%%%%|||||||||||||------|||||||--------|%%%%%%------g---||||||---|||||||||-----%%%----%%%%%%%%%%%%%--------------k-------------------------r-------k-||||||||X||
------%%%%%--------------|||||||||||||||||||||||||||||||||------|||||||--------|||||||----------|%%%%|---|||||||||-----|||----|||||||||||||%%%%%%%%%%%---------------------------------------||||||||X||
%%%%%%|||||%%%%%%%%%%%%%%|||||||||||||||||||||||||||||||||----%%%%%%%%%%%%%---%%%%%%%%%%%-----%%%%%%%%%%%|||||||||-----|||----||||||||||||||||||||||||%%%%%%%%%%-----%%%%%%%%%%%%%%%%%%%%%%%%||||||||X||
