--------------------------------------------------------------------------------------------------------------------------------------------------------------------------------------------------------
--------------------------------------------------------------------------------------------------------------------------------------------------------------------------------------------------------
--------------------------------------------------------------------------------------------------------------------------------------------------------------------------------------------------------
--------------------------------------------------------------------------------------------------------------------------------------------------------------------------------------------------------
--------------------------------------------------------------------------------------------------------------------------------------------------------------------------------------------------------
--------------------------------------------------------------------------------------------------------------------------------------------------------------------------------------------------------
--------------------------------------------------------------------------------------------------------------------------------------------------------------------------------------------------------
-----------------------------------------------------------------------------------------------------------------------------------------------------------------------------SSCC-----------------------
--------------------------------------------------------------------------------------------------------------------------------------------------------------------------------------------------------
--------------------------------------------------------------------------------------------------------------------------------------------------------------------------------------------------------
-----------------------------------------------------------------------------------------------------------------------------2SCCSSCCCS-----------------------------------------------------------------
--------------------------------------------------------ggkggggg---------------%%%%%---g----------------%%%%%%%-------------kgggggkkggggk-----------------------------------%%%%%%----------------------
---------------------------------------------------------%%%%%%----------------|||||--------------------|%%%|||-----------r--------------------------------g---g------------||||||----------------------
-------------------------------g---g------------------r--||||||-%%%%%%%%%%-----|||||--%%%%%%%%%%%%%-----|||||||----%%%%%%%%--------------%%%%%%%%%%%%%----------------------||||||---gg-----------------
------%%%%%-------------------------------%%%%%%%%%%%%%--||||||-||||||||||-----|||||--|||||||||||||-----|||||||----||||||||--------------|||||||||||||----%%%%%%%%%%%%------||||||----------------------
XXXXXX|||||XXXXXXXXXXXXXX-----XXXXXXXXXXXX|||||||||||||XXXXXXXXX||||||||||---XXXXXXXXX|||||||||||||---XXXXXXXXXXXXX||||||||XXXXXXXXXXXXXX|||||||||||||----||||||||||||----XXXXXXXXXX----XXXXXXXXXXXXXFXX
