--------------------------------------------------------------------------------------------------------------------------------------------------------------------------------------------------------
--------------------------------------------------------------------------------------------------------------------------------------------------------------------------------------------------------
--------------------------------------------------------------------------------------------------------------------------------------------------------------------------------------------------------
--------------------------------------------------------------------------------------------------------------------------------------------------------------------------------------------------------
--------------------------------------------------------------------------------------------------------------------------------------------------------------------------------------------------------
--------------------------------------------------------------------------------------------------------------------------------------------------------------------------------------------------------
--------------------------------------------------------------------------------------------------------------------------------------------------------------------------------------------------------
--------------------------------------------------------------------------------------------------------------------------------------------------------------------------------------------------------
------------------------------------------------------------------------------------------------------------------------g---------g---------------------------------------------------------------------
--------------------------------------------------------------------------------------------gkgkgkggkgggk--------------------------------------------------------------------k--------------------------
------------------------------------------------------------------------------------------r--|||||||||||-------------------------------------------SCCC22S2---------------------------------------------
-------------------------------%%%%------------------------------------------%%%%%%%%%%%%%%--|||||||||||-%%%%%%%%%%%%%%----------------gg-----------------------------------%%%%%%%%%%%%%%--------------
-------------------------------||||---g-------------g------------------------||||||||||||||--|||||||||||-||||||||||||||-----------------------------------------------------||||||||||||||--------------
------------------------------%%%%%------------------------------------------||||||||||||||%%%%%%%%%%%%%%||||||||||||||---------------%%%%%%%%%%--------------%%%%%%%%%%%%%%||||||||||||||%%%%%%%%%%%F%%
------%%%%%-------------------|||||----------------%%%%%%%%%%%%%----%%%%%%%%%||||||||||||||||||||||||||||||||||||||||||---------------||||||||||%%%%%%%%%%%%%%|||||||||||||||||||||||||||||||||||||||%||
XXXXXX|||||XXXXXXXXXXXXXX---XXXXXXXXX---XXXXXXXXXXX|||||||||||||----|||||||||||||||||||||||||||||||||||||||||||||||||||----XXXXXXXXXXX||||||||||||||||||||||||||||||||||||||||||||||||||||||||||||||||||
