--------------------------------------------------------------------------------------------------------------------------------------------------------------------------------------------------------
--------------------------------------------------------------------------------------------------------------------------------------------------------------------------------------------------------
--------------------------------------------------------------------------------------------------------------------------------------------------------------------------------------------------------
--------------------------------------------------------------------------------------------------------------------------------------------------------------------------------------------------------
--------------------------------------------------------------------------------------------------------------------------------------------------------------------------------------------------------
--------------------------------------------------------------------------------------------------------------------------------------------------------------------------------------------------------
--------------------------------------------------------------------------------------------------------------------------------------------------------------------------------------------------------
--------------------------------------------------------------------------------------------------------------------------------------------------------------------------------------------------------
---------------------------------------------------------------------------------------------------g-------------------------U--------------------------------------------------------------------------
-------------------------------------------------------------------------------------------------------------------------------------BBBC2B-----------------g--------g-----CCC22B---g----g--------------
-------------------------------------------------------------------------------2CCCCBBB------------------------------------------------------------------------------------------------------%%%%%%%%F%%
---------------------------------%%%%----------------------------------------ggggkkkkkkggg---------------------------------------ggggggggggggg--------------%%%%%%%%%%%%-----------%%%%%%%%%%||||||||X||
---------------------------------||||--------------------------------------r------------------------------------------%%%%%%%%%%%---------------------------||||||||||||-----------||||||||||||||||||X||
--------------------------------%%%%%-----g------------------------%%%%%%%%%--------------%%%%%%%%--------------------|||||||||||-------------%%%%%%%%%%%%%%||||||||||||%%%%%%%%%%%||||||||||||||||||X||
------%%%%%---------------------|||||------------------------------|||||||||--------------||||||||--------------------|||||||||||-------------|||||||||||||||||||||||||||||||||||||||||||||||||||||||X||
%%%%%%|||||%%%%%%%%%%%%%%-----%%%%%%%%---%%%%%%%%%%%%%%---%%%%%%%%%|||||||||%%%%%%%%%%%%%%||||||||---%%%%%%%%%%%%%----|||||||||||%%%%%%%%%%%%%|||||||||||||||||||||||||||||||||||||||||||||||||||||||X||
