--------------------------------------------------------------------------------------------------------------------------------------------------------------------------------------------------------
--------------------------------------------------------------------------------------------------------------------------------------------------------------------------------------------------------
--------------------------------------------------------------------------------------------------------------------------------------------------------------------------------------------------------
--------------------------------------------------------------------------------------------------------------------------------------------------------------------------------------------------------
--------------------------------------------------------------------------------------------------------------------------------------------------------------------------------------------------------
--------------------------------------------------------------------------------------------------------------------------------------------------------------------------------------------------------
----------------------------------------------------------------------------------------------------------------------------------------------------%%%%%%%---------------------------------------------
----------------------------------------------------------------------------------------------------------------------------------------------------|||||||---------------------------------------------
-----------------------------------------------------------gg-----g---------------------------------------------------------------------------------|||||||-------CUS-----------------------------------
-------------------------------------------------------------------U--------------------------------------------------------------------------------|%%%%%%%--------------------------------------------
--------------------------------------------------------------------------------------------------------------------------------------------------%%%%%%%%%%%%%-----------------------------------------
-----------------------------------gkkggggggk--------------------------ggggggkgkgggg--------------------------------------------------------------|||||||||||||-----------------------------------------
------------------------------------%%%%%%%%-----------------------------|||||||||-------------------------------------------------------gg-------|||||||||||||%%%%%%%%---------------k--%%%%%%%--------
---------------------------------r--||||||||-%%%%%%%%%%%%%-----%%%%%%%%--|||||||||--%%%%%%%%%%%%----gg----------g%%%%%%%%%%%----------------------|||||||||||||||||||||------gg----------|||||||--------
------%%%%%--------------%%%%%%%%%--||||||||-|||||||||||||-----||||||||--|||||||||--||||||||||||-----------------|||||||||||------------%%%%%%%%%%|||||||||||||||||||||------------------|||||||--------
XXXXXX|||||XXXXXXXXXXXXXX|||||||||XXXXXXXXXXX|||||||||||||-----||||||||XXXXXXXXXXXXX||||||||||||---XXXXXXXXXXXXXX|||||||||||-----XXX----|||||||||||||||||||||||||||||||----XXXXXXXX----XXXXXXXXXXXXXXFXX
