--------------------------------------------------------------------------------------------------------------------------------------------------------------------------------------------------------
--------------------------------------------------------------------------------------------------------------------------------------------------------------------------------------------------------
--------------------------------------------------------------------------------------------------------------------------------------------------------------------------------------------------------
--------------------------------------------------------------------------------------------------------------------------------------------------------------------------------------------------------
--------------------------------------------------------------------------------------------------------------------------------------------------------------------------------------------------------
--------------------------------------------------------------------------------------------------------------------------------------------------------------------------------------------------------
--------------------------------------------------------------------------------------------------------------------------------------------------------------------------------------------------------
--------------------------------------------------------------------------------------------------------------------------------------------------------------------------------------------------------
--------------------------------------------------------------------------------------------------------------------------------------------------------------------------------------------------------
----------------------------------------------------------------------------------------------------------------------------------------------------------------------------g---------------------------
-----------------------------------------------------------------------------------------------------------------------------------U--------------------------------------------------------------------
------------------------------------------------------ggggkggggkk-----------------------------------%%%%%----BCUBCCB2------------------gkggkggggkggg----------------------------------------------------
----------------------------------------------------r--XXXXXXXXX------------------------------------|||||--------------------------------%%%%%%%%%--------------%%%%%%%%%%%-----------------------------
-------------------------------g-g-----g%%%%%%%%%%%%%--XXXXXXXXX-%%%%%%%%%%%%%------gg-----g--------|||||----------------g-----g---------|||||||||--%%%%%%%%%%%%|||||||||||-----%%%%%--g------g--g------
------%%%%%-----------------------------|||||||||||||--XXXXXXXXX-|||||||||||||----------------------|||||------------------%%%%%%%%%%%%--|||||||||--|||||||||||||||||||||||-----|||||-------------------
%%%%%%|||||%%%%%%%%%%%%%%-----%%%%%%%%%%|||||||||||||%%%%%%%%%%%%|||||||||||||-----%%%%%%%%%%%----%%%%%%%%%%%%%%%%%%%%%%---||||||||||||%%%%%%%%%%%%%|||||||||||||||||||||||---%%%%%%%%-----%%%%%%%%%%F%%
