--------------------------------------------------------------------------------------------------------------------------------------------------------------------------------------------------------
--------------------------------------------------------------------------------------------------------------------------------------------------------------------------------------------------------
--------------------------------------------------------------------------------------------------------------------------------------------------------------------------------------------------------
--------------------------------------------------------------------------------------------------------------------------------------------------------------------------------------------------------
--------------------------------------------------------------------------------------------------------------------------------------------------------------------------------------------------------
--------------------------------------------------------------------------------------------------------------------------------------------------------------------------------------------------------
--------------------------------------------------------------------------------------------------------------------------------------------------------------------------------------------------------
--------------------------------------------------------------------------------------------------------------------------------------------------------------------------------------------------------
--------------------------------------------------------------------------------------------------------------------------------------------------------------------------------------------------------
--------------------------------------------------------------------------------------------------------------------------------------------------------------------------------------------------------
-----------------------------------------g------------------------------------------------------------------SSSCS---------------------------------------------------------------------------------------
---------------------------------------------%%%%%%-------------------------------2U-----------------------ggkkgkkgg--------------------------g---r-------S2CSSC2SS-------------------------------------
---------------------------------------------||||||------------------------------------------------------r-------------------%%%%%%%%%%%%---------------------------------------------------------------
---------------------------------------------||||||-----------------------------g-----g-----------%%%%%%%%----------%%%%%%%%%||||||||||||----%%%%%%%%%%%-------------------------k----------------------
------%%%%%----------------------------------||||||--------%%%----%%%%%%%%%%%%%-------------------||||||||----------|||||||||||||||||||||----|||||||||||-------------%%%%%%%%%%%------------------------
XXXXXX|||||XXXXXXXXXXXXXX----XXXXXXXXXXX---XXXXXXXXXXX-----|||----|||||||||||||XXXXXXXX---XXXXXXXX||||||||XXXXXXXXXX|||||||||||||||||||||----|||||||||||XXXXXXXXXXXXX|||||||||||XXXXXXXXXXXXXXXXXXXXXFXX
