--------------------------------------------------------------------------------------------------------------------------------------------------------------------------------------------------------
--------------------------------------------------------------------------------------------------------------------------------------------------------------------------------------------------------
--------------------------------------------------------------------------------------------------------------------------------------------------------------------------------------------------------
--------------------------------------------------------------------------------------------------------------------------------------------------------------------------------------------------------
--------------------------------------------------------------------------------------------------------------------------------------------------------------------------------------------------------
--------------------------------------------------------------------------------------------------------------------------------------------------------------------------------------------------------
--------------------------------------------------------------------------------------------------------------------------------------------------------------------------------------------------------
--------------------------------------------------------------------------------------------------------------------------------------------------------------------------------------------------------
--------------------------------------------------------------------------------------------------------------------------------------------------2CUCC22--%%%%%%%%%%%%%-r------------------------------
-------------------------------U---------------------------------------------------------------------------------------------------------------------------|||||||||||||--------------------------------
--------------------------------------SSSSSCCC--------------------------------------------------------------------------------------------2S2SU------------|||||||||||||---%%%%%%%%---------------------
-----------------------------------gggggggkgggkg-----------------------------------------------------------------------------------------------------------|||||||||||||---||||||||-----%%%%%-----------
---------------------------------------------------------------------------------------------r-----%%%%%%--------------------------------------------------|||||||||||||---||||||||----%%%%%|-----------
-------------------------%%%%%%%%%%-------------%%%%%%%%%------------------------%XXXXXX-----------||||||-------r-r------r---------------------------------|||||||||||||---||||||||----||||||-----------
------%%%%%--------------||||||||||-------------|||||||||----%%%%%%%%%%%%%%------|XXXXXXXX---------||||||----------------------------%%%%%%%%%%%%%%%%%%%%%%|||||||||||||---||||||||---%%%%%%%%%---------
XXXXXX|||||XXXXXXXXXXXXXX||||||||||XXXXXXXXXXXXX|||||||||----||||||||||||||----XXXXXXXXXXXXX-----XXXXXXXXXX----XXXXXXXXXXXXXXXXXXXXXX|||||||||||||||||||||||||||||||||||---||||||||---|||||||||XXXXXXFXX
