--------------------------------------------------------------------------------------------------------------------------------------------------------------------------------------------------------
--------------------------------------------------------------------------------------------------------------------------------------------------------------------------------------------------------
--------------------------------------------------------------------------------------------------------------------------------------------------------------------------------------------------------
--------------------------------------------------------------------------------------------------------------------------------------------------------------------------------------------------------
--------------------------------------------------------------------------------------------------------------------------------------------------------------------------------------------------------
--------------------------------------------------------------------------------------------------------------------------------------------------------------------------------------------------------
--------------------------------------------------------------------------------------------------------------------------------------------------------------------------------------------------------
--------------------------------------------------------------------------------------------------------------------------------------------------------------------------------------------------------
--------------------------------------------------------U------------------------------------------------g----------------------------------------------------------------------------------------------
---------------------------------------------------------------BB---------------------------------------------------------------------------------------------------------------------------------------
----------------------------------------------------------------------------------------------g------g----------------------------------2B2BCUCB--------------------------------------------------------
------------------------------------------------------------ggggkkgg-------------------------------------------------------------------------------------------------------------2C22BBB22C-------------
--------------------------------------g----g--------%%%%%%%%--------------------------tt-----%%%%%%%%%%%%---%%%%%%%%%%%----------------g-r--------------------------------------------------------------
------------------------------%%%-------------------||||||||--------%%%%%%%%%---------tt-----||||||||||||---|||||||||||--------------------------------------r----r-r-----k-----------------------------
------%%%%%-------------------|||----%%%%%%%%%%%%---||||||||--------|||||||||---%%%%%%%%%%%%%||||||||||||---|||||||||||-----%%%%%%%%%%%%%%%%%%%%%%------------------------------------------------------
%%%%%%|||||%%%%%%%%%%%%%%-----|||----||||||||||||---||||||||%%%%%%%%|||||||||---|||||||||||||||||||||||||---|||||||||||-----||||||||||||||||||||||%%%%%%%%%%-----%%%%%%%%%%%%%%%%%%%%%%%%%%%%%%%%%%%%F%%
