--------------------------------------------------------------------------------------------------------------------------------------------------------------------------------------------------------
--------------------------------------------------------------------------------------------------------------------------------------------------------------------------------------------------------
--------------------------------------------------------------------------------------------------------------------------------------------------------------------------------------------------------
------------------------------------------------------------------------------------------------------------------------------U-------------------------------------------------------------------------
--------------------------------------------------------------------------------------------------------------------------------------2BB2CB2B----------------------------------------------------------
--------------------------------------------------------------------------------------------------------------------------------------------------------------------------------------------------------
----------------------------------------------------------------------------------------------------------------------------------ggkkkggggggggg--------------------------------------------------------
----------------------------------------------------------------------------------------------------------------------%%%%%%%%%%%%----------------------------------------------------------------------
----------------------------------------------------------------------------------------------------------------------||||||||||||--------------%%%%%%%%%---------------g-------g-----------------------
----------------------------------------------------------------------------------------------------------------%%%%%-||||||||||||--------------|||||||||-----------------------------------------------
----------------------------------------------------------g-----------------------------------------------------|%%%|-||||||||||||%%%%%%%%%%%%%%|||||||||%%%%%%%%%%%%%%---------------------------------
----------------------------------kgggkggggk------------------------------------------------------------------%%%%%%%%|||||||||||||||||||||||||||||||||||||||||||||||||------%%%%%----------------------
-------------------------------------------------------------------tt-----------g----g------%%%--------g------|||||||||||||||||||||||||||||||||||||||||||||||||||||||||------|||||----------------------
--------------------------------r-----------%%%%%%%%%%%%%%---------tt-----------------------|||---------------|||||||||||||||||||||||||||||||||||||||||||||||||||||||||----%%%%%%%%-g-------------------
------%%%%%--------------%%%%%%%%-----------||||||||||||||---%%%%%%%%%%%%%-----%%%%%%%%-----|||----%%%%%%%%%%%|||||||||||||||||||||||||||||||||||||||||||||||||||||||||----||||||||---------%%%%%%%%%F%%
%%%%%%|||||%%%%%%%%%%%%%%||||||||%%%%%%%%%%%||||||||||||||---|||||||||||||-----||||||||-----|||----||||||||||||||||||||||||||||||||||||||||||||||||||||||||||||||||||||----||||||||%%%%%%%%%|||||||||X||
