--------------------------------------------------------------------------------------------------------------------------------------------------------------------------------------------------------
--------------------------------------------------------------------------------------------------------------------------------------------------------------------------------------------------------
--------------------------------------------------------------------------------------------------------------------------------------------------------------------------------------------------------
--------------------------------------------------------------------------------------------------------------------------------------------------------------------------------------------------------
--------------------------------------------------------------------------------------------------------------------------------------------------------------------------------------------------------
--------------------------------------------------------------------------------------------------------------------------------------------------------------------------------------------------------
--------------------------------------------------------------------------------------------------------------------------------------------------------------------------------------------------------
-------------------------------------------------------------------------------------------------------------------------------SSCSSU2S2-%%%%%%%%%%%%---------------------------------------------------
-----------------------------------------------------------------------------------------------------------------------------------------||||||||||||-g-g-----------------------------------------------
------------------------------------------------------------------------------------------------------------------------C2UCSS-----------||||||||||||---------------------------------------------------
-----------------------------------------------------------------------------------------------%%%%%%%-----------------------------------||||||||||||----%%%%%%%%%%%%%---r-------------%%%%%------------
------------------------------------------------ggggggkkkkgkg----------------------------------|||||||-----------------------------------||||||||||||----|||||||||||||-----------------|||||------------
----------------------------------------------r--|||||||||||-----------------g-----------g-----|||||||-----------------------------------||||||||||||----|||||||||||||----%%%%%%%%%%%--|||||------------
--------------------------g---g--g-----%%%%%%%%--|||||||||||-%%%%%%%%%%%%----------------------|%%%%%|----%%%%%%%%%%%%%%%%%%%%-----------||||||||||||----|||||||||||||----|||||||||||--|||||------------
------%%%%%----------------------------||||||||--|||||||||||-||||||||||||---%%%%%%%%%%%%-----%%%%%%%%%%%%%||||||||||||||||||||-----------||||||||||||----|||||||||||||----|||||||||||%%%%%%%%%----------
XXXXXX|||||XXXXXXXXXXXXXX----XXXXXXXXXX||||||||XXXXXXXXXXXXXX||||||||||||---||||||||||||-----|||||||||||||||||||||||||||||||||XXXXXXXXXXX||||||||||||----|||||||||||||----||||||||||||||||||||XXXXXXXFXX
