--------------------------------------------------------------------------------------------------------------------------------------------------------------------------------------------------------
--------------------------------------------------------------------------------------------------------------------------------------------------------------------------------------------------------
--------------------------------------------------------------------------------------------------------------------------------------------------------------------------------------------------------
--------------------------------------------------------------------------------------------------------------------------------------------------------------------------------------------------------
--------------------------------------------------------------------------------------------------------------------------------------------------------------------------------------------------------
--------------------------------------------------------------------------------------------------------------------------------------------------------------------------------------------------------
---------------------------------------------------------------------------------------------------------------------------------CCSS2UC-----SSCSSCSC---------------------------------------------------
------------------------------------------------------------------------------------------------------------------------tt------------------------------------------------------------------------------
------------------------------------------------------------------------------------------------------------------------tt------------------------------------------------------------------------------
-----------------------------------------------------------------------------------------------kgkgggggkkrr-------------tt------------------------------------------------------------------------------
---------------------------------------------------------------------------------------------r--||||||||||---------%%%%%%%%%%%%%%%%%%%%%%%%%%%%%%%%%%%%----%%%%%%%%%%%%%%-------------------------------
--------------------------------------gg-----------------%%%%%%%----------------%%%%%%%%%%%%%%--||||||||||-%%%%%%%%||||||||||||||||||||||||||||||||||||----||||||||||||||------%%%%%%%------------------
--------------------------------------------------------%%%%||||----------------||||||||||||||--||||||||||-||||||||||||||||||||||||||||||||||||||||||||----||||||||||||||------|||||||------------------
-------------------------------------%%%%%%%%%%%%%------||||||||---%%%%%%%%%%%%%||||||||||||||%%%%%%%%%%%%%||||||||||||||||||||||||||||||||||||||||||||----||||||||||||||----%%%%%%%%%%%%%--------------
------%%%%%-------------------%%%----|||||||||||||------||||||||---||||||||||||||||||||||||||||||||||||||||||||||||||||||||||||||||||||||||||||||||||||----||||||||||||||----|||||||||||||%%%%%%%%%%%F%%
XXXXXX|||||XXXXXXXXXXXXXX-----|||----|||||||||||||-----XXXXXXXXXXXX||||||||||||||||||||||||||||||||||||||||||||||||||||||||||||||||||||||||||||||||||||----||||||||||||||----||||||||||||||||||||||||X||
