--------------------------------------------------------------------------------------------------------------------------------------------------------------------------------------------------------
--------------------------------------------------------------------------------------------------------------------------------------------------------------------------------------------------------
--------------------------------------------------------------------------------------------------------------------------------------------------------------------------------------------------------
--------------------------------------------------------------------------------------------------------------------------------------------------------------------------------------------------------
--------------------------------------------------------------------------------------------------------------------------------------------------------------------------------------------------------
--------------------------------------------------------------------------------------------------------------------------------------------------------------------------------------------------------
--------------------------------------------------------------------------------------------------------------------------------------------------------------------------------------------------------
--------------------------------------------------------------------------------------------------------------------------------------------------------------------------------------------------------
--------------------------------------------------------------------------------------------------------------------------------------------------------------------------------------------------------
--------------------------------------------------------------------------------------------------------------------------------------------------------------------------------------------------------
-------------------------------U--------------------------------------------------------------------------------------------------------------------------C2CCBBCU--------------------------------------
-----------------------------------gkgggkgggkkgg--------------------------------------------------------------------k------------C2CBB2---%%%%%%%%%%%%%%------------------------------------------------
------------------------------------------------------------------------------------------------------------------------------------------||||||||||||||------------%%%%%%%%%%%-------------------------
------------------------------------------------%%%%%%%%%%%-----------------g-------------------------k--------k--------%%%%%-------------||||||||||||||------------|||||||||||-------------------------
------%%%%%--------------%%%%%%%%%%-------------|||||||||||-------------------------------------------------------------|||||-------------||||||||||||||%%%%%%%%%%%%|||||||||||-------------------------
%%%%%%|||||%%%%%%%%%%%%%%||||||||||%%%%%%%%%%%%%|||||||||||-----%%%%%%%%%%%---%%%%%%%%%%%-----%%%----%%%%%%%%%%%%%%---%%%%%%%%%%%%%%%%%%%%|||||||||||||||||||||||||||||||||||||---%%%%%%%%%%%%%%%%%%%F%%
