--------------------------------------------------------------------------------------------------------------------------------------------------------------------------------------------------------
--------------------------------------------------------------------------------------------------------------------------------------------------------------------------------------------------------
--------------------------------------------------------------------------------------------------------------------------------------------------------------------------------------------------------
--------------------------------------------------------------------------------------------------------------------------------------------------------------------------------------------------------
--------------------------------------------------------------------------------------------------------------------------------------------------------------------------------------------------------
--------------------------------------------------------------------------------------------------------------------------------------------------------------------------------------------------------
-----------------------------------------------------------------------------------------------------------------------SC2CSSSC2S-----------------------------------------------------------------------
--------------------------------------------------------------------------------------------------------------------------------------------------------------------------------------------------------
---------------------------------------------------------------------------------------------------------%%%%%%%%---------------------------------------------------------------------------------------
-----------------------------------------------U----------------------------g---------------------------%%%%|||||--------------------------------------------------------------------CS2SSCSS-----------
-----------------------------------------------------------------------------------------------%%%%%%--%%%%%%%%%%%%%%%%%%%%%%%%%%%%-------------g-----g--k----------------------------------------------
--------------------------------%%%%%--------------kgggggggggkgg-------------------------------||||||--||||||||||||||||||||||||||||-g-------------------------------------%%%%%%%%-r-----------k--------
--------------------------------|||||----------------|||||||||-------------------------------%%%%%%%%%%||||||||||||||||||||||||||||---------------------------------------||||||||--------------%%%%%F%%
-------------------------g------|||||----%%%%%%%%%%--|||||||||--%%%%%%%%%%-------%%%%%%%%----||||||||||||||||||||||||||||||||||||||---------------------------k-------k---||||||||%%%%%%%%%%%%%%|||||%||
------%%%%%---------------------|XXX|----||||||||||--|||||||||--||||||||||-------||||||||----||||||||||||||||||||||||||||||||||||||----%%%%%%%%---------------------------||||||||||||||||||||||||||||||
XXXXXX|||||XXXXXXXXXXXXXX-----XXXXXXXX---||||||||||XXXXXXXXXXXXX||||||||||-----XXXXXXXXXXXXXX||||||||||||||||||||||||||||||||||||||----||||||||---XXXXXXXXXXXXXXXXXXXXXXXX||||||||||||||||||||||||||||||
