--------------------------------------------------------------------------------------------------------------------------------------------------------------------------------------------------------
--------------------------------------------------------------------------------------------------------------------------------------------------------------------------------------------------------
--------------------------------------------------------------------------------------------------------------------------------------------------------------------------------------------------------
--------------------------------------------------------------------------------------------------------------------------------------------------------------------------------------------------------
--------------------------------------------------------------------------------------------------------------------------------------------------------------------------------------------------------
--------------------------------------------------------------------------------------------------------------------------------------------------------------------------------------------------------
--------------------------------------------------------------------------------------------------------------------------------------------------------------------------------------------------------
--------------------------------------------------------------------------------------------------------------------------------------------------------------------------------------------------------
--------------------------------------------------------------------------------------------------------------------------------------------------------------------------------------------------------
------------------------------------------------------------------------------BCC-----------------------------------------------------------------------------------------------------------------------
--------------------------------------------------------------------------------------------------------------------------------------------------------------------------------------------------------
----------------------------------g--------------------------------------------------------------------------------rkk-------CBCB22B2------BCB22B2---------------------------------CCU2CC2--------------
---------------------------------------g----------------------------------------------------------------------------------------------------------------------------------------------------------------
--------------------------g-----%%%%%----------------------gg---------------%%%%%%%----g-------------k-----k------%%%%%%%%--------------------------------------k----------------k----------------------
------%%%%%---------------------|||||---------------------------------------|||||||-------------------------------||||||||------------------------------------------------------------------------------
%%%%%%|||||%%%%%%%%%%%%%%-----%%%%%%%%---%%%%%%%%%%%%%---%%%%%%%%%%%%%%---%%%%%%%%%%%%---%%%%%%%%%%%-----%%%%%%%%%||||||||%%%%%%%%%%%%%%%%%%%%%%%%%%%%%%%%%%%%%%-----%%%%%%%%%%%%%%%%%%%%%%%%%%%%%%%%F%%
