--------------------------------------------------------------------------------------------------------------------------------------------------------------------------------------------------------
--------------------------------------------------------------------------------------------------------------------------------------------------------------------------------------------------------
--------------------------------------------------------------------------------------------------------------------------------------------------------------------------------------------------------
--------------------------------------------------------------------------------------------------------------------------------------------------------------------------------------------------------
--------------------------------------------------------------------------------------------------------------------------------------------------------------------------------------------------------
--------------------------------------------------------------------------------------------------------------------------------------------------------------------------------------------------------
-------------------------------------------------------------------------------------------------------------------------------------------------------------------------------%%%%%%%------------------
-------------------------------------------------------------------------------------------------------------------------------------------------------------------------------|%%%%%|------------------
-----------------------------------------B22B------------------%%%%%%%%-----ggg-------U-----------------------------------------------------------------------------g-g-k------|||||||------------------
----------------------------------------gkkgkggg---------------||||||||-----------------------CB----------------------------------------------------UCBB2B-%%%%%%%%------------|||||||------------------
--------------------------------------r-----------------------%%%%%%|||------------------------------------------------------------------------------------||||||||%%%%%%%%%%%%%%%%%%%%%%%%%%%%%%%%%%F%%
-------------------------%%%%%%%%%%%%%%---------%%%%%%%%------|||||||||-------------------gkggggkg-------------------------------CBB----------BCUBB--------||||||||||||||||||||||||||||||||||||||||||X||
-------------------------||||||||||||||---------||||||||-----%%%%%%%%%%%%%%----%%%%%%%%%%%-----------------------------------------------------------------||||||||||||||||||||||||||||||||||||||||||X||
-------------------------||||||||||||||%%%%%%%%%||||||||-----||||||||||||||----|||||||||||--------%%%%%%%%%%-----------------------------------------------||||||||||||||||||||||||||||||||||||||||||X||
------%%%%%--------------|||||||||||||||||||||||||||||||-----||||||||||||||----|||||||||||--------||||||||||-----------------------------------------------||||||||||||||||||||||||||||||||||||||||||X||
%%%%%%|||||%%%%%%%%%%%%%%|||||||||||||||||||||||||||||||-----||||||||||||||----|||||||||||%%%%%%%%||||||||||-----%%%%%%%%%%%%%%%%%%%%%%%%%%%%%%%%%%%%%%%%%%||||||||||||||||||||||||||||||||||||||||||X||
