--------------------------------------------------------------------------------------------------------------------------------------------------------------------------------------------------------
--------------------------------------------------------------------------------------------------------------------------------------------------------------------------------------------------------
--------------------------------------------------------------------------------------------------------------------------------------------------------------------------------------------------------
--------------------------------------------------------------------------------------------------------------------------------------------------------------------------------------------------------
--------------------------------------------------------------------------------------------------------------------------------------------------------------------------------------------------------
--------------------------------------------------------------------------------------------------------------------------------------------------------------------------------------------------------
--------------------------------------------------------------------------------------------------------------------------------------------------------------------------------------------------------
--------------------------------------------------------------------------------------------------------------------------------------------------------------------------------------------------------
--------------------------------------------------------------------------------------------------------------------------------------------------------------------------------------------------------
--------------------------------------------------------------------------------------------------------------------------------------------------------------------------------------------------------
------------------------------------------------------------------------g----------g---------------U----------------------------------------------------------------------------------------------------
------------------------------%%%%%%-----------------gggkggggkg----------------------------------------gggggggk----------------------------------------------------------------------U2SSCSS---%%%%%%F%%
--------------------------g---||||||---------------------------------------------------------------------%%%%-------------%%%%%%%%%%%%---------------------------------------------------------||||||%||
-----------------------------%%%||||---------------r-----------%%%%%%%%-----%%%%%%%%%--------------------||||--%%%%%%%%%%%||||||||||||-g-----g--kk---------------k-----%%%%%%%%----------------|||||||||
------%%%%%------------------|||||||--%%%%%%%%%%%%%%-----------||||||||-----|||||||||-----%%%%%%%%%%%%%--||||--|||||||||||||||||||||||---------------------------------||||||||----------------|||||||||
XXXXXX|||||XXXXXXXXXXXXXX---XXXXXXXXXX||||||||||||||XXXXXXXXXXX||||||||-----|||||||||-----|||||||||||||XXXXXXXX|||||||||||||||||||||||XXXXXXXXXXX----XXXXXXXXXXX-----XXXXXXXXXXXXXXXXXXXXXXXXXX|||||||||
