--------------------------------------------------------------------------------------------------------------------------------------------------------------------------------------------------------
--------------------------------------------------------------------------------------------------------------------------------------------------------------------------------------------------------
--------------------------------------------------------------------------------------------------------------------------------------------------------------------------------------------------------
--------------------------------------------------------------------------------------------------------------------------------------------------------------------------------------------------------
--------------------------------------------------------------------------------------------------------------------------------------------------------------------------------------------------------
------------------------------------------------------------------------------------------------CCSU2--%%%%%%%%%%%%-------------------------------------------------------------------------------------
-------------------------------------------------------------------------------------------------------||||||||||||-------------------------------------------------------------------------------------
------------------------------------------------------------------------------------------SCCSU--------||||||||||||-------------------------------------------------------------------------------------
-------------------------------------------------------------------------------------------------------||||||||||||-k-r--r--------------------------%%%%%%%---------------------------------------------
-------------------------------------------------------------------------------------------------------||||||||||||--------------------------------%%%%||||---------------------------------------------
-------------------------------------------------------------------------------------------------------||||||||||||%%%%%%%%%%%%%%-----------------%%%%%%%%%%%%------------------------------------------
-----------------------------------------------------------------------CC22CSSS2--%%%%%%%%%%%%%%%%%%%%%||||||||||||||||||||||||||-----%%%%%%%%%%%%||||||||||||------------------------------------------
-------------------------------------g--------------------------------------------|||||||||||||||||||||||||||||||||||||||||||||||-----||||||||||||||||||||||||-r-----k--------------%%%%%%--------------
--------------------------g-------------------------------r---%%%%%---------------|||||||||||||||||||||||||||||||||||||||||||||||-----||||||||||||||||||||||||---%%%%%%%%%%%%%%k----||||||--------------
------%%%%%---------------------------------------------------|||||---------------|||||||||||||||||||||||||||||||||||||||||||||||-----||||||||||||||||||||||||---||||||||||||||---%%%%%%%%%%%-----------
XXXXXX|||||XXXXXXXXXXXXXX---XXXXXXXXX----XXXXXXXXXXXXXX-----XXXXXXXXXXXXXXXXXXXXXX|||||||||||||||||||||||||||||||||||||||||||||||-----||||||||||||||||||||||||---||||||||||||||---|||||||||||XXXXXXXXFXX
