--------------------------------------------------------------------------------------------------------------------------------------------------------------------------------------------------------
--------------------------------------------------------------------------------------------------------------------------------------------------------------------------------------------------------
--------------------------------------------------------------------------------------------------------------------------------------------------------------------------------------------------------
--------------------------------------------------------------------------------------------------------------------------------------------------------------------------------------------------------
--------------------------------------------------------------------------------------------------------------------------------------------------------------------------------------------------------
--------------------------------------------------------------------------------------------------------------------------------------------------------------------------------------------------------
--------------------------------------------------------------------------------------------------------------------------------------------------------------------------------------------------------
--------------------------------------------------------------------------------------------------------------------------------------------------------------------------------------------------------
--------------------------------------------------------------------------------------------------------------g--------g-------------------------------------B2U2---------------------------------------
--------------------------------------------------------------------------------------------------------------------------------------------------------------------------------------------------------
--------------------------------U--------------------------g---gg-----------------------------------------------------------------------------------------------------------------------------%%%%%%%F%%
------------------------------------gkgggkgg---------------------------------------------ggggkggggk---------------------------------------------%%%%%%%%%%--------------------------%%%%%%%%%%|||||||X||
--------------------------------------%%%%---------------------------------------------r--XXXXXXXX----------------------------------------------||||||||||%%%%%%%%%%----------------|||||||||||||||||X||
--------------------------------------||||--%%%%%%%%%%%%%%----------------%%%%%%%%%%%%%%--XXXXXXXX-%%%%%%%%%%------------g-----g-------k-----k--||||||||||||||||||||----------------|||||||||||||||||X||
------%%%%%--------------%%%%%%%%%%%--||||--||||||||||||||----------------||||||||||||||--XXXXXXXX-||||||||||-----------------------------------||||||||||||||||||||----------------|||||||||||||||||X||
%%%%%%|||||%%%%%%%%%%%%%%|||||||||||%%%%%%%%||||||||||||||----%%%%%%%%%%%%||||||||||||||%%%%%%%%%%%||||||||||---%%%%%%%%%%%%%%%%%-----%%%%%%%%%%||||||||||||||||||||-----%%%%%%%%%%%|||||||||||||||||X||
