--------------------------------------------------------------------------------------------------------------------------------------------------------------------------------------------------------
--------------------------------------------------------------------------------------------------------------------------------------------------------------------------------------------------------
--------------------------------------------------------------------------------------------------------------------------------------------------------------------------------------------------------
--------------------------------------------------------------------------------------------------------------------------------------------------------------------------------------------------------
--------------------------------------------------------------------------------------------------------------------------------------------------------------------------------------------------------
--------------------------------------------------------------------------------------------------------------------------------------------------------------------------------------------------------
--------------------------------------------------------------------------------------------------------------------------------------------------------------------------------------------------------
--------------------------------------------------------------------------------------------------------------------------------------------------------------------------------------------------------
----------------------------------------------------------------------------------------------------------------------------g---------------------g-----------------------------------------------------
-------------------------------------------------------------------------------------------------gggggkkkggkg------------------------------%%%%%--------------------------------------------------------
-----------------------------------------------------------------------------------------------r--XXXXXXXXXX---------------%%%%%%%%%%%%%%--|||||--------------------------------------------------------
------------------------------------------------------------%%%%%%%%-----------------%%%%%%%%%%%--XXXXXXXXXX-%%%%%%%%%%%%%%||||||||||||||%%%%%%%%-------------------------------------------------------
------------------------------------------------------------||||||||-----------------|||||||||||--XXXXXXXXXX-||||||||||||||||||||||||||||||||||||-------------------------------------------------------
--------------------------g-----------------------gg-g------||||||||----%%%%%%%%%%%%%|||||||||||%%%%%%%%%%%%%||||||||||||||||||||||||||||||||||||------------g---------g--g------r-------k--------------
------%%%%%-------------------------------------------------||||||||----|||||||||||||||||||||||||||||||||||||||||||||||||||||||||||||||||||||||||------------------------------------------%%%%%%%%%%F%%
%%%%%%|||||%%%%%%%%%%%%%%-----%%%%%%%%%%%%%%-----%%%%%%%%%%%||||||||----|||||||||||||||||||||||||||||||||||||||||||||||||||||||||||||||||||||||||---%%%%%%%%-----%%%%%%%%%%%%---%%%%%%%%%%%||||||||||X||
