--------------------------------------------------------------------------------------------------------------------------------------------------------------------------------------------------------
--------------------------------------------------------------------------------------------------------------------------------------------------------------------------------------------------------
--------------------------------------------------------------------------------------------------------------------------------------------------------------------------------------------------------
--------------------------------------------------------------------------------------------------------------------------------------------------------------------------------------------------------
--------------------------------------------------------------------------------------------------------------------------------------------------------------------------------------------------------
--------------------------------------------------------------------------------------------------------------------------------------------------------------------------------------------------------
-----------------------------------------------------------------%%%%%----------------------------------------------------------------------------------------------------------------------------------
-----------------------------------------------------------------|||||----------------------------------------------------------------------------------------------------------------------------------
-----------------------------------------------------------g-g---|||||----------------------------------------------------------------------------------------------------------------------------------
-------------------------------------BUBC2B2--%%%%%%%%%%%%-------|||||----------------------------------------------------------------------------------------------------------------------------------
----------------------------------------------||||||||||||-----%%%%%%%%%--------------------------------------------------------------------------------------------------%%%%%%--%%%%%%%%%%%%----------
-------------------------------B2UC-----------||||||||||||-----|||||||||-------U---gggkgrkk---------%%%%%%%%%%--------------------------------------%%%%%%%---------------||||||--||||||||||||%%%%%%%F%%
----------------------------------------------||||||||||||-----|||||||||----------------------------||||||||||-----%%%%%%%%%%--------------r--------|||||||-------------%%%%%%%%%%|||||||||||||||||||X||
----------------------------------------------||||||||||||-----|||||||||-------------%%%%--%%%%%%%%%||||||||||----r||||||||||-------%%%%%---------%%%%%%%%%%%%%--%%%%%--|||||||||||||||||||||||||||||X||
------%%%%%-----------------------------------||||||||||||-----|||||||||-------------||||--|||||||||||||||||||-----||||||||||-------|||||-%%%%%%%%|||||||||||||--|||||--|||||||||||||||||||||||||||||X||
%%%%%%|||||%%%%%%%%%%%%%%%%%%%%%%%%%%%%%%%%%%%||||||||||||-----|||||||||---%%%%%%%%%%%%%%%%|||||||||||||||||||-----||||||||||-----%%%%%%%%|||||||||||||||||||||%%%%%%%%%|||||||||||||||||||||||||||||X||
