--------------------------------------------------------------------------------------------------------------------------------------------------------------------------------------------------------
--------------------------------------------------------------------------------------------------------------------------------------------------------------------------------------------------------
--------------------------------------------------------------------------------------------------------------------------------------------------------------------------------------------------------
--------------------------------------------------------------------------------------------------------------------------------------------------------------------------------------------------------
--------------------------------------------------------------------------------------------------------------------------------------------------------------------------------------------------------
--------------------------------------------------------------------------------------------------------------------------------------------------------------------------------------------------------
--------------------------------------------------------------------------------------------------------------------------------------------------------------------------------------------------------
--------------------------------------------------------------------------------------------------------------------------------------------------------------------------------------------------------
---------------------------------------------------------------------------------------------------------------------------------UCC2CBCBC------------------------------------r---k---------------------
------------------------------------------------------------------------------------------------------------------%%%%%%%%-----------------------------BUBBBC2BB--%%%%%%%%%%%---------------------------
--------------------------------------------------------------------------------------------------g---g-----------||||||||----------------------------------------|||||||||||%%%%%%%%%%%%%%%%%%%%%%%%F%%
------------------------------------------------------------------------ggggkgkggkgkg-----------------------------||||||||-----------------------2BBCU------------|||||||||||||||||||||||||||||||||||X||
-------------------------------------------------------------------------%%%%%%%%%%%-------------------%%%%%%---%%%%%%%%%%%%%%%%%%%%%%%%%%%%----------------------|||||||||||||||||||||||||||||||||||X||
---------------------------------------------gg-----------------------r--|||||||||||-%%%%%%%%%%%%------||||||---||||||||||||||||||||||||||||----------------------|||||||||||||||||||||||||||||||||||X||
------%%%%%---------------------------------------------------%%%%%%%%%--|||||||||||-||||||||||||------||||||---||||||||||||||||||||||||||||----------------------|||||||||||||||||||||||||||||||||||X||
%%%%%%|||||%%%%%%%%%%%%%%-----%%%%%%%%%%%%%%----%%%%%%%%%%%%%%|||||||||%%%%%%%%%%%%%%||||||||||||----%%%%%%%%%%%||||||||||||||||||||||||||||%%%%%%%%%%%%%%%%%%%%%%|||||||||||||||||||||||||||||||||||X||
