--------------------------------------------------------------------------------------------------------------------------------------------------------------------------------------------------------
--------------------------------------------------------------------------------------------------------------------------------------------------------------------------------------------------------
--------------------------------------------------------------------------------------------------------------------------------------------------------------------------------------------------------
--------------------------------------------------------------------------------------------------------------------------------------------------------------------------------------------------------
--------------------------------------------------------------------------------------------------------------------------------------------------------------------------------------------------------
--------------------------------------------------------------------------------------------------------------------------------------------------------------------------------------------------------
--------------------------------------------------------------------------------------------------------------------------------------------------------------------------------------------------------
--------------------------------------------------------------------------------------------------------------------------------------------------------------------------------------------------------
-------------------------------------------------------------------------------------------------------------------------g------------------------------------------------------------------------------
---------------------------------------------------------------------------------------------------------------------------------------------------------BB---------------------------------------------
----------------------------------U---------------------------------------------------------------BBCC2CB----------------------------------------------gkgkggr--------%%%%%%%%%%%%%%--------------------
--------------------------------------gggggggggg------------------------------------------------ggggggkgggk------------------------------------------r----------------||||||||||||||--------------------
----------------------------------------------------------------------------------------------r-----------------------------------------%%%%%%%%%%%%%%--------%%%%%%%%||||||||||||||-----%%%%%%%%%%%%F%%
------------------------------------------------%%%%%%%%%%----gg---------gg-----------%%%%%%%%%------------%%%%%%%%%%%%%%---------------||||||||||||||--------||||||||||||||||||||||-----||||||||||||X||
------%%%%%--------------%%%%%%%%%%%%%----------||||||||||----------------------------|||||||||------------||||||||||||||---------------||||||||||||||%%%%%%%%||||||||||||||||||||||-----||||||||||||X||
%%%%%%|||||%%%%%%%%%%%%%%|||||||||||||%%%%%%%%%%||||||||||---%%%%%%%%---%%%%%%%%%%%%%%|||||||||%%%%%%%%%%%%||||||||||||||---%%%%%%%%%%%%||||||||||||||||||||||||||||||||||||||||||||-----||||||||||||X||
