--------------------------------------------------------------------------------------------------------------------------------------------------------------------------------------------------------
--------------------------------------------------------------------------------------------------------------------------------------------------------------------------------------------------------
--------------------------------------------------------------------------------------------------------------------------------------------------------------------------------------------------------
--------------------------------------------------------------------------------------------------------------------------------------------------------------------------------------------------------
--------------------------------------------------------------------------------------------------------------------------------------------------------------------------------------------------------
---------------------------------------------------------------------------------------------------------------------------------------------------------------------------------------S2C--------------
----------------------------------------------------------------------------SSS-------------------------------------------------------------------------------------------------------------------------
--------------------------------------------------------------------------------------------------------------------------------------------------------------------------------------------------------
--------------------------------------------------------------------------------------------------------------------------------------------------------------------------------------------------------
-----------------------------------------------------------------------------------------------------------------------------------------------------------------------gg---g--------%%%%%%%------------
-------------------------------------ggggkgkgg-----------------------------%%%%%------------------------U----------------------------------------------------------------------------|||||||------------
-----------------------------------r--|||||||------------------------------|||||----------------------------ggggggkgkgkgg---------------------------------------------%%%%%%%%---r-%%%%%%%%%%%%---------
-------------------------%%%%%%%%%%%--|||||||-%%%%%%%%%%%%---%%%%%%%%------|||||------------------------------%%%%%%%%%-----------------------------------------------||||||||-----||||||||||||---------
-------------------------|||||||||||--|||||||-||||||||||||---||||||||------|||||----g-------------------------|||||||||--%%%%%%%%%%%---%%%%%%%%%-g--------------------||||||||-----||||||||||||---------
------%%%%%--------------|||||||||||%%%%%%%%%%||||||||||||---||||||||----%%%%%%%%---------------%%%%%%%%%%%%--|||||||||--|||||||||||---|||||||||----------------------||||||||-----||||||||||||---------
XXXXXX|||||XXXXXXXXXXXXXX|||||||||||||||||||||||||||||||||---||||||||----||||||||---XXXXXXXXXXXX||||||||||||XXXXXXXXXXXXX|||||||||||---|||||||||XXXXXXXXXXXXXXXXXXXXXX||||||||-----||||||||||||XXXXXXFXX
