--------------------------------------------------------------------------------------------------------------------------------------------------------------------------------------------------------
--------------------------------------------------------------------------------------------------------------------------------------------------------------------------------------------------------
--------------------------------------------------------------------------------------------------------------------------------------------------------------------------------------------------------
--------------------------------------------------------------------------------------------------------------------------------------------------------------------------------------------------------
--------------------------------------------------------------------------------------------------------------------------------------------------------------------------------------------------------
--------------------------------------------------------------------------------------------------------------------------------------------------------------------------------------------------------
----------------------------------------------------------------------------------------------------------------------------SCSSSSS---------------------------------------------------------------------
--------------------------------------------------------------------------------------------------------------------------------------------------------------------------------------------------------
--------------------------------------------------------------------------------------------------------------------------------------------------------------------------------------------------------
----------------------------------U-----------------------------------------g--------------------------SCSSSUC--%%%%%%%%%----------------------------r--------------------------------------------------
------------------------------------------SSSC------------------------------------------------------------------|||||||||%%%%%%%%%%%%%------------------------------------------------------------------
--------------------------------------ggggkkkggkk-----------------------------------------------CUSCSSS---------||||||||||||||||||||||-----%%%%%%%%%%%%%%-----%%%%%%--------------------SCSC22CCS-------
-----------------------------------------------------------------%%%%%%%----------------------------------------||||||||||||||||||||||-----||||||||||||||----%%%%|||------------------------------------
----------------------------%%%%%%%%%%-----------%%%%%%%%%%%-----|||||||--------g-------------------------------||||||||||||||||||||||-----||||||||||||||----|||||||----r--------------------------%%F%%
------%%%%%-----------------||||||||||-----------|||||||||||-----|||||||----------------------------------------||||||||||||||||||||||-----||||||||||||||----|||||||-------------------------------||%||
XXXXXX|||||XXXXXXXXXXXXXX---||||||||||XXXXXXXXXXX|||||||||||---XXXXXXXXXXXX-----XXXXXXXXXXXXXXXXXXXXXXXXXXXXXXXX||||||||||||||||||||||-----||||||||||||||---XXXXXXXXXX----XXXXXXXXXXXXXXXXXXXXXXXXX|||||
