--------------------------------------------------------------------------------------------------------------------------------------------------------------------------------------------------------
--------------------------------------------------------------------------------------------------------------------------------------------------------------------------------------------------------
--------------------------------------------------------------------------------------------------------------------------------------------------------------------------------------------------------
--------------------------------------------------------------------------------------------------------------------------------------------------------------------------------------------------------
--------------------------------------------------------------------------------------------------------------------------------------------------------------------------------------------------------
--------------------------------------------------------------------------------------------------------------------------------------------------------------------------------------------------------
--------------------------------------------------------------------------------------------------------------------------------------------------------------------------------------------------------
--------------------------------------------------------------------------------------------------------------------------------------------------------------------------------------------------------
--------------------------------------------------------------------------------U------------------------g-------------------------------------------------------------------k--------------------------
----------------------------------------------------------------------------------------2C----------------------------------------------------------------kgggggkg--------------------------------------
--------------------------------------------------------------------------------------------------------------------------------------------------------r--XXXXXX---------------------------------------
-----------------------------------------------------------CCBC---------------------gkggkgkgg---------------------------BCB------------------%%%%%%%%%%%%--XXXXXX-%%%%%%%%------------------------------
-----------------------------------------------------------------------%%%%%%%%%%%%%---------------------------------------------------------||||||||||||--XXXXXX-||||||||----%%%%%%%%%%%%%%------------
--------------------------gg-g------g------------------------------g---|||||||||||||---------%%%%%%%%----------------------------------------||||||||||||%%%%%%%%%||||||||----||||||||||||||------------
------%%%%%------------------------------------------------------------|||||||||||||---------||||||||-----%%%%%%%%%%%------------------------|||||||||||||||||||||||||||||----||||||||||||||------------
%%%%%%|||||%%%%%%%%%%%%%%---%%%%%%%%%%%%%---%%%%%%%%%%%%%%%%%%%%%%-----|||||||||||||%%%%%%%%%||||||||-----|||||||||||%%%%%%%%----%%%%%%%%%%%%|||||||||||||||||||||||||||||----||||||||||||||%%%%%%%%%F%%
