--------------------------------------------------------------------------------------------------------------------------------------------------------------------------------------------------------
--------------------------------------------------------------------------------------------------------------------------------------------------------------------------------------------------------
--------------------------------------------------------------------------------------------------------------------------------------------------------------------------------------------------------
--------------------------------------------------------------------------------------------------------------------------------------------------------------------------------------------------------
--------------------------------------------------------------------------------------------------------------------------------------------------------------------------------------------------------
--------------------------------------------------------------------------------------------------------------------------------------------------------------------------------------------------------
--------------------------------------------------------------------------------------------------------------------------------------------------------------------------------------------------------
--------------------------------------------------------------------------------------------------------------------------------------------------------------------------------------------------------
----------------------------------------------------------------------------------------------------g---------------------------------------------------------------------------------------------------
----------------------------------------------------------g-----g---------------------------------------------------------------------------------------------------------------------------------------
--------------------------------------CBBC----------------------------U---------------------------------------------------------------------------------------------------------------------------------
-------------------------------------gkgkkkgg-----------------------------gggggkggggkg--------------------------------------ggggggggggggg-------------%%%%%%%%--------------------BBB-------------------
-----------------------------------r----------------------------------------%%%%%%%%---------------------%%%%%------------g--XXXXXXXXXXX--------------||||||||---g--------------------------------------
-------------------------%%%%%%%%%%%---------%%%%%%%%%%%%-------------------||||||||--%%%%%%%%%%%%%%-----|||||-%%%%%%%%%%%%--XXXXXXXXXXX-%%%%%%%%%%%%%||||||||------------------------------------------
------%%%%%--------------|||||||||||---------||||||||||||---%%%%%%%%%%%%%%--||||||||--||||||||||||||-----|||||-||||||||||||--XXXXXXXXXXX-|||||||||||||||||||||-----%%%%%%%%%%%%-------------------------
%%%%%%|||||%%%%%%%%%%%%%%|||||||||||%%%%%%%%%||||||||||||---||||||||||||||%%%%%%%%%%%%||||||||||||||---%%%%%%%%||||||||||||%%%%%%%%%%%%%%|||||||||||||||||||||-----||||||||||||%%%%%%%%%%%%%%%%%%%%%%F%%
