--------------------------------------------------------------------------------------------------------------------------------------------------------------------------------------------------------
--------------------------------------------------------------------------------------------------------------------------------------------------------------------------------------------------------
--------------------------------------------------------------------------------------------------------------------------------------------------------------------------------------------------------
--------------------------------------------------------------------------------------------------------------------------------------------------------------------------------------------------------
--------------------------------------------------------------------------------------------------------------------------------------------------------------------------------------------------------
--------------------------------------------------------------------------------------------------------------------------------------------------------------------------------------------------------
--------------------------------------------------------------------------------------------------------------------------------------------------------------------------------------------------------
-----------------------------------------------------------------------------------------------------------------------------------------------------------------------------------%%%%%----------------
-----------------------------------------------------------------------------------------------------------------------------------------------------------------------------------|||||----------------
----------------------------------------------------------kggkgkg-------------------BBBC----g---g--g---------------------------------------BBB-------------------------------------|||||----------------
--------------------------------------------------------r--XXXXX--------------------------------------------------------------------------gggggrr--------------%%%%%%%%%%%%%%----%%%%%%%%%--------------
-------------------------------------------%%%%%%%%%%%%%%--XXXXX-%%%%%%%%%%%%--------------------------------g-g---g--------------------r----------------------||||||||||||||----|||||||||--------------
-------------------------------------------||||||||||||||--XXXXX-||||||||||||-----------------------------------------------%%%%%%%%%%%%%--------%%%%%%%%%%%%%%||||||||||||||----|||||||||--------------
-------------------------------------------||||||||||||||%%%%%%%%||||||||||||------%%%%%%--------%%%%%%%--------------------|||||||||||||--------||||||||||||||||||||||||||||----|||||||||--------------
------%%%%%--------------------------------||||||||||||||||||||||||||||||||||------||||||--------|||||||--------------------|||||||||||||%%%%%%%%||||||||||||||||||||||||||||----|||||||||%%%%%%%%%%%F%%
%%%%%%|||||%%%%%%%%%%%%%%-----%%%%%%%%%%%%%||||||||||||||||||||||||||||||||||----%%%%%%%%%%----%%%%%%%%%%%%%---%%%%%%%%%%%%%|||||||||||||||||||||||||||||||||||||||||||||||||----||||||||||||||||||||X||
