--------------------------------------------------------------------------------------------------------------------------------------------------------------------------------------------------------
--------------------------------------------------------------------------------------------------------------------------------------------------------------------------------------------------------
--------------------------------------------------------------------------------------------------------------------------------------------------------------------------------------------------------
--------------------------------------------------------------------------------------------------------------------------------------------------------------------------------------------------------
--------------------------------------------------------------------------------------------------------------------------------------------------------------------------------------------------------
--------------------------------------------------------------------------------------------------------------------------------------------------------------------------------------------------------
--------------------------------------------------------------------------------------------------------------------------------------------------------------------------------------------------------
--------------------------------------------------------------------------------------------------------------------------------------------------------------------------------------------------------
------------------------------------------------------------------------------rr------k--------------------------------------------------------------------------------2BBBUB----k----------------------
---------------------------------------------------------------------------------r-------------CCCCCUBB------------------------------------------------------%%%%%--------------------------------------
----------------------------------------------------------------%%%%%%%%%%%%%--------------------------------------------------------------------------------|||||--------------%%%%%%%%%%%%%%%%%%%%%F%%
--------------------------------%%%%%---------------------------|||||||||||||----%%%%%%%%%%%%-----------------------------------------------22CB----k-----k--|||||--------------|||||||||||||||||||||X||
--------------------------------|||||--------------------tt-----|||||||||||||----||||||||||||--------------------------------%%%%%%%%----------------------%%%%%%%%%%%%%%%%%%%%%|||||||||||||||||||||X||
-------------------------gg-----|||||--------------------tt-----|||||||||||||----||||||||||||%%%%%%%%%%%%%-------------------|%%%%%%%%%------------%%%%%%%%||||||||||||||||||||||||||||||||||||||||||X||
------%%%%%---------------------|||||--------------%%%%%%%%%%%%%|||||||||||||----|||||||||||||||||||||||||-------------------||||||||||------------||||||||||||||||||||||||||||||||||||||||||||||||||X||
%%%%%%|||||%%%%%%%%%%%%%%-----%%%%%%%%%-----%%%----||||||||||||||||||||||||||----|||||||||||||||||||||||||----%%%%%%%%%%---%%%%%%%%%%%%%%%%%%%%%%%%||||||||||||||||||||||||||||||||||||||||||||||||||X||
