--------------------------------------------------------------------------------------------------------------------------------------------------------------------------------------------------------
--------------------------------------------------------------------------------------------------------------------------------------------------------------------------------------------------------
--------------------------------------------------------------------------------------------------------------------------------------------------------------------------------------------------------
--------------------------------------------------------------------------------------------------------------------------------------------------------------------------------------------------------
--------------------------------------------------------------------------------------------------------------------------------------------------------------------------------------------------------
--------------------------------------------------------------------------------------------------------------------------------------------------------------------------------------------------------
--------------------------------------------------------------------------------------------------------------------------------------------------------------------------------------------------------
--------------------------------------------------------------------------------------------------------------------------------------------------------------------------------------------------------
----------------------------------------------------------------------gg----g---------------------------------------------------------------------------------------------------------------------------
----------------------------------------------------------------------------------------------------------------------------------r------r-------------------------------SSCCSSS------------------------
-----------------------------------------------gggggggggkggk-------------------U------------------------------------------------------------------------------------------------------------------------
---------------------------------------------r--|||||||||||------------------------ggkgggggg---------------------------------------------------------SSCSCSS-----r--------------------CSSCCSS-----------
-------------------------------------%%%%%%%%%--|||||||||||-%%%%%%%%%----------------%%%%%--------------------------------%%%%%---------%%%%%%%---------------------------------------------------------
-------------------------------------|||||||||--|||||||||||-|||||||||----------------|||||--%%%%%%%%%%%%%-----------------|||||---------|||||||---------------%%%%%%%%%%%%%%%%%%%%%---------------------
------%%%%%--------------------------|||||||||%%%%%%%%%%%%%%|||||||||-----%%%%%%%%%--|||||--|||||||||||||-----------------|||||---------|||||||---------------|||||||||||||||||||||---------------------
XXXXXX|||||XXXXXXXXXXXXXX---XXXXXXXXX||||||||||||||||||||||||||||||||-----|||||||||XXXXXXXXX|||||||||||||-----XXXXXXXXXXXXXXXXXXX-----XXXXXXXXXXXXXXXXXXXXXXXX|||||||||||||||||||||XXXXXXXXXXXXXXXXXXFXX
