--------------------------------------------------------------------------------------------------------------------------------------------------------------------------------------------------------
--------------------------------------------------------------------------------------------------------------------------------------------------------------------------------------------------------
--------------------------------------------------------------------------------------------------------------------------------------------------------------------------------------------------------
--------------------------------------------------------------------------------------------------------------------------------------------------------------------------------------------------------
--------------------------------------------------------------------------------------------------------------------------------------------------------------------------------------------------------
--------------------------------------------------------------------------------------------------------------------------------------------------------------------------------------------------------
--------------------------------------------------------------------------------------------------------------------------------------------------------------------------------------------------------
--------------------------------------------------------------------------------------------------------------------------------------------------------------------------------------------------------
--------------------------------------------------------------------------------------------------------------------------------------------------------------------------------------------------------
--------------------------------------------------------------------------------------------------------------------------------------------------------------------------------------------------------
-----------------------------------------------------BBCCCB---------------------------------------------------------------------------------------------------------------------------------------------
----------------------------------------------------kkgggkggkg-----------------------U---kgkgggggggggg---------------------------------%%%%%%%%----------------------------------------BCCB-------------
--------------------------------------------------r------------------------------------------------------------------------------------||||||||---------%%%%%%%%----------------------------------------
---------------------------------------%%%%%%%%%%%%-----------%%%%%%%%%%%------------------%%%%%%%%%--%%%%%%%%%%%%%%----%%%%%%%%-------|%%%%%%%%----g--g|||||g||-----g-----%%%%%%%----------------------
------%%%%%----------------------------||||||||||||-----------|||||||||||------------------|||||||||--||||||||||||||----||||||||-----%%%%%%%%%%%%%%-----|||||X||-----------|||||||----------------------
%%%%%%|||||%%%%%%%%%%%%%%-----%%%%%%%%%||||||||||||%%%%%%%%%%%|||||||||||---%%%%%%%%%%%%%%%%%%%%%%%%%%||||||||||||||----||||||||-----||||||||||||||---%%%%%%%%%%%%%%-----%%%%%%%%%%%%%%%%%%%%%%%%%%%%F%%
