--------------------------------------------------------------------------------------------------------------------------------------------------------------------------------------------------------
--------------------------------------------------------------------------------------------------------------------------------------------------------------------------------------------------------
--------------------------------------------------------------------------------------------------------------------------------------------------------------------------------------------------------
--------------------------------------------------------------------------------------------------------------------------------------------------------------------------------------------------------
--------------------------------------------------------------------------------------------------------------------------------------------------------------------------------------------------------
--------------------------------------------------------------------------------------------------------------------------------------------------------------------------------------------------------
-----------------------------------------------------------------------------U--------------------------------------------------------------------------------------------------------------------------
------------------------------------------------------------------------------------SSSSSSC-------------------------------------------------------------------------------------------------------------
--------------------------------------------------------g---g--------------------------------------------g----------------------------------------------------------------------------------------------
---------------------------------------------------------------------------------ggggggggggggg----------------------------------------------------------------------------------------------------------
---------------------------------------------------------------------%%%%%%%%%%%%-----------------------------------------------------------------------------------------------------------------------
----------------------------------kkkggkkkggg------------------------||||||||||||-------------%%%%%%%%%%--------------------------------------------------------------------------------SC2CSSCCS-------
--------------------------------r--|||||||||--------------------tt---||||||||||||-------------||||||||||----------------------------------------%%%%----------------------------------------------------
-------------------------%%%%%%%%--|||||||||-%%%%%%%%%%---------tt---||||||||||||%%%%%%%%%%%%%||||||||||----------------------------------------|%%%%%%%-----------%%%%%%%-----%%%%%---g------g---g-----
------%%%%%--------------||||||||--|||||||||-||||||||||-----%%%%%%%%%|||||||||||||||||||||||||||||||||||----%%%%%%%%%%%-------------------------||||||||-----------|||||||-----|||||--------------------
XXXXXX|||||XXXXXXXXXXXXXX||||||||XXXXXXXXXXXX||||||||||-----||||||||||||||||||||||||||||||||||||||||||||----|||||||||||-----XXX----XXXXXXXXX---XXXXXXXXXXXXX-----XXXXXXXXXXXXXXXXXXXXXXXXXXXXXXXXXXXXFXX
