--------------------------------------------------------------------------------------------------------------------------------------------------------------------------------------------------------
--------------------------------------------------------------------------------------------------------------------------------------------------------------------------------------------------------
--------------------------------------------------------------------------------------------------------------------------------------------------------------------------------------------------------
--------------------------------------------------------------------------------------------------------------------------------------------------------------------------------------------------------
--------------------------------------------------------------------------------------------------------------------------------------------------------------------------------------------------------
--------------------------------------------------------------------------------------------------------------------------------------------------------------------------------------------------------
----------------------------------------------------------------------------------------------------------------------------------------------------------------SCSS------------------------------------
--------------------------------------------------------------------------------------------------------------------------------------------------------------------------------------------------------
--------------------------------------------------------------------------------------------------------------------------------------------------------------g-----------------------------------------
-----------------------------------------------------------g-----------U----------------------------------------------------------------CSUSSCC-%%%%%%%%%%%%%-------------------------------------------
------------------------------------------------------------------------------------------------------------------------------------------------|||||||||||||%%%%%%%%%%---------------------------------
----------------------------------kkgkkkkggg-------------------------------gggggggggg----------------------------------------------UCS----------|||||||||||||||||||||||------------------UC-------------
--------------------------------r--||||||||----------------------------------||||||-------------------------------------%%%%%-------------------|||||||||||||||||||||||---------------------------------
-------------------------%%%%%%%%--||||||||-%%%%%%%%%%%%%%---%%%%%%%%%%%%%%--||||||--%%%%%%%%%%%%%-----gg---------------|||||-------------------|||||||||||||||||||||||----%%%%%%%%%%%------------------
------%%%%%--------------||||||||--||||||||-||||||||||||||---||||||||||||||--||||||--|||||||||||||---------------------XX||||-------------------|||||||||||||||||||||||----|||||||||||------------------
XXXXXX|||||XXXXXXXXXXXXXX||||||||XXXXXXXXXXX||||||||||||||---||||||||||||||XXXXXXXXXX|||||||||||||----XXXXXXXXXXXXX---XXXXXXXXXXXXXXXXXXXXXXXXXX|||||||||||||||||||||||----|||||||||||XXXXXXXXXXXXXXXFXX
