--------------------------------------------------------------------------------------------------------------------------------------------------------------------------------------------------------
--------------------------------------------------------------------------------------------------------------------------------------------------------------------------------------------------------
--------------------------------------------------------------------------------------------------------------------------------------------------------------------------------------------------------
--------------------------------------------------------------------------------------------------------------------------------------------------------------------------------------------------------
--------------------------------------------------------------------------------------------------------------------------------------------------------------------------------------------------------
--------------------------------------------------------------------------------------------------------------------------------------------------------------------------------------------------------
--------------------------------------------------------------------------------------------------------------------------------------------------------------------------------------------------------
--------------------------------------------------------------------------------------------------------------------------------------------------------------------------------------------------------
--------------------------------------------------------------------------------------------U-----------------------------------------------------------------%%%%%-------------------------------------
----------------------------------------------------------------------------------------------------CSC------------------------k------------------------------|||||-------------------------------------
-----------------------------------------------------------------------------------------------------------------------------------------------%%%%%%%%%%%%%--|||||----SSSCUS---------------------------
------------------------------------------------------------------------------------------------gkgggkggg-----------%%%%%%%%%%%%%%%%%%%%%%%%%%%|||||||||||||--|||||---------------SCSCCCSS2-------------
-------------------------------------------------------------------------------------%%%%%%%%%%%--------------------||||||||||||||||||||||||||||||||||||||||%%%%%%%%%-kr--------------------------------
-----------------------------------------------g--------------------%%%%%%%%%%%%%%---|||||||||||---------%%%%%%%%%%%|||||||||||||||||||||||||||||||||||||||||||||||||----------------k-k----------------
------%%%%%---------------------------------------------------------||||||||||||||---|||||||||||---------||||||||||||||||||||||||||||||||||||||||||||||||||||||||||||%%%%%%%%%%-------------------------
XXXXXX|||||XXXXXXXXXXXXXX-----XXXXXXXXXXX-----XXXXXXXXXX-----XXX----||||||||||||||---|||||||||||XXXXXXXXX||||||||||||||||||||||||||||||||||||||||||||||||||||||||||||||||||||||XXXXXXXXXXXXXXXXXXXXXXFXX
