--------------------------------------------------------------------------------------------------------------------------------------------------------------------------------------------------------
--------------------------------------------------------------------------------------------------------------------------------------------------------------------------------------------------------
--------------------------------------------------------------------------------------------------------------------------------------------------------------------------------------------------------
--------------------------------------------------------------------------------------------------------------------------------------------------------------------------------------------------------
--------------------------------------------------------------------------------------------------------------------------------------------------------------------------------------------------------
-------------------------------------------------------------------------------------------------------ggggkgkkkgkk-------------------------------------------------------------------------------------
-----------------------------------------------------------------------------------------------------r--||||||||||------------SSSCU---------------------------------------------------------------------
-------------------------------------------------------------------------%%%%%-------------%%%%%%%%%%%--||||||||||-%%%%%%%%-----------------------------------------------------------------------------
-------------------------------------------------------------------------|||||--g---g------|||||||||||--||||||||||-||||||||-----------------------------------------------------------------------------
-------------------------------------------------------------------------|||||-------------|||||||||||%%%%%%%%%%%%%||||||||-----------------------------------g-----------------------------------------
-------------------------------------------------------------------------|||||-%%%%%%%%%%%%||||||||||||||||||||||||||||||||%%%%%%%%%%g-----g------------------------------------------------------------
-----------------------------------------------------------------------%%%%%%%%||||||||||||||||||||||||||||||||||||||||||||||||||||||-----------------%%%%%--%%%%%%%%%%%%---%%%%%%%%%%%-----------------
-------------------------------------------------------------%%%%%%%---||||||||||||||||||||||||||||||||||||||||||||||||||||||||||||||%%%%%%%%%%-------|||||--||||||||||||---|||||||||||-----------------
--------------------------g----------------------------------|||||||---||||||||||||||||||||||||||||||||||||||||||||||||||||||||||||||||||||||||-------|||||--||||||||||||---|||||||||||-----%%%%%%%%%F%%
------%%%%%--------------------------------------------------|||||||---||||||||||||||||||||||||||||||||||||||||||||||||||||||||||||||||||||||||-------|||||--||||||||||||---|||||||||||-----|||||||||%||
XXXXXX|||||XXXXXXXXXXXXXX----XXXXXXXXXXXX-----XXXXXXXX-----XXXXXXXXXXXX||||||||||||||||||||||||||||||||||||||||||||||||||||||||||||||||||||||||-----XXXXXXXXX||||||||||||---|||||||||||-----||||||||||||
