--------------------------------------------------------------------------------------------------------------------------------------------------------------------------------------------------------
--------------------------------------------------------------------------------------------------------------------------------------------------------------------------------------------------------
--------------------------------------------------------------------------------------------------------------------------------------------------------------------------------------------------------
--------------------------------------------------------------------------------------------------------------------------------------------------------------------------------------------------------
--------------------------------------------------------------------------------------------------------------------------------------------------------------------------------------------------------
--------------------------------------------------------------------------------------------------------------------------------------------------------------------------------------------------------
--------------------------------------------------------------------------------------------------------------------------------------------------------------------------------------------------------
--------------------------------------------------------------------------------------------------------------------------------------------------------------------------------------------------------
-----------------------------------------------------BCBBBBBBB---------------------------------------------------------------------------------------------------ggg--------g--r------------------------
---------------------------------------------------gggkggggggggg----------------------------------------------------------------------------------------------------------------------------------------
--------------------------g-------g--------------r--------------------------------------------------------------------------------------------------------------%%%%%%%%%%%%----------------------------
------------------------------------------%%%%%%%%--------------%%%%%%%%------------------------------------------U---gkkkgggggggggk--------------%%%%%%%%%%%%%%||||||||||||----------------------------
------------------------------------------||||||||--------------||||||||--------------------------------------------------BCCCB2BB----------------||||||||||||||||||||||||||----%%%%%%%%%---------------
------------------------------------------||||||||%%%%%%%%%%%%%%||||||||-------------------g------------g---------------------------%%%%%%%%%%%%%%||||||||||||||||||||||||||----|||||||||---------------
------%%%%%-------------------------------||||||||||||||||||||||||||||||------------------------------------------------------------||||||||||||||||||||||||||||||||||||||||----|||||||||---------------
%%%%%%|||||%%%%%%%%%%%%%%-----%%%%%%%%%%%%||||||||||||||||||||||||||||||-----%%%%%%%%%%%%%%---%%%%%%%%%----%%%%%%%%%%%%%%%%%%%%%%%%%||||||||||||||||||||||||||||||||||||||||----|||||||||%%%%%%%%%%%%F%%
