--------------------------------------------------------------------------------------------------------------------------------------------------------------------------------------------------------
--------------------------------------------------------------------------------------------------------------------------------------------------------------------------------------------------------
--------------------------------------------------------------------------------------------------------------------------------------------------------------------------------------------------------
--------------------------------------------------------------------------------------------------------------------------------------------------------------------------------------------------------
--------------------------------------------------------------------------------------------------------------------------------------------------------------------------------------------------------
--------------------------------------------------------------------------------------------------------------------------------------------------------------------------------------------------------
--------------------------------------------------------------------------------------------------------------------------------------------------------------------------------------------------------
-------------------------------------------------------------------------------------------------------------------------------------------------SS22SUSSS-%%%%%%%%%------------SS----------------------
-----------------------------------------------------------------------------------------------------------------------------------------------------------|||||||||------------------kr-----r----------
-----------------------------------------------------------------------------------------------------------------------------------------USC2CCS-----------|||||||||------------------------------------
-----------------------------------------------------------------------------------------------------------------------------------------------------------|||||||||%%%%%%%%%--------%%%%%%%%%%%%%%%%F%%
----------------------------------------------------------------------------kkgggggggr---------------------------------------------------------------------||||||||||||||||||%%%%%%%%||||||||||||||||%||
----------------------------------------------%%%%%%-------------------------------------------------------------------------------------------------------|||||||||||||||||||||||||||||||||||||||||||||
-------------------------g--------------------||||||--------g---g---------r-----------%%%%%%%%%%%%----%%%%%%%%--------------------%%%%%%%%%%%%%------------|||||||||||||||||||||||||||||||||||||||||||||
------%%%%%-----------------------------------||||||---------------%%%%%%%%-----------||||||||||||----||||||||--------------------|||||||||||||------------|||||||||||||||||||||||||||||||||||||||||||||
XXXXXX|||||XXXXXXXXXXXXXX-----XXXXXXXXXX----XXXXXXXXXXX----XXXXXXXX||||||||XXXXXXXXXXX||||||||||||----||||||||XXXXXXXX---XXXXXXXXX|||||||||||||XXXXXXXXXXXX|||||||||||||||||||||||||||||||||||||||||||||
