--------------------------------------------------------------------------------------------------------------------------------------------------------------------------------------------------------
--------------------------------------------------------------------------------------------------------------------------------------------------------------------------------------------------------
--------------------------------------------------------------------------------------------------------------------------------------------------------------------------------------------------------
--------------------------------------------------------------------------------------------------------------------------------------------------------------------------------------------------------
------------------------------------------------------------------------------------U-------------------------------------------------------------------------------------------------------------------
----------------------------------------SC22SS2SU-%%%%%%%%%%%%%%----------------------------------------------------------------------------------------------------------------------------------------
--------------------------------------------------||||||||||||||--------------------------%%%%%--------------------------------------------------------------C2SCSU-------------------------------------
---------------------------------SSS2UC-----------||||||||||||||------------------------kggggkggk--------------------------------------------------%%%%%------------------------------------------------
--------------------------------------------------||||||||||||||-------------%%%%%%%%%%%--|||||----------------------------------g---g-g-----------|||||---k--------rr----------------------------------
--------------------------------------------------||||||||||||||-------------|||||||||||--|||||--%%%%%%%%%%%%%-------------------------------------|||||------------------------------------------------
--------------------------------------------------||||||||||||||----%%%%%%%%%|||||||||||--|||||--|||||||||||||-----%%%%%%%%%%%%%-----------------%%%%%%%%%%%%%%%%%%%%%----------------------------------
-------------------------%%%%%%%%%%%%%%%%%%%%%%%%%||||||||||||||----||||||||||||||||||||%%%%%%%%%|||||||||||||-----|||||||||||||-----------------|||||||||||||||||||||----k-----------%%%%%-------------
-------------------------|||||||||||||||||||||||||||||||||||||||----||||||||||||||||||||||||||||||||||||||||||-----|||||||||||||---%%%%%%%%%%%%%%|||||||||||||||||||||----------------|||||-------------
-------------------------|||||||||||||||||||||||||||||||||||||||----||||||||||||||||||||||||||||||||||||||||||-----|||||||||||||---|||||||||||||||||||||||||||||||||||----%%%%%%%%%%--|||||-------------
------%%%%%--------------|||||||||||||||||||||||||||||||||||||||----||||||||||||||||||||||||||||||||||||||||||-----|||||||||||||---|||||||||||||||||||||||||||||||||||----||||||||||--|||||-------------
XXXXXX|||||XXXXXXXXXXXXXX|||||||||||||||||||||||||||||||||||||||----||||||||||||||||||||||||||||||||||||||||||-----|||||||||||||---|||||||||||||||||||||||||||||||||||----||||||||||XXXXXXXXXXXXXXXXXFXX
