--------------------------------------------------------------------------------------------------------------------------------------------------------------------------------------------------------
--------------------------------------------------------------------------------------------------------------------------------------------------------------------------------------------------------
--------------------------------------------------------------------------------------------------------------------------------------------------------------------------------------------------------
--------------------------------------------------------------------------------------------------------------------------------------------------------------------------------------------------------
--------------------------------------------------------------------------------------------------------------------------------------------------------------------------------------------------------
--------------------------------------------------------------------------------------------------------------------------------------------------------------------------------------------------------
--------------------------------------------------------------------------------------------------------------------------------------------------------------------------------------------------------
--------------------------------------------------------------------------------------------------------------------------------------------------------------------------------------------------------
--------------------------------------------------------------------------------------------------------------------------------------------------------------------------------------------------------
--------------------------------------------------------------------------------------------------------------------------------------------------------------------------------------------------------
------------------------------------------------------BC2BB-----------------------------------------------U---------------------------------------------------------------------------------------------
--------------------------------%%%%%---------------ggggggggkg------------------------------------------------kggggggkkr----------------------------------------r--------------%%%%%%%%%%%%%%%%%%%%%%F%%
--------------------------------|||||-------------r--------------------------------------------g---------------------------------------------------------------------%%%%%%%---||||||||||||||||||||||X||
--------------------------------|||||--%%%%%%%%%%%%-----------%%%%%%%%%%------------------------------------------------%%%%%%%%%%%%---------------------------------|||||||---||||||||||||||||||||||X||
------%%%%%---------------------|||||--||||||||||||-----------||||||||||-------------%%%%%%%%%%---%%%%%%%%%%%%----------||||||||||||---------------------------------|||||||---||||||||||||||||||||||X||
%%%%%%|||||%%%%%%%%%%%%%%-----%%%%%%%%%||||||||||||%%%%%%%%%%%||||||||||---%%%%%%%%%%||||||||||---||||||||||||%%%%%%%%%%||||||||||||----%%%%%%%%%%%%%%%%%%%%%%%----%%%%%%%%%%%%||||||||||||||||||||||X||
