--------------------------------------------------------------------------------------------------------------------------------------------------------------------------------------------------------
--------------------------------------------------------------------------------------------------------------------------------------------------------------------------------------------------------
--------------------------------------------------------------------------------------------------------------------------------------------------------------------------------------------------------
--------------------------------------------------------------------------------------------------------------------------------------------------------------------------------------------------------
--------------------------------------------------------------------------------------------------------------------------------------------------------------------------------------------------------
--------------------------------------------------------------------------------------------------------------------------------------------------------------------------------------------------------
--------------------------------------------------------------------------------------------------------------------------------------------------------------------------------------------------------
--------------------------------------------------------------------------------------------------------------------------------------------------------------------------------------------------------
---------------------------------------------------------------------------------------------------------------------------------------------------BCCBCBBB-----------g----------gg---------------------
--------------------------------------------------------------g-------------------------------U----------------------------g----------------------ggggggggggg-------------------------------------------
-----------------------------------------CBCBCCCBB----------------------------------------------------CBBC--------------------------------------g--------------------------%%%%%%-----------------------
----------------------------------------gkkgggggkkkkg---------------------------------------------gggggggggg------------------------%%%%%%%%%%%%%------------%%%%%%%%-----%%%||||-----------------------
--------------------------------------r---------------------------------------------------------------------------------------------|||||||||||||------------||||||||-----|||||||--------%%%------------
-------------------------%%%%%%%%%%%%%%--------------%%%%%%%%----------gg----------g--g---%%%%%%%%----------%%%%%%%%%%%-------%%%%%-|||||||||||||%%%%%%%%%%%%||||||||----%%%%%%%%%%-----%%%%%%%---------
------%%%%%--------------||||||||||||||--------------||||||||-----------------------------||||||||----------|||||||||||-------|||||-|||||||||||||||||||||||||||||||||----||||||||||-----|||||||---------
%%%%%%|||||%%%%%%%%%%%%%%||||||||||||||%%%%%%%%%%%%%%||||||||-----%%%%%%%%%%%%----%%%%%%%%||||||||%%%%%%%%%%|||||||||||-----%%%%%%%%|||||||||||||||||||||||||||||||||----||||||||||---%%%%%%%%%%%%%%%F%%
