--------------------------------------------------------------------------------------------------------------------------------------------------------------------------------------------------------
--------------------------------------------------------------------------------------------------------------------------------------------------------------------------------------------------------
--------------------------------------------------------------------------------------------------------------------------------------------------------------------------------------------------------
--------------------------------------------------------------------------------------------------------------------------------------------------------------------------------------------------------
--------------------------------------------------------------------------------------------------------------------------------------------------------------------------------------------------------
--------------------------------------------------------------------------------------------------------------------------------------------------------------------------------------------------------
--------------------------------------------------------------------------------------------------------------------------------------------------------------------------------------------------------
------------------------------------------------------------------------------------------------------------------gkkgkggkkgg--------------tt-----------------------------------------------------------
----------------------------------------------------------------------------------------------------------------r--XXXXXXXXX---------------tt-----------------------------------------------------------
--------------------------------------------------------------------------------------------------------%%%%%%%%%--XXXXXXXXX-%%%%%%%%%-----tt----g------g--------g---k----------------------------------
--------------------------------------------------------------------------------------------------------|||||||||--XXXXXXXXX-|||||||||%%%%%%%%%%-----%%%%%%%--------------------------------------------
-------------------------------------------------------------%%%%%%-------------------------------------|||||||||%%%%%%%%%%%%|||||||||||||||||||----%%%%%|||----%%%%%%%%%%%%----------------------------
-----------------------------------------------%%%%%---------||||||-------------------------------------||||||||||||||||||||||||||||||||||||||||----||||||||----||||||||||||------------%%%%%%%%%%%%%F%%
-------------------------------------------g---|||||---g-----||||||------------------%%%----%%%%%%%%%%%%||||||||||||||||||||||||||||||||||||||||---%%%%%%%%%%%%%||||||||||||-------tt---|||||||||||||X||
------%%%%%------------------------------------|||||---------||||||--%%%%%%%%%%%-----|||----||||||||||||||||||||||||||||||||||||||||||||||||||||---|||||||||||||||||||||||||-------tt---|||||||||||||X||
%%%%%%|||||%%%%%%%%%%%%%%-----%%%%%%%%%%%%---%%%%%%%%%-----%%%%%%%%%%|||||||||||-----|||----||||||||||||||||||||||||||||||||||||||||||||||||||||---|||||||||||||||||||||||||---%%%%%%%%%|||||||||||||X||
