--------------------------------------------------------------------------------------------------------------------------------------------------------------------------------------------------------
--------------------------------------------------------------------------------------------------------------------------------------------------------------------------------------------------------
--------------------------------------------------------------------------------------------------------------------------------------------------------------------------------------------------------
--------------------------------------------------------------------------------------------------------------------------------------------------------------------------------------------------------
--------------------------------------------------------------------------------------------------------------------------------------------------------------------------------------------------------
--------------------------------------------------------------------------------------------------------------------------------------------------------------------------------------------------------
--------------------------------------------------------------------------------------------------------------------------------------------------------------------------------------------------------
----------------------------------------------------------------------------------------U---------------------------------------------------------------------------------------------------------------
-------------------------------------------------------------------------------------------------------------------gg-g-%%%%%%--------------------------------------------------------------------------
----------------------------------------------------------------------------------------------%%%%%%%-------------------||||||-----------------------------------g--------------------------------------
---------------------------------------------------------------------g----------------------kggggggkkgg-----------------||||||---g------------%%%%%-----------------------------------------------------
--------------------------g----g-----------------gkgkggkg----------------------%%%%%%%%%%%%%--|||||||-------------------||||||----------------|||||-----------------------------------%%%%%%%%----------
--------------------------------------------------%%%%%%-----------------------|||||||||||||--|||||||--%%%%%%%%%%%----%%%%%%%%%%%%%%%%%%%%%%--|||||------------------%%%%%%%----------||||||||----------
-----------------------------------------------r--||||||-%%%%%%%%%%------------|||||||||||||--|||||||--|||||||||||----||||||||||||||||||||||%%%%%%%%%-gg--%%%%%------|||||||-----g----||||||||----------
------%%%%%----------------------------%%%%%%%%%--||||||-||||||||||------------|||||||||||||%%%%%%%%%%%|||||||||||----|||||||||||||||||||||||||||||||-----|||||------|||||||----------||||||||----%%%F%%
XXXXXX|||||XXXXXXXXXXXXXX----XXXXXXXXXX|||||||||XXXXXXXXX||||||||||---XXXXXXXXX|||||||||||||||||||||||||||||||||||----|||||||||||||||||||||||||||||||---XXXXXXXX---XXXXXXXXXXXXX----XXXXXXXXXXXXXX|||X||
