--------------------------------------------------------------------------------------------------------------------------------------------------------------------------------------------------------
--------------------------------------------------------------------------------------------------------------------------------------------------------------------------------------------------------
--------------------------------------------------------------------------------------------------------------------------------------------------------------------------------------------------------
--------------------------------------------------------------------------------------------------------------------------------------------------------------------------------------------------------
--------------------------------------------------------------------------------------------------------------------------------------------------------------------------------------------------------
--------------------------------------------------------------------------------------------------------------------------------------------------------------------------------------------------------
--------------------------------------------------------------------------------------------------------------------------------------------------------------------------------------------------------
--------------------------------------------------------------------------------------------------------------------------------------------------------------------------------------------------------
-------------------------------------------------------------g-g-----g-------------U--------------------------------------------------------------------------------------------------------------------
-----------------------------------------SSSS2---------------------------------------------2S2S------------------%%%%%------------------gg--------------------------------------------------------------
----------------------------------------kggggkkg-----------------------------------------------------------------|||||------------------------------------------------------------------SSSSCU----------
--------------------------------------r------------------------------------------------ggkkgkgggg----------------|||||--------%%%%%%--------------------------------------------------------------------
-------------------------%%%%%%%%%%%%%%---------%%%%%%%%%%%%----------------%%%%%%%%%%%--------------------------|||||--------||||||--------%%%%%------------------------------------------------%%%%F%%
-------------------------||||||||||||||---------||||||||||||----%%%%%%%%%%%%|||||||||||----------%%%%%%%%%-----%%%%%%%%-g-----g|||||--------|||||---gg---------g---------------------------------||||%||
------%%%%%--------------||||||||||||||%%%%%%%%%||||||||||||----|||||||||||||||||||||||----------|||||||||-----||||||||-------||||||--------|||||---------------------------%%%%%%%%%%%%%%%%%%%%%|||||||
XXXXXX|||||XXXXXXXXXXXXXX|||||||||||||||||||||||||||||||||||----|||||||||||||||||||||||XXXXXXXXXX|||||||||-----||||||||-----XXXXXXXXXXX---XXXXXXXXXXXXXXXXXXXXX----XXXXXXXXX||||||||||||||||||||||||||||
