--------------------------------------------------------------------------------------------------------------------------------------------------------------------------------------------------------
--------------------------------------------------------------------------------------------------------------------------------------------------------------------------------------------------------
--------------------------------------------------------------------------------------------------------------------------------------------------------------------------------------------------------
--------------------------------------------------------------------------------------------------------------------------------------------------------------------------------------------------------
--------------------------------------------------------------------------------------------------------------------------------------------------------------------------------------------------------
--------------------------------------------------------------------------------------------------------------------------------------------------------------------------------------------------------
--------------------------------------------------------------------------------------------------------------------------------------------------------------------------------------------------------
--------------------------------------------------------------------------------------------------------------------------------------------------------------------------------------------------------
------------------------------------------------------g---------------------------------------------------------------------------------------------------------kk--------------------------------------
------------------------------------2CUB2B--%%%%%%%%%-----------------------------------------------------------------------------------------------%%%%%%%---------------------------------------------
--------------------------------------------|||||||||-----------------------------------------------------U-----------------------------------------|%%%%%%---------------------------------------------
------------------------------UCBB----------|||||||||-----------------------------------------CCBB------------ggggkgkggggkgg------------------------|||||||-------------------------BBBBBC2CB-----------
--------------------------------------------|||||||||----%%%%%%%%%%---------------------------------------------%%%%%%%%%%----------%%%%%%%%%%%---%%%%%%%%%%%%%-----------------------------------------
--------------------------------------------|||||||||----||||||||||-------------gg-g----------------------------||||||||||--%%%%%%%%|||||||||||---|||||||||||||-------------------k-------r-------------
------%%%%%---------------------------------|||||||||----||||||||||----------------------------------%%%%%%%%%--||||||||||--|||||||||||||||||||---|||||||||||||-----------------------------------------
%%%%%%|||||%%%%%%%%%%%%%%%%%%%%%%%%%%%%%%%%%|||||||||----||||||||||-----%%%----%%%%%%%%%%%%%%%%%%%%%%|||||||||%%%%%%%%%%%%%%|||||||||||||||||||---|||||||||||||-----%%%%%%%%%%%%%%%%%%%%%%%%%%%%%%%%%F%%
