--------------------------------------------------------------------------------------------------------------------------------------------------------------------------------------------------------
--------------------------------------------------------------------------------------------------------------------------------------------------------------------------------------------------------
--------------------------------------------------------------------------------------------------------------------------------------------------------------------------------------------------------
--------------------------------------------------------------------------------------------------------------------------------------------------------------------------------------------------------
---------------------------------------------------------------------------------------------------------------------------BC2BB------------------------------------------------------------------------
--------------------------------------------------------------------------------------------------------------------------kggkggkk----------------------------------------------------------------------
------------------------------------------------------------------------------------------------------------------------r-------------------------------------------------------------------------------
---------------------------------------------------------------------------------------------------------------%%%%%%%%%%---------%%%%%%%%%%%-----------------%%%%%%%-----------------------------------
---------------------------------------------------------------------------------------------------------------||||||||||---------|||||||||||-g---------------|||||||-----------------------------------
-----------------------------------------------------------------------------------------------------g---------||||||||||%%%%%%%%%|||||||||||-----------------|||||||-----------------------------------
---------------------------------------------------------------------------------------------------------------||||||||||||||||||||||||||||||----%%%%%%%%%%%%%%%%%%%%%%%--BBCC--------------------------
---------------------------------------------------------------------------------ggggggggk----------%%%%%%%%%%%||||||||||||||||||||||||||||||----|||||||||||||||||||||||--------------------------------
-------------------------------------------------------------------------------r--XXXXXXX-----------|||||||||||||||||||||||||||||||||||||||||----|||||||||||||||||||||||-g------------------------------
--------------------------g--g------------g--------------------tt---%%%%%%%%%%%%--XXXXXXX-%%%%%%%%%%|||||||||||||||||||||||||||||||||||||||||----|||||||||||||||||||||||--------------------%%%%%%%%%F%%
------%%%%%----------------------------------------------------tt---||||||||||||--XXXXXXX-|||||||||||||||||||||||||||||||||||||||||||||||||||----|||||||||||||||||||||||%%%%%%%%%-----------|||||||||X||
%%%%%%|||||%%%%%%%%%%%%%%----%%%%%%%%----%%%%%%%%%%%%%%----%%%%%%%%%||||||||||||%%%%%%%%%%|||||||||||||||||||||||||||||||||||||||||||||||||||----||||||||||||||||||||||||||||||||%%%%%%%%%%%|||||||||X||
