--------------------------------------------------------------------------------------------------------------------------------------------------------------------------------------------------------
--------------------------------------------------------------------------------------------------------------------------------------------------------------------------------------------------------
--------------------------------------------------------------------------------------------------------------------------------------------------------------------------------------------------------
--------------------------------------------------------------------------------------------------------------------------------------------------------------------------------------------------------
--------------------------------------------------------------------------------------------------------------------------------------------------------------------------------------------------------
--------------------------------------------------------------------------------------------------------------------------------------------------------------------------------------------------------
--------------------------------------------------------------------------------------------------------------------------------------------------------------------------------------------------------
-------------------------------------SSSSSSU-%%%%%%%%%-------------------------------------------------------------------------U------------------------------------------------------------------------
---------------------------------------------|||||||||--------g----g-g--------------g------------------------------------------------------------------------------------SS2SSS----r--------------------
-------------------------------C2U-----------|||||||||-------------------------------------------------------------------------------%%%%%%%%%----------------------------------------------------------
---------------------------------------------|||||||||---%%%%%%%%%%%%--------------------------------------------------------------gggggggkgkkrr----------------------------------%%%%%%%%%%%%%%%%%%%F%%
---------------------------------------------|||||||||---||||||||||||----------------------------------------------USSC--%%%%%%%%%%--|||||||||----------------%%%%%%%%%-----------|||||||||||||||||||%||
---------------------------------------------|||||||||---||||||||||||---%%%%%%%%%%%--------------------------------------||||||||||--|||||||||--%%%%%%%%%%%%%%|||||||||%%%%%%%%%%%||||||||||||||||||||||
-------------------------%%%%%%%%%%----------|||||||||---||||||||||||---|||||||||||----------------g--g------------------||||||||||--|||||||||--||||||||||||||||||||||||||||||||||||||||||||||||||||||||
------%%%%%--------------||||||||||----------|||||||||---||||||||||||---|||||||||||---%%%%%%%%---------------------------||||||||||%%%%%%%%%%%%%||||||||||||||||||||||||||||||||||||||||||||||||||||||||
XXXXXX|||||XXXXXXXXXXXXXX||||||||||XXXXXXXXXX|||||||||---||||||||||||---|||||||||||---||||||||-----XXXXXXXXXXXXXXXXXXXXXX|||||||||||||||||||||||||||||||||||||||||||||||||||||||||||||||||||||||||||||||
