--------------------------------------------------------------------------------------------------------------------------------------------------------------------------------------------------------
--------------------------------------------------------------------------------------------------------------------------------------------------------------------------------------------------------
--------------------------------------------------------------------------------------------------------------------------------------------------------------------------------------------------------
--------------------------------------------------------------------------------------------------------------------------------------------------------------------------------------------------------
--------------------------------------------------------------------------------------------------------------------------------------------------------------------------------------------------------
--------------------------------------------------------------------------------------------------------------------------------------------------------------------------------------------------------
--------------------------------------------------------------------------------------------------------------------------------------------------------------------------------------------------------
------------------------------U-------------------------------------------------------------------------------------------------------------------------------------------------------------------------
--------------------------------------------------------------------------------------------------------------------------------------------------------------------------------------------------------
------------------------------------%%%%%%%%%%------------------------------------------------------------------------------------------------------------------------------------%%%%%%%---------------
----------------------------------gkkkkggggggggg----------------------------------------------------------------------------------------------------------------------------------|||||||---------------
-------------------------%%%%%%%%%--XXXXXXXXXX---------------------------------------%%%%%-------------------------------gkgkgggggg--------------------------gg-----------%%%%%---|||||||---------------
-------------------------|||||||||--XXXXXXXXXX--%%%%%%%%%%%%%%-----------------------|||||-----------------------------r--XXXXXXXX----------------------------------------|||||---|||||||---------------
-------------------------|||||||||--XXXXXXXXXX--||||||||||||||---%%%%%%%%%%%%%%------|||||-------------------%%%%%%%%%%%--XXXXXXXX-%%%%%%%%%%%%-------------%%%%%%%%%%%%--|||||-%%%%%%%%%%%%%-----------
------%%%%%--------------|||||||||%%%%%%%%%%%%%%||||||||||||||---||||||||||||||------|||||-------------------|||||||||||--XXXXXXXX-||||||||||||-------------||||||||||||%%%%%%%%|||||||||||||-----------
%%%%%%|||||%%%%%%%%%%%%%%|||||||||||||||||||||||||||||||||||||---||||||||||||||----%%%%%%%%-----%%%%%%%%%%%%%|||||||||||%%%%%%%%%%%||||||||||||----%%%%%%%%%|||||||||||||||||||||||||||||||||%%%%%%%%F%%
