--------------------------------------------------------------------------------------------------------------------------------------------------------------------------------------------------------
--------------------------------------------------------------------------------------------------------------------------------------------------------------------------------------------------------
--------------------------------------------------------------------------------------------------------------------------------------------------------------------------------------------------------
--------------------------------------------------------------------------------------------------------------------------------------------------------------------------------------------------------
--------------------------------------------------------------------------------------------------------------------------------------------------------------------------------------------------------
--------------------------------------------------------------------------------------------------------------------------------------------------------------------------------------------------------
--------------------------------------------------------------------------------------------------------------------------------------------------------------------------------------------------------
--------------------------------------------------------------------------------------------------------------------------------------------------------------------------------------------------------
--------------------------------------------------------------------------------------------------------------------------------------------------------------------------------------------------------
------------------------------U----------------------------------------------------------------kkkkgggggg-----------------------------------------------------------------------------------------------
-------------------------------------CBBBBCBBB-----------------------------------------------r--XXXXXXXX------------------------------------------------------------------------------------------------
----------------------------------gkgggggkgggggg-------------------g------------%%%%%%%%%%%%%%--XXXXXXXX-%%%%%%%%%%%%---------------g-----%%%%%%-----BCBU-----------------------------------------------
--------------------------------------------------------------------------------||||||||||||||--XXXXXXXX-||||||||||||----%%%%%%%%%%-------||||||--------------------------------------------%%%%%%%%%F%%
-------------------------%%%%%%%%%--------------%%%%%%%%%%%%%-----%%%%%%%%%%%%%%||||||||||||||%%%%%%%%%%%||||||||||||----||||||||||-------||||||-----------gg--------%%%%%%----g---------g--|||||||||X||
------%%%%%--------------|||||||||--------------|||||||||||||-----|||||||||||||||||||||||||||||||||||||||||||||||||||----||||||||||-----%%%%%%%%%%%------------------||||||-----------------|||||||||X||
%%%%%%|||||%%%%%%%%%%%%%%|||||||||%%%%%%%%%%%%%%|||||||||||||-----|||||||||||||||||||||||||||||||||||||||||||||||||||----||||||||||-----|||||||||||%%%%%%%%%%%%%%%%%%%%%%%%%%%%%%%%%%%%%%%%%|||||||||X||
