--------------------------------------------------------------------------------------------------------------------------------------------------------------------------------------------------------
--------------------------------------------------------------------------------------------------------------------------------------------------------------------------------------------------------
--------------------------------------------------------------------------------------------------------------------------------------------------------------------------------------------------------
--------------------------------------------------------------------------------------------------------------------------------------------------------------------------------------------------------
--------------------------------------------------------------------------------------------U-----------------------------------------------------------------------------------------------------------
----------------------------------------------------------------------------------------------------CSSSS2C---------------------------------------------------------------------------------------------
--------------------------------------------------------------------------------------------------------------------------------------------------------------------------------------------------------
------------------------------------------------------------------------------------------------gkkgggggggkgg-------------------------------------------------------------------------------------------
----------------------------------------------------------------------------------%%%%%%%%%%%%%%--------------------------------------------------------------------------------------------------------
-------------------------------------2CSSS2CUS22C-%%%%%%%%%%%%%%------------------||||||||||||||-------------%%%%%%%%%%---------------------------------------------------------------------------------
--------------------------------------------------||||||||||||||-------g----g-----||||||||||||||-------------||||||||||----r----r-----------------------------------------------------------------------
-------------------------------22SU---------------||||||||||||||------------------||||||||||||||%%%%%%%%%%%%%||||||||||----------------------------------------CSC22CUSS------SCSSSSS-----CS---%%%%%%F%%
--------------------------------------------------||||||||||||||----%%%%%%%%%%%%%%|||||||||||||||||||||||||||||||||||||---%%%%%%%%%-------------r----------------------------------------------||||||%||
--------------------------------------------------||||||||||||||----|||||||||||||||||||||||||||||||||||||||||||||||||||---|||||||||--------------------------------------------k---------------|||||||||
------%%%%%---------------------------------------||||||||||||||----|||||||||||||||||||||||||||||||||||||||||||||||||||---|||||||||------------%%%%%%%%%%%%%%----------------------------------|||||||||
XXXXXX|||||XXXXXXXXXXXXXXXXXXXXXXXXXXXXXXXXXXXXXXX||||||||||||||----|||||||||||||||||||||||||||||||||||||||||||||||||||---|||||||||XXXXXXXXXXXX||||||||||||||XXXXXXXXXXXXXXXXXXXXXXXXXXXXXXXXXX|||||||||
