--------------------------------------------------------------------------------------------------------------------------------------------------------------------------------------------------------
--------------------------------------------------------------------------------------------------------------------------------------------------------------------------------------------------------
--------------------------------------------------------------------------------------------------------------------------------------------------------------------------------------------------------
--------------------------------------------------------------------------------------------------------------------------------------------------------------------------------------------------------
--------------------------------------------------------------------------------------------------------------------------------------------------------------------------------------------------------
--------------------------------------------------------------------------------------------------------------------------------------------------------------------------------------------------------
-----------------------------------------------------------------------------CBC------------------------------------------------------------------------------------------------------------------------
--------------------------------------------------------------------------------------------------------------------------------------------------------------------------------------------------------
------------------------------------------U------------------------------------------------------------------------------------------gg--------------rk------------%%%%%%-------------------------------
-----------------------------------------------------------------------------------------------------------------------------------------------B2B-----------------||||||-------------------------------
------------------------------------------------%%%%-----------------------%%%%%%--g------------------------------------------------%%%%%%%%%--------%%%%%%%%%%%%--||||||-------------------------------
----------------------------------------------kgggkkkk--------------------%%%%%||---------------------------------------%%%%%%%%%%%%|||||||||--------||||||||||||--||||||-----%%%%%------%%%%%%---------
------------------------------------%%%%%%%%%%--XXXX----------------------|||||||---------------------------------------|||||||||||||||||||||--------||||||||||||%%%%%%%%%%%-%%%|||------|%%%%%%--%%%F%%
-----------------------------g---g-g||||||||||--XXXX--%%%%%%%%%%%%%%------|||||||---------------------------g----g------|||||||||||||||||||||%%%%%%%%|||||||||||||||||||||||-||||||------|||||||--|||X||
------%%%%%-------------------------||||||||||--XXXX--||||||||||||||----%%%%%%%%|----%%%%%%%%%%%-----%%%----------------||||||||||||||||||||||||||||||||||||||||||||||||||||-||||||------|||||||--|||X||
%%%%%%|||||%%%%%%%%%%%%%%---%%%%%%%%||||||||||%%%%%%%%||||||||||||||----|||||||||----|||||||||||-----|||----%%%%%%%%%%%%||||||||||||||||||||||||||||||||||||||||||||||||||||%%%%%%%%---%%%%%%%%%%%|||X||
