--------------------------------------------------------------------------------------------------------------------------------------------------------------------------------------------------------
--------------------------------------------------------------------------------------------------------------------------------------------------------------------------------------------------------
--------------------------------------------------------------------------------------------------------------------------------------------------------------------------------------------------------
--------------------------------------------------------------------------------------------------------------------------------------------------------------------------------------------------------
--------------------------------------------------------------------------------------------------------------------------------------------------------------------------------------------------------
--------------------------------------------------------------------------------------------------------------------------------------------------------------------------------------------------------
--------------------------------------------------------------------------------------------------------------------------------------------------------------------------------------------------------
--------------------------------------------------------------------------------------------------------------------------------------------------------------------------------------------------------
------------------------------------------------------------------------------------------------------------------------g---------g---------------------------------------------------------------------
--------------------------------------------------------------------------------------------gkgkgkggkgggk--------------------------------------------------------------------k--------------------------
------------------------------------------------------------------------------------------r--XXXXXXXXXXX-------------------------------------------BCCC22B2---------------------------------------------
-------------------------------%%%%------------------------------------------%%%%%%%%%%%%%%--XXXXXXXXXXX-%%%%%%%%%%%%%%----------------gg-----------------------------------%%%%%%%%%%%%%%--------------
-------------------------------||||---g-------------g------------------------||||||||||||||--XXXXXXXXXXX-||||||||||||||-----------------------------------------------------||||||||||||||--------------
------------------------------%%%%%------------------------------------------||||||||||||||%%%%%%%%%%%%%%||||||||||||||---------------%%%%%%%%%%--------------%%%%%%%%%%%%%%||||||||||||||%%%%%%%%%%%F%%
------%%%%%-------------------|||||----------------%%%%%%%%%%%%%----%%%%%%%%%||||||||||||||||||||||||||||||||||||||||||---------------||||||||||%%%%%%%%%%%%%%|||||||||||||||||||||||||||||||||||||||X||
%%%%%%|||||%%%%%%%%%%%%%%---%%%%%%%%%---%%%%%%%%%%%|||||||||||||----|||||||||||||||||||||||||||||||||||||||||||||||||||----%%%%%%%%%%%|||||||||||||||||||||||||||||||||||||||||||||||||||||||||||||||X||
