--------------------------------------------------------------------------------------------------------------------------------------------------------------------------------------------------------
--------------------------------------------------------------------------------------------------------------------------------------------------------------------------------------------------------
--------------------------------------------------------------------------------------------------------------------------------------------------------------------------------------------------------
--------------------------------------------------------------------------------------------------------------------------------------------------------------------------------------------------------
--------------------------------------------------------------------------------------------------------------------------------------------------------------------------------------------------------
--------------------------------------------------------------------------------------------------------------------------------------------------------------------------------------------------------
--------------------------------------------------------------------------------------------------------------------------------------------------------------------------------------------------------
--------------------------------------------------------------------------------------------------------------------------------------------------------------------------------------------------------
----------------------------------U----------------------------------------------------------------------------------------------------------------------2CB2BB2BB--------------------------------------
------------------------------------------2C2B---------------------------------------------------------------------------------------------------------kggggkgggggrr------------------------------------
-----------------------------------------------------------------------------------------------------------------------------------------------------r-------------------------%%%%%%%%%%%--------------
--------------------------------------gkggkgggggg-----------------------------------------%%%%%%----g--------g------------------------g--%%%%%%%%%%%%%--------------%%%%%%%%%%%|||||||||||%%%%%%%%%%%F%%
-------------------------%%%%%%%%%%%%%----------------------------------------------------||||||-----------------------------------------|||||||||||||--------------|||||||||||||||||||||||||||||||||X||
-------------------------|||||||||||||-----------%%%%%%%%%%-----g-----------g----g-----g--||||||---%%%%%%%%%%%%------------%%%%%%%%%%%%%%|||||||||||||%%%%%%%%%%%%%%|||||||||||||||||||||||||||||||||X||
------%%%%%--------------|||||||||||||-----------||||||||||-------------------------------||||||---||||||||||||-----%%%----||||||||||||||||||||||||||||||||||||||||||||||||||||||||||||||||||||||||||X||
%%%%%%|||||%%%%%%%%%%%%%%|||||||||||||%%%%%%%%%%%||||||||||----%%%%%%%%%---%%%%%%%%%%---%%%%%%%%%%%||||||||||||-----|||----||||||||||||||||||||||||||||||||||||||||||||||||||||||||||||||||||||||||||X||
