--------------------------------------------------------------------------------------------------------------------------------------------------------------------------------------------------------
--------------------------------------------------------------------------------------------------------------------------------------------------------------------------------------------------------
--------------------------------------------------------------------------------------------------------------------------------------------------------------------------------------------------------
--------------------------------------------------------------------------------------------------------------------------------------------------------------------------------------------------------
--------------------------------------------------------------------------------------------------------------------------------------------------------------------------------------------------------
----------------------------------------------------------------------------------------------------------------------------------------------------------C2CSCSU--%%%%%%%%%%%%%%-----------------------
-------------------------------------------------------------------------------------------------------------------------------------------------------------------||||||||||||||-----------------------
-----------------------------------------------------------------------------------------------------------------------------------------------------2U------------||||||||||||||-----------------------
-------------------------------------------------------------------------------------------------------------------------------------------------------------------||||||||||||||-----------------------
-------------------------------------------------------------------------------------------------U-----------------------------------------------------------------||||||||||||||-----------------------
-------------------------------------------------------------------------------------------------------------------------------------------------------------------||||||||||||||---%%%%%%%%%%%%%%------
-----------------------------------------------------ggggggggggkgg-----------------------------------gggkgggkgggrk-----------------------------%%%%%%%%%-----------||||||||||||||---||||||||||||||------
--------------------------------%%%%%------------------------------------------------------------------|||||||||------------------r------------|||||||||-----------||||||||||||||---||||||||||||||------
--------------------------gg----|||||--------------r--------------%%%%%%%%%%%%---------------%%%%%%%%--|||||||||--%%%%%%%%%%%%-----------------|||||||||%%%%%%%%%%%||||||||||||||---||||||||||||||------
------%%%%%---------------------|||||--%%%%%%%%%%%%%--------------||||||||||||---------------||||||||--|||||||||--||||||||||||---%%%%%%%%%%%%%%||||||||||||||||||||||||||||||||||---||||||||||||||%%%F%%
XXXXXX|||||XXXXXXXXXXXXXX-----XXXXXXXXX|||||||||||||XXXXXXXXXXXXXX||||||||||||---XXXXXXXXXXXX||||||||XXXXXXXXXXXXX||||||||||||---||||||||||||||||||||||||||||||||||||||||||||||||---|||||||||||||||||X||
