--------------------------------------------------------------------------------------------------------------------------------------------------------------------------------------------------------
--------------------------------------------------------------------------------------------------------------------------------------------------------------------------------------------------------
--------------------------------------------------------------------------------------------------------------------------------------------------------------------------------------------------------
--------------------------------------------------------------------------------------------------------------------------------------------------------------------------------------------------------
--------------------------------------------------------------------------------------------------------------------------------------------------------------------------------------------------------
--------------------------------------------------------------------------------------------------------------------------------------------------------------------------------------------------------
------------------------------------------------------------------------------------------%%%%%---------------------------------------------------------------------------------------------------------
-----------------------------------------------------------------------------------------%%%%%%----------------------------------------------------------------------------------------BBBBB------------
-----------------------------------------------------------------------------------------||||||--g------------------------------------------------------------------------------------------------------
-----------------------------------------------------------------------------------------||||||--------------------------------------------------------------------------------------k---k--k-----------
---------------------------------------g--g--------------------------------------------%%%%%%%%%%--------------------------------------------------CCCC-------------------------------------------------
---------------------------------------------------------------------------------------||||||||||-------%%%%%%%%----------------------g----gg-------------------------------%%%%%%%%%%%%%%%%%%----------
--------------------------------%%%%%------------------------------g--------g----------||||||||||-------||||||||--------------tt--------------------------------------------||||||||||||||||||%%%%%%%F%%
-------------------------g------|||||----------------------%%%%%--------------%%%%%%%%%||||||||||-----%%%%%%%%%%%%%%-g--------tt-----%%%%%%%%%%%----------g---r-r-k---------|||||||||||||||||||||||||X||
------%%%%%---------------------|||||---------------------%%%|||--%%%%%%%%%%%%|||||||||||||||||||-----||||||||||||||---%%%%%%%%%%%%%%|||||||||||%%%%%%%%%-------------------|||||||||||||||||||||||||X||
%%%%%%|||||%%%%%%%%%%%%%%-----%%%%%%%%-----%%%%%%%%%%----%%%%%%%%%|||||||||||||||||||||||||||||||-----||||||||||||||---||||||||||||||||||||||||||||||||||-----%%%%%%%%%%%%%%|||||||||||||||||||||||||X||
