--------------------------------------------------------------------------------------------------------------------------------------------------------------------------------------------------------
--------------------------------------------------------------------------------------------------------------------------------------------------------------------------------------------------------
--------------------------------------------------------------------------------------------------------------------------------------------------------------------------------------------------------
--------------------------------------------------------------------------------------------------------------------------------------------------------------------------------------------------------
---------------------------------------------------------------------------------------------------------------------------------------------2C---------------------------------------------------------
--------------------------------------------------------------------------------------------------------------------------------------------------------------------------------------------------------
--------------------------------------------------------------------------------------------------------------------------------------------------------------------------------------------------------
--------------------------------------------------------------------------------------------------------------------------------------------------------------------------------------------------------
-------------------------------------------------------------------------------------------------------------------------------------------%%%%%---------------------------------------BB---------------
-------------------------------------------------------------------------------------------------------------------------------------------|||||--------------------------------------------------------
-----------------------------------------------------------------------------------------------U-------------------------------------------|||||---g----------------------------------------------------
-----------------------------------------------%%%%%%-----------------ggggkgk----------------------gkgkggkggkgg--------------%%%%%%%%%%%%--|||||--------------------------------------------------------
-----------------------------------------------||||||------------------------------------------------%%%%%%%%----------------||||||||||||%%%%%%%%%------------------------------------%%%%%-------------
-------------------------------------------g--g||g|||---------------r--------%%%%%%%%%%%-------------||||||||--%%%%%%%%%%%%%%|||||||||||||||||||||--------------------gg--------------|||||-------------
------%%%%%------------------------------------||X|||---%%%%%%%%%%%%%--------|||||||||||---%%%%%%%%--||||||||--|||||||||||||||||||||||||||||||||||------------------------------------|||||-------------
%%%%%%|||||%%%%%%%%%%%%%%---%%%%%%%%%%%%%%---%%%%%%%%%%%|||||||||||||%%%%%%%%|||||||||||---||||||||%%%%%%%%%%%%|||||||||||||||||||||||||||||||||||---%%%%%%%%%%%%%---%%%%%%%%%%%----%%%%%%%%%%%%%%%%%F%%
