--------------------------------------------------------------------------------------------------------------------------------------------------------------------------------------------------------
--------------------------------------------------------------------------------------------------------------------------------------------------------------------------------------------------------
--------------------------------------------------------------------------------------------------------------------------------------------------------------------------------------------------------
--------------------------------------------------------------------------------------------------------------------------------------------------------------------------------------------------------
--------------------------------------------------------------------------------------------------------------------------------------------------------------------------------------------------------
--------------------------------------------------------------------------------------------------------------------------------------------------------------------------------------------------------
--------------------------------------------------------------------------------------------------------------------------------------------------------------------------------------------------------
--------------------------------------------------------------------------------------------------------------------------------------------------------------------------------------------------------
------------------------------------------------------------------------------------------------------------------------------------------g-----g--------%%%%%%----%%%%%---g----gk----------------------
---------------------------------------------------------------------------------------------------------------------------------------------------------||||||----|||||--------------------------------
--------------------------------------------------------------------------------------------------2SSS2SC-----------------g------%%%%%%--%%%%%%%%%%%---%%%%%%%%%%%%%%%%%%%%%%%%%%%----rr----------------
-------------------------------%%%%%%%--------------------------------------%%%%%%---------------kkgggggkggg---------------------||||||--|||||||||||---|||||||||||||||||||||||||||----------------------
-------------------------------|||||||------------tt-----------------------%%%%|||-------------r---------------------------------||||||--|||||||||||---|||||||||||||||||||||||||||---%%%%%%%%%%%--------
--------------------------gg---|||||||----g-g--g--Tt---g-------------------|||||||--%%%%%%%%%%%%------------%%%%%%%%%%%%%%-------||||||--|||||||||||---|||||||||||||||||||||||||||---|||||||||||--------
------%%%%%--------------------|||||||------------tt-----------------------|||||||--||||||||||||------------||||||||||||||-----%%%%%%%%%%|||||||||||---|||||||||||||||||||||||||||---|||||||||||%%%%%F%%
XXXXXX|||||XXXXXXXXXXXXXX----XXXXXXXXXXXX-----XXXXXXXXX-----XXXXXXXXXXX---XXXXXXXXXX||||||||||||XXXXXXXXXXXX||||||||||||||-----|||||||||||||||||||||---|||||||||||||||||||||||||||---||||||||||||||||X||
