--------------------------------------------------------------------------------------------------------------------------------------------------------------------------------------------------------
--------------------------------------------------------------------------------------------------------------------------------------------------------------------------------------------------------
--------------------------------------------------------------------------------------------------------------------------------------------------------------------------------------------------------
--------------------------------------------------------------------------------------------------------------------------------------------------------------------------------------------------------
--------------------------------------------------------------------------------------------------------------------------------------------------------------------------------------------------------
--------------------------------------------------------------------------------------------------------------------------------------------------------------------------------------------------------
-----------------------------------------------------------------------------SCSCSCSC-------------------------------------------------------------------------------------------------------------------
---------------------------------------------------------------------------gkgkggggggggg----------------------------------------------------------------------------------------------------------------
-------------------------------------CSC-----------------%%%%%%----------r----------------------------g------g------------2S2CCU2CS-----------U2SSS2SSS--%%%%%%%%%%%%%-----k-------k--------------------
------------------------------------ggkgggg--------------|%%%%%%-%%%%%%%%%--------------%%%%%%%%%%%%%----------------------------------------------------|||||||||||||----------------------------------
----------------------------------r----------------------|||||||-|||||||||--------------|||||||||||||-------------------------------------CU-------------|||||||||||||-----%%%%%%%%%---%%%--------------
-------------------------%%%%%%%%%%--------%%%%%%%%%---%%%%%%%%%%|||||||||%%%%%%%%%%%%%%|||||||||||||-----%%%%%%%%%%%%%----------------------------------|||||||||||||-----|||||||||--%%%%%--%%%%%%%%F%%
-------------------------||||||||||--------|||||||||---||||||||||||||||||||||||||||||||||||||||||||||-----|||||||||||||%%%%%%%%%%%%%%--------------------|||||||||||||-----|||||||||--|||||--||||||||%||
-------------------------||||||||||%%%%%%%%|||||||||---||||||||||||||||||||||||||||||||||||||||||||||-----|||||||||||||||||||||||||||--------------------|||||||||||||-----|||||||||--|||||--|||||||||||
------%%%%%--------------|||||||||||||||||||||||||||---||||||||||||||||||||||||||||||||||||||||||||||-----|||||||||||||||||||||||||||%%%%%%%%%%%%%%%%%%%%|||||||||||||-----|||||||||%%%%%%%%%|||||||||||
XXXXXX|||||XXXXXXXXXXXXXX|||||||||||||||||||||||||||---||||||||||||||||||||||||||||||||||||||||||||||-----||||||||||||||||||||||||||||||||||||||||||||||||||||||||||||-----|||||||||||||||||||||||||||||
