--------------------------------------------------------------------------------------------------------------------------------------------------------------------------------------------------------
--------------------------------------------------------------------------------------------------------------------------------------------------------------------------------------------------------
--------------------------------------------------------------------------------------------------------------------------------------------------------------------------------------------------------
--------------------------------------------------------------------------------------------------------------------------------------------------------------------------------------------------------
--------------------------------------------------------------------------------------------------------------------------------------------------------------------------------------------------------
--------------------------------------------------------------------------------------B2C2C2BBC---------------------------------------------------------------------------------------------------------
-------------------------------------------------------------------------------------kgkgkggkgggg-------------------------------------------------------------------------------------------------------
-----------------------------------------------------------------------------------r--------------------------------------------------------------------------------------------------------------------
----------------------------------------------------------------------------%%%%%%%%-------------%%%%%%%%%%-------%%%%%%--------------------g-g-g-------------------------------------------------------
---------------------------------------gggggggk-----------------------------||||||||-------------||||||||||-------||||||--------------------------------------------------------------------------------
-------------------------------------r--XXXXXX------------------------------||||||||%%%%%%%%%%%%%||||||||||-------||||||---------%%%%%%%----------------------------------------------------------------
-------------------------%%%%%%%%%%%%%--XXXXXX-%%%%%%%%%%%%%%----%%%%%%%%%%%|||||||||||||||||||||||||||||||-----%%%%%%%%%%%------|||||||---------%%%%%%%-------------------------BB222B-----------------
-------------------------|||||||||||||--XXXXXX-||||||||||||||----||||||||||||||||||||||||||||||||||||||||||-----|||||||||||------|||||||---------|||||||----------------%%%%%---------------------------
-------------------------|||||||||||||%%%%%%%%%||||||||||||||----||||||||||||||||||||||||||||||||||||||||||-----|||||||||||----%%%%%%%%%%%%------|||||||----------------|||||---------------------------
------%%%%%--------------||||||||||||||||||||||||||||||||||||----||||||||||||||||||||||||||||||||||||||||||-----|||||||||||----||||||||||||------|||||||----------------|||||---------------------------
%%%%%%|||||%%%%%%%%%%%%%%||||||||||||||||||||||||||||||||||||----||||||||||||||||||||||||||||||||||||||||||-----|||||||||||----||||||||||||----%%%%%%%%%%%%%%%%%%%%---%%%%%%%%%%%%%%%%%%%%%%%%%%%%%%%F%%
