--------------------------------------------------------------------------------------------------------------------------------------------------------------------------------------------------------
--------------------------------------------------------------------------------------------------------------------------------------------------------------------------------------------------------
--------------------------------------------------------------------------------------------------------------------------------------------------------------------------------------------------------
--------------------------------------------------------------------------------------------------------------------------------------------------------------------------------------------------------
--------------------------------------------------------------------------------------------------------------------------------------------------------------------------------------------------------
--------------------------------------------------------------------------------------------------------------------------------------------------------------------------------------------------------
--------------------------------------------------------------------------------------------------------------------------------------------------------------------------------------------------------
--------------------------------------------------------------------------------------------------------------------------------------------------------------------------------------------------------
---------------------------------------------------------------------------------------------------------------------------------------------------------------------------------------r-k--------------
--------------------------------------------------------------------------------------------------------------------------------------------------------------------------------------------------------
-----------------------------------------------------------------------------------------------gkgggggggg---------------------SC2CSC--------------------------------------------------%%%%%%%%%%%%%%%F%%
----------------------------------------g-g--------------------------------------------------r--||||||||-----------%%%%%%%%----------------------------------SCCSSSU2-----------------|||||||||||||||%||
-------------------------------------------------------------------------------%%%%%--%%%%%%%%--||||||||-%%%%%%%%%%||||||||-g---g--k------------------------------------%%%%%%%%%%%%%%||||||||||||||||||
------------------------------%%%%%%%------------------------------------------|||||--||||||||--||||||||-||||||||||||||||||----------------%%%-------------r--------r---||||||||||||||||||||||||||||||||
------%%%%%-------------------|||||||------------------------------------------|||||--||||||||%%%%%%%%%%%||||||||||||||||||%%%%%%%%%%%-----|||--------------------------||||||||||||||||||||||||||||||||
XXXXXX|||||XXXXXXXXXXXXXX---XXXXXXXXXXXX-----XXXXXXXXXXXXX----XXXXXXXXXXXX---XXXXXXXXX||||||||||||||||||||||||||||||||||||||||||||||||-----|||----XXXXXXXXXXXXXXXXXXXXXX||||||||||||||||||||||||||||||||
