--------------------------------------------------------------------------------------------------------------------------------------------------------------------------------------------------------
--------------------------------------------------------------------------------------------------------------------------------------------------------------------------------------------------------
--------------------------------------------------------------------------------------------------------------------------------------------------------------------------------------------------------
--------------------------------------------------------------------------------------------------------------------------------------------------------------------------------------------------------
--------------------------------------------------------------------------------------------------------------------------------------------------------------------------------------------------------
--------------------------------------------------------------------------------------------------------------------------------------------------------------------------------------------------------
------------------------------------------------------------------------------------------------------ggkgggg--------------BBUB-------------------------------------------------------------------------
----------------------------------------------------------------------------------------------------r--XXXXX--------------------------------------------------------------------------------------------
--------------------------------------------------------------------------------------------%%%%%%%%%--XXXXX-%%%%%%%%%%%%-g-----g-----------------------------------------------------------------------
--------------------------------------------------------------------------------------------|||||||||--XXXXX-||||||||||||-------------------------g-g---------------------------------------------------
-----------------------------------------------U------------------------------------%%%%%%%%|||||||||%%%%%%%%||||||||||||%%%%%%%%%----g----------g------------------------------------------------------
---------------------------------------------------kkkgggkk------------------%%%%%--||||||||||||||||||||||||||||||||||||||||||||||--------------------------------%%%%%%%%%%%%--------------------------
-----------------------------------------------------%%%%--------------------|||||--||||||||||||||||||||||||||||||||||||||||||||||----%%%%%%%%%%%%----------------||||||||||||--------------------------
--------------------------g------g----g----------g---||||--%%%%%%%%%%%%%---%%%%%%%%%||||||||||||||||||||||||||||||||||||||||||||||----||||||||||||----------------||||||||||||--------------------------
------%%%%%------------------------------%%%%%%%%%%--||||--|||||||||||||---|||||||||||||||||||||||||||||||||||||||||||||||||||||||----||||||||||||----------------||||||||||||----%%%%%%%%%%------------
%%%%%%|||||%%%%%%%%%%%%%%----%%%%%%%%----||||||||||%%%%%%%%|||||||||||||---|||||||||||||||||||||||||||||||||||||||||||||||||||||||----||||||||||||-----%%%%%%%%%%%||||||||||||----||||||||||%%%%%%%%%F%%
