--------------------------------------------------------------------------------------------------------------------------------------------------------------------------------------------------------
--------------------------------------------------------------------------------------------------------------------------------------------------------------------------------------------------------
--------------------------------------------------------------------------------------------------------------------------------------------------------------------------------------------------------
--------------------------------------------------------------------------------------------------------------------------------------------------------------------------------------------------------
--------------------------------------------------------------------------------------------------------------------------------------------------------------------------------------------------------
--------------------------------------------------------------------------------------------------------------------------------------------------------------------------------------------------------
--------------------------------------------------------------------------------------------------------------------------------------------------------------------------------------------------------
--------------------------------------------------------------------------------------------------------------------------------------------------------------------------------------------------------
-----------------------------------------------------------------------------------------------------------------------------------------------------------------------------------g------g-------------
---------------------------------------------------------g----------------------------------------------------------------------------------------------------------------------------------------------
-----------------------------------------------------------------------------------------------U--------------------------------------------------------------------------------------------------------
--------------------------------------------------------%%%%%%%%%%%%%%-----------------------------kkgggkgkk--------------------------------gkggggggggg-------------%%%%%%%%%%%%%%----------------------
--------------------------------------------------------||||||||||||||-------------------------------%%%%%-----------------------------------%%%%%%%%%--------------||||||||||||||-----%%%%%%%----%%%F%%
-----------------------------g--g----g-------%%%%%%%----||||||||||||||-------------------------------|||||--%%%%%%%%%-----%%%%%%----------r--|||||||||-%%%%%%%%%%%%%||||||||||||||-----|||||||----|||X||
------%%%%%----------------------------------|||||||----||||||||||||||-----------------%%%%%%%%%%%%--|||||--|||||||||-----||||||---%%%%%%%%--|||||||||-|||||||||||||||||||||||||||-----|||||||----|||X||
%%%%%%|||||%%%%%%%%%%%%%%---%%%%%%%%%%%----%%%%%%%%%%%%%||||||||||||||---%%%%%%%%%%%%%%||||||||||||%%%%%%%%%|||||||||---%%%%%%%%%%%||||||||%%%%%%%%%%%%|||||||||||||||||||||||||||---%%%%%%%%%%%%%|||X||
