--------------------------------------------------------------------------------------------------------------------------------------------------------------------------------------------------------
--------------------------------------------------------------------------------------------------------------------------------------------------------------------------------------------------------
--------------------------------------------------------------------------------------------------------------------------------------------------------------------------------------------------------
--------------------------------------------------------------------------------------------------------------------------------------------------------------------------------------------------------
--------------------------------------------------------------------------------------------------------------------------------------------------------------------------------------------------------
--------------------------------------------------------------------------------------------------------------------------------------------------------------------------------------------------------
----------------------------------------------------------------------------------------------%%%%%%%-------SCU---------------------------------------%%%%%%--------------------------------------------
----------------------------------------------------------------------------------------------|||||||-------------------------------------------------||||||--------------------------------------------
----------------------------------------------------------------------------------------------|||||||-----gg--k---------------------r--k--------------||||||--------%%%%%-------------------------------
--------------------------------------------------------SUSCC--%%%%%%%%%%%%------------------%%%%||||--------------------------------------%%%%%%-----||||||--------|||||---r---------------------------
---------------------------------------------------------------||||||||||||-----%%%%%%%%----%%%%%%%%%%%%%%%%%%%%%%----------%%%%%%%%-------||||||---%%%%%%%%%%%-k--k|||||---k-----------%%%%%%%%%%%%%F%%
-------------------------------------------------C2USCC--------||||||||||||-----||||||||----||||||||||||||||||||||----------||||||||-------||||||---|||||||||||---%%%%%%%%%%%%%%%%%%%%%%|||||||||||||%||
--------------------------------%%%%%%%%-----------------------||||||||||||-----||||||||----||||||||||||||||||||||%%%%%%%%%%||||||||-------|%%%%%---|||||||||||---||||||||||||||||||||||||||||||||||||||
----------------------------g---||||||||-----------------------||||||||||||-----||||||||----||||||||||||||||||||||||||||||||||||||||-----%%%%%%%%%%%|||||||||||---||||||||||||||||||||||||||||||||||||||
------%%%%%---------------------||||||||-----------------------||||||||||||-----||||||||----||||||||||||||||||||||||||||||||||||||||-----||||||||||||||||||||||---||||||||||||||||||||||||||||||||||||||
XXXXXX|||||XXXXXXXXXXXXXX-----XXXXXXXXXXXXXXXXXXXXXXXXXXXXXXXXX||||||||||||-----||||||||----||||||||||||||||||||||||||||||||||||||||-----||||||||||||||||||||||---||||||||||||||||||||||||||||||||||||||
