--------------------------------------------------------------------------------------------------------------------------------------------------------------------------------------------------------
--------------------------------------------------------------------------------------------------------------------------------------------------------------------------------------------------------
--------------------------------------------------------------------------------------------------------------------------------------------------------------------------------------------------------
--------------------------------------------------------------------------------------------------------------------------------------------------------------------------------------------------------
----------------------------------------------------------------------------------------------------------------------------------------------------22BCCBU--%%%%%%%%%%%%%------------------------------
-------------------------------------------------------------------------------------------------------------------------------------------------------------|||||||||||||------------------------------
--------------------------------------------------------------------------------------------------------------------------------------------CCCUBB-----------|||||||||||||------------------------------
-------------------------------------------------------------------------------------------------------------------------------------------------------------|||||||||||||------------------------------
-----------------------------------------------------------------------------------------------------22CBC---------------------------------------------------|||||||||||||------------------------------
----------------------------------------------------------BBC---------------------------------------kkgggkkrk------------------------------------------------|||||||||||||------------------------------
-----------------------------------------------------g--------------------------------------------r------------------------%%%%%%%%%%%%%%%%%%%%%%%-----------|||||||||||||%%%%%%%%%%%%%%%%%%------------
-------------------------------------------------------------------------------------%%%%%%%%%%%%%%----------%%%%%%%%%%%%%%|||||||||||||||||||||||-----------|||||||||||||||||||||||||||||||%%%%%%%%%F%%
-------------------------------------------------------------------------------------||||||||||||||----------|||||||||||||||||||||||||||||||||||||-----------||||||||||||||||||||||||||||||||||||||||X||
--------------------------gg---g-----g---g%%%%%%---------%%%%%%---------g-g----------||||||||||||||%%%%%%%%%%|||||||||||||||||||||||||||||||||||||%%%%%%%%%%%||||||||||||||||||||||||||||||||||||||||X||
------%%%%%------------------------------X%%%|||---------||||||----------------------||||||||||||||||||||||||||||||||||||||||||||||||||||||||||||||||||||||||||||||||||||||||||||||||||||||||||||||||X||
%%%%%%|||||%%%%%%%%%%%%%%---%%%%%%%%---%%%%%%%%%%%%%---%%%%%%%%%%%-----%%%%%%%%%%%%%%||||||||||||||||||||||||||||||||||||||||||||||||||||||||||||||||||||||||||||||||||||||||||||||||||||||||||||||||X||
