--------------------------------------------------------------------------------------------------------------------------------------------------------------------------------------------------------
--------------------------------------------------------------------------------------------------------------------------------------------------------------------------------------------------------
--------------------------------------------------------------------------------------------------------------------------------------------------------------------------------------------------------
--------------------------------------------------------------------------------------------------------------------------------------------------------------------------------------------------------
--------------------------------------------------------------------------------------------------------------------------------------------------------------------------------------------------------
--------------------------------------------------------------------------------------------------------------------------------------------------------------------------------------------------------
--------------------------------------------------------------------------------------------------------------------------------------------------------------------------------------------------------
-----------------------------U--------------------------------------------------------------------------------------------------------------------------------------------------------------------------
------------------------------------CCCB2BCBB------------g-g-g------------------------------------------------------------------------------------------------------------------------------------------
--------------------------------------------------------------------------------------------------------------------------------------------------------------------------------------------------------
---------------------------------kgggggkggkgggg--------------------------------------------------------------------------------------------------------------------%%%%%%%%%%%%%%-----------------------
-------------------------%%%%%%%%---------------------------------------------------------------------------------------------------------------gggggggggk---------||||||||||||||-----------------------
-------------------------||||||||--------------%%%%%%%%%-----------------------------------%%%%%%------------------------------------------------%%%%%%%%----------||||||||||||||-gr-----k----%%%%%%%F%%
-------------------------||||||||--------------|||||||||------------------%%%--------------||||||--------------------g------g-----------------r--||||||||-%%%%%%%%%||||||||||||||-------------|||||||X||
------%%%%%--------------||||||||%%%%%%%%%%%%%%|||||||||---%%%%%%%%%%-----|||-------------%%%%%%%--------------------------------%%%%%%%%%%%%%%--||||||||-|||||||||||||||||||||||%%%%%%%%%%%%%|||||||X||
%%%%%%|||||%%%%%%%%%%%%%%|||||||||||||||||||||||||||||||---||||||||||-----|||----%%%%%%%%%%%%%%%%%%%%%%%%%%%%%%-----%%%%%%%%%%%%%||||||||||||||%%%%%%%%%%%|||||||||||||||||||||||||||||||||||||||||||X||
