--------------------------------------------------------------------------------------------------------------------------------------------------------------------------------------------------------
--------------------------------------------------------------------------------------------------------------------------------------------------------------------------------------------------------
--------------------------------------------------------------------------------------------------------------------------------------------------------------------------------------------------------
--------------------------------------------------------------------------------------------------------------------------------------------------------------------------------------------------------
-----------------------------------------------------------------------------------------------------------------------------------U--------------------------------------------------------------------
--------------------------------------------------------------------------------------------------------------------------------------------------------------------------------------------------------
-----------------------------------------------------------------------------------------------------------------------------------------%%%%----------------------------SUCSSCS-----SCSSSCC------------
---------------------------------------------------------------------------------------------------%%%%%%%-----%%%%%%%%----------------ggkrkrrr---------------------------------------------------------
---------------------------------------------------------------------------------------------------|||||||-----||||||||----%%%%%%%%%%%%--||||-----------------------------------------------------------
---------------------------------------------------------------------------SSSCU2-%%%%%%%%%%%------|||||||-----||||||||----||||||||||||--||||--%%%%%%%%%%%----------------------------------------------
----------------------------------------------------------------------------------|||||||||||------|||||||---%%%%%%%%%%%%%%||||||||||||--||||--|||||||||||%%%%%%%%%%%%%%%%%%%%%%%%%%%%%%%%%%%%%%%%%%%F%%
--------------------------------------------------------------------CSCUS---------|||||||||||----%%%%%%%%%%%%||||||||||||||||||||||||||%%%%%%%%||||||||||||||||||||||||||||||||||||||||||||||||||||||%||
-------------------------------------------------------%%%------------------------|||||||||||----|||||||||||||||||||||||||||||||||||||||||||||||||||||||||||||||||||||||||||||||||||||||||||||||||||||||
--------------------------gg----g----------g-g---g-----|%%%%%---------------------|||||||||||----|||||||||||||||||||||||||||||||||||||||||||||||||||||||||||||||||||||||||||||||||||||||||||||||||||||||
------%%%%%--------------------------------------------||||||---------------------|||||||||||----|||||||||||||||||||||||||||||||||||||||||||||||||||||||||||||||||||||||||||||||||||||||||||||||||||||||
XXXXXX|||||XXXXXXXXXXXXXX-----XXXXXXXX----XXXXXXXXX---XXXXXXXXXXXXXXXXXXXXXXXXXXXX|||||||||||----|||||||||||||||||||||||||||||||||||||||||||||||||||||||||||||||||||||||||||||||||||||||||||||||||||||||
