--------------------------------------------------------------------------------------------------------------------------------------------------------------------------------------------------------
--------------------------------------------------------------------------------------------------------------------------------------------------------------------------------------------------------
--------------------------------------------------------------------------------------------------------------------------------------------------------------------------------------------------------
--------------------------------------------------------------------------------------------------------------------------------------------------------------------------------------------------------
--------------------------------------------------------------------------------------------------------------------------------------------------------------------------------------------------------
--------------------------------------------------------------------------------------------------------------------------------------------------------------------------------------------------------
----------------------------------------------------------------------------------------------------------------------------------------------ggggggggggggg---------------------------------------------
--------------------------------------------------------------------------------------------------------------------------------------------r--XXXXXXXXXXX-----------------%%%%%%-----------------------
---------------------------------------------------------------------------------------------------------------------------------%%%%%%%%%%%%--XXXXXXXXXXX-%%%%%%%%%%------||||||-----------------------
------------------------------------------------------------------------------------------------ggkgkgkggkk----------------------||||||||||||--XXXXXXXXXXX-||||||||||------||||||-----------------------
----------------------------------------------------------------------------------------------r--XXXXXXXXX---------%%%%%%%%%%%%%%||||||||||||%%%%%%%%%%%%%%||||||||||----%%%%%%%%%%%%%%%%%%%------------
---------------------------------------------------------------------------------------%%%%%%%%--XXXXXXXXX-%%%%%%%%||||||||||||||||||||||||||||||||||||||||||||||||||----|||||||||||||||||||%%%%%%%%%F%%
---------------------------------------------------------------------------------%%%%%-||||||||--XXXXXXXXX-||||||||||||||||||||||||||||||||||||||||||||||||||||||||||----||||||||||||||||||||||||||||X||
--------------------------g----%%%%g%%%-----g---------------g---g-----tt---------|||||-||||||||%%%%%%%%%%%%||||||||||||||||||||||||||||||||||||||||||||||||||||||||||----||||||||||||||||||||||||||||X||
------%%%%%--------------------||||X|||-------------------------------tt---------|||||-||||||||||||||||||||||||||||||||||||||||||||||||||||||||||||||||||||||||||||||----||||||||||||||||||||||||||||X||
%%%%%%|||||%%%%%%%%%%%%%%----%%%%%%%%%%%%%%----%%%%%%%%%%%%-----%%%%%%%%%%%%---%%%%%%%%||||||||||||||||||||||||||||||||||||||||||||||||||||||||||||||||||||||||||||||----||||||||||||||||||||||||||||X||
