--------------------------------------------------------------------------------------------------------------------------------------------------------------------------------------------------------
--------------------------------------------------------------------------------------------------------------------------------------------------------------------------------------------------------
--------------------------------------------------------------------------------------------------------------------------------------------------------------------------------------------------------
--------------------------------------------------------------------------------------------------------------------------------------------------------------------------------------------------------
--------------------------------------------------------------------------------------------------------------------------------------------------------------------------------------------------------
--------------------------------------------------------------------------------------------------------------------------------------------------------------------------------------------------------
------------------------------------------------------------------------------------------------------------------------------------S2SCS2----SSCSS-----------------------------------------------------
----------------------------------------------------------------------------------------------------------------------------%%%%%--------------------------------------%%%%%----------------------------
----------------------------------------------------------------------------------------------------------------------------|||||-----------g----------------g---gg----|||||----------------------------
--------------------------------------------------------gg------------------------------------------------------------------|||||--------------------------------------|||||----------------------------
--------------------------------------CSCS--------------------------------------------------------------------------------%%%%%%%%%%%%%%%%%%%%%%%%%%%g--%%%%%%%%%%---%%%%%%%%%--------------------------
-------------------------------------kgkgggg-----------------------------------------gkgggggggkk-----------------gg-g-----|||||||||||||||||||||||||||---||||||||||---|||||||||---%%%%%%%%%%%------------
-----------------------------------r--------------------------------------------------------------------------------------|||||||||||||||||||||||||||---||||||||||---|||||||||---|||||||||||------------
-------------------------%%%%%%%%%%%--------%%%%%%%%%%%-------%%%%%%---------------r------------%%%%%%%%%%%%%---%%%%%%%%%%|||||||||||||||||||||||||||---||||||||||---|||||||||---|||||||||||------------
------%%%%%--------------|||||||||||--------|||||||||||-------||||||--%%%%%%%%%%%%%%------------|||||||||||||---|||||||||||||||||||||||||||||||||||||---||||||||||---|||||||||---|||||||||||------------
XXXXXX|||||XXXXXXXXXXXXXX|||||||||||XXXXXXXX|||||||||||-----XXXXXXXXXX||||||||||||||XXXXXXXXXXXX|||||||||||||---|||||||||||||||||||||||||||||||||||||---||||||||||---|||||||||---|||||||||||XXXXXXXXXFXX
