--------------------------------------------------------------------------------------------------------------------------------------------------------------------------------------------------------
--------------------------------------------------------------------------------------------------------------------------------------------------------------------------------------------------------
--------------------------------------------------------------------------------------------------------------------------------------------------------------------------------------------------------
--------------------------------------------------------------------------------------------------------------------------------------------------------------------------------------------------------
--------------------------------------------------------------------------------------------------------------------------------------------------------------------------------------------------------
--------------------------------------------------------------------------------------------------------------------------------------------------------------------------------------------------------
--------------------------------------------------------------------------------------------------------------------------------------------------------------------------------------------------------
--------------------------------------------------------------------------------------------------------------------------------------------------------------------------------------------------------
-----------------------------------------------------------------------------------------------------------BCCUB2--%%%%%%%%%%---------------------------------------------------------------------------
-------------------------------------------------------------------------------------------------------------------||||||||||---------------------------------------------------------------------------
----------------------------------------------------------------------------------------------------CBBCU----------||||||||||---------------------------------------------------------------------------
--------------------------------------kggkgggkkkg--------------------------g---------------------------------------||||||||||-----%%%%%%%%%%%%%---------------------------------------------------------
---------------------------------------%%%%%%%%%---------------------tt--------------------------------------------||||||||||-----|||||||||||||---------------------------g----r------%%%%%-------------
------------------------------------r--|||||||||-%%%%%%%%%%----------tt--------------------------------------------||||||||||-----|||||||||||||------------%%%%%%%%%%%%%%------------%%%%%%-------------
------%%%%%--------------%%%%%%%%%%%%--|||||||||-||||||||||----------tt---------------------%%%%%%%%%%%%%----------||||||||||-----|||||||||||||-----%%%----||||||||||||||%%%%%%%%%%--||||||-------------
%%%%%%|||||%%%%%%%%%%%%%%||||||||||||%%%%%%%%%%%%||||||||||-----%%%%%%%%%%-----%%%%%%%%%%%%%|||||||||||||%%%%%%%%%%||||||||||-----|||||||||||||-----|||----||||||||||||||||||||||||%%%%%%%%%%%%%%%%%%F%%
