--------------------------------------------------------------------------------------------------------------------------------------------------------------------------------------------------------
--------------------------------------------------------------------------------------------------------------------------------------------------------------------------------------------------------
--------------------------------------------------------------------------------------------------------------------------------------------------------------------------------------------------------
--------------------------------------------------------------------------------------------------------------------------------------------------------------------------------------------------------
--------------------------------------------------------------------------------------------------------------------------------------------------------------------------------------------------------
--------------------------------------------------------------------------------------------------------------------------------------------------------------------------------------------------------
--------------------------------------------------------------------------------------------------------------------------------------------------------------------------------------------------------
----------------------------------------------------------------------------------------------------------------------------------------------------------BCCB------------------------------------------
--------------------------------------------------------------------------------------------------------------------------------------------------------------------------------------------------------
--------------------------------------------------------------------------------------------------------------------------------------------------------------------------------------------------------
---------------------------------------------------kggggggkkgk-------------------------------------kgggggggggggg----------------------------------------------------------------------------------------
-------------------------------------------------r--XXXXXXXXX------------------------------------r--XXXXXXXXXXX------------------------------------------%%%%%%-----------------------------------------
-----------------------------------------%%%%%%%%%--XXXXXXXXX-%%%%%%%%%%------%%%%%-%%%%%%%%%%%%%%--XXXXXXXXXXX-%%%%%%%%%-----%%%%%%%%-------------------||||||----%%%%%%%------------------------------
-----------------------------------------|||||||||--XXXXXXXXX-||||||||||------|||||-||||||||||||||--XXXXXXXXXXX-|||||||||-----|%%%%%%|--------------g----||||||----|||||||---------%%%%%%%%-------------
------%%%%%------------------------------|||||||||%%%%%%%%%%%%||||||||||----%%%%%%%%||||||||||||||%%%%%%%%%%%%%%|||||||||---%%%%%%%%%%%%%%---------------||||||----|||||||---------||||||||----%%%%%%F%%
%%%%%%|||||%%%%%%%%%%%%%%-----%%%%%%%%%%%|||||||||||||||||||||||||||||||----|||||||||||||||||||||||||||||||||||||||||||||---||||||||||||||%%%%%%%%%----%%%%%%%%%%%%%%%%%%%%%%%---%%%%%%%%%%%%%%||||||X||
