--------------------------------------------------------------------------------------------------------------------------------------------------------------------------------------------------------
--------------------------------------------------------------------------------------------------------------------------------------------------------------------------------------------------------
--------------------------------------------------------------------------------------------------------------------------------------------------------------------------------------------------------
--------------------------------------------------------------------------------------------------------------------------------------------------------------------------------------------------------
--------------------------------------------------------------------------------------------------------------------------------------------------------------------------------------------------------
--------------------------------------------------------------------------------------------------------------------------------------------------------------------------------------------------------
--------------------------------------------------------------------------------------------------------------------------------------------------------------------------------------------------------
--------------------------------------------------------------------------------------------------------------------------------------------------------------------------------------------------------
--------------------------------------------------------------------------------------------------------------------------------------------------------------------------%%%%%----%%%%%%---------------
--------------------------------------------------------------------------------------------------------g-----------------------------------------------------------------|||||----|%%%%|---------------
--------------------------------------------------------------------------------------------------------------------------------------------------------------------------|||||----||||||---------------
------------------------------------U---gkgkgkggggkgg-----------------------------------ggkgggg-----------------------------SSSS------------------SCSUCC------------------|||||--%%%%%%%%%%-------------
--------------------------------------------------------------------------------------r--|||||--------------------------------------------------------------------------%%%%%%%%%||||||||||-------------
------------------------------------------%%%%%%%%%--%%%%%%%%%%%%--------------%%%%%%%%--|||||-%%%%%%%%%-----------------------------------------gg-----------g--r------|||||||||||||||||||%%%%%%%%%%F%%
------%%%%%-------------------------------|||||||||--||||||||||||--------------||||||||--|||||-|||||||||----------------------------------------------------------------|||||||||||||||||||||||||||||%||
XXXXXX|||||XXXXXXXXXXXXXX----XXXXXXXXXXXXXXXXXXXXXXXX||||||||||||----XXXXXXXXXX||||||||XXXXXXXX|||||||||-----XXXXXXXXXXXXXXXXXXXXXX-----XXXXXXXXXXXXXXXXXXX---XXXXXXXXXX||||||||||||||||||||||||||||||||
