--------------------------------------------------------------------------------------------------------------------------------------------------------------------------------------------------------
--------------------------------------------------------------------------------------------------------------------------------------------------------------------------------------------------------
--------------------------------------------------------------------------------------------------------------------------------------------------------------------------------------------------------
--------------------------------------------------------------------------------------------------------------------------------------------------------------------------------------------------------
--------------------------------------------------------------------------------------------------------------------------------------------------------------------------------------------------------
--------------------------------------------------------------------------------------------------------------------------------------------------------------------------------------------------------
--------------------------------------------------------------------------------------------------------------------------------------------------------------------------------------------------------
--------------------------------------------------------------------------------------------------------------------------------------------------------------------------------------------------------
----------------------------------------------------------------------------------------U---------------------------------------------------------------------------------------------------------------
------------------------------------------------------gggkgkgggggg------------------------------SS----------------------------%%%%%-----------------ggg-------------------------------------------------
----------------------------------------------------r--||||||||||-------------------------------------------------------------|||||-------------------------------g-g------------------%%%%%%%----%%%F%%
-----------------------------------------%%%%%%%%%%%%--||||||||||-%%%%%%%%%-----------------ggkkgkkgg----------%%%%%%%%%%-----|||||----------------------------------------------------|||||||----|||%||
-----------------------------------------||||||||||||--||||||||||-|||||||||---%%%%%%%%%%%%%%-------------------||||||||||-----|||||------------------------------%%%%%%%%%-------------|||||||----||||||
-------------------------------gg-------g||||||||||||%%%%%%%%%%%%%|||||||||---||||||||||||||---------%%%%%%%%%%||||||||||---%%%%%%%%-----------------------------|||||||||-----%%%%%-%%%%%%%%%%%%%||||||
------%%%%%------------------------------||||||||||||||||||||||||||||||||||---||||||||||||||---------||||||||||||||||||||---||||||||---%%%%%%%%%%%%--------------|||||||||-----|||||-|||||||||||||||||||
XXXXXX|||||XXXXXXXXXXXXXX-----XXXXXXXXXXX||||||||||||||||||||||||||||||||||---||||||||||||||XXXXXXXXX||||||||||||||||||||---||||||||---||||||||||||---XXXXXXXXXXX|||||||||---XXXXXXXX|||||||||||||||||||
