--------------------------------------------------------------------------------------------------------------------------------------------------------------------------------------------------------
--------------------------------------------------------------------------------------------------------------------------------------------------------------------------------------------------------
--------------------------------------------------------------------------------------------------------------------------------------------------------------------------------------------------------
--------------------------------------------------------------------------------------------------------------------------------------------------------------------------------------------------------
--------------------------------------------------------------------------------------------------------------------------------------------------------------------------------------------------------
--------------------------------------------------------------------------------------------------------------------------------------------------------------------------------------------------------
--------------------------------------------------------------------------------------------------------------------------------------------------------------------------------%%%%%%%%----------------
---------------------------------------------------------------------------------------------------------------------------U----------------------------------------------------|%%%%%%|----------------
-----------------------------------------------------------------------------------------------------------------------------------CSCS-------------------------%%%%%%%---------||||||||----------------
---------------------------------------------------------------------------------------------------------------------------------------------------------------%%%%||||---------||||||||----------------
-------------------------------------------------------------------------------------------------------------------------------gggkkkggggg--------------------%%%%%%%%%%%%%---%%%%%%%%%%%%%%%%%%%%%%%F%%
----------------------------------------------------------------------kggkkggggg----------------%%%%%%%-------------%%%%%%%%%%%---------------------%%%%%%%%%%|||||||||||||---|||||||||||||||||||||||%||
--------------------------------------------------------------------r--||||||||-----------------|||||||-------------|||||||||||-----------%%%%%%%%%%|||||||||||||||||||||||---||||||||||||||||||||||||||
------------------------------gg-------------------------%%%%%%%%%%%%--||||||||-%%%%%%%%%-------|||||||-------------|||||||||||-----------|||||||||||||||||||||||||||||||||---||||||||||||||||||||||||||
------%%%%%----------------------------------------------||||||||||||--||||||||-|||||||||------XXXXX|||-------------|||||||||||%%%%%%%%%%%|||||||||||||||||||||||||||||||||---||||||||||||||||||||||||||
XXXXXX|||||XXXXXXXXXXXXXX----XXXXXXXXX-----XXXXXXXXXXXXXX||||||||||||XXXXXXXXXXX|||||||||-----XXXXXXXXXXXXXXXXXXXXXX|||||||||||||||||||||||||||||||||||||||||||||||||||||||---||||||||||||||||||||||||||
