--------------------------------------------------------------------------------------------------------------------------------------------------------------------------------------------------------
--------------------------------------------------------------------------------------------------------------------------------------------------------------------------------------------------------
--------------------------------------------------------------------------------------------------------------------------------------------------------------------------------------------------------
--------------------------------------------------------------------------------------------------------------------------------------------------------------------------------------------------------
--------------------------------------------------------------------------------------------------------------------------------------------------------------------------------------------------------
--------------------------------------------------------------------------------------------------------------------------------------------------------------------------------------------------------
--------------------------------------------------------------------------------------------------------------------------------------------------------------------------------------------------------
--------------------------------------------------------------------------------------------------------------------------------------------------------------------------------------------------------
-------------------------------------------------------------------------------------------------------------------------------------------------------------------------------------gg-----------------
------------------------------------------------------------------------------------------g----g-g--------------------------------------------------CBCCB2----------------------------------------------
-------------------------------------------------------------------------gg----%g%%%%%-------------------------------------------------------------ggggggggg--------------%%%%%%%%%%--------------------
--------------------------------------------------U---kkkkkkgkg----------------|X|||||----------%%%%%%%%-----------------------------------------g------------------------||||||||||--------------------
------------------------------------------------------------------------------%%%|||||----------||||||||--------------------------g-------%%%%%%%%----------%%%%%%%%%%%%%%||||||||||--------------------
--------------------------------------------------------%%%%%--%%%%%%%%%------||||||||----------||||||||----------------------------------||||||||----------||||||||||||||||||||||||-----%%%%%%%%%%%%F%%
------%%%%%---------------------------------------------|||||--|||||||||-----%%%%%%%%%%%%-------||||||||-------------------------%%%%%%%%%||||||||%%%%%%%%%%||||||||||||||||||||||||-----||||||||||||X||
%%%%%%|||||%%%%%%%%%%%%%%-----%%%%%%%%%%-----%%%%%%%%%%%%%%%%%%|||||||||-----||||||||||||-----%%%%%%%%%%%%%%%%%%%%%%%-----%%%----|||||||||||||||||||||||||||||||||||||||||||||||||||-----||||||||||||X||
