--------------------------------------------------------------------------------------------------------------------------------------------------------------------------------------------------------
--------------------------------------------------------------------------------------------------------------------------------------------------------------------------------------------------------
--------------------------------------------------------------------------------------------------------------------------------------------------------------------------------------------------------
--------------------------------------------------------------------------------------------------------------------------------------------------------------------------------------------------------
--------------------------------------------------------------------------------------------------------------------------------------------------------------------------------------------------------
--------------------------------------------------------------------------------------------------------------------------------------------------------------------------------------------------------
--------------------------------------------------------------------------------------------------------------------------------------------------------------------------------222BC2B2C---------------
--------------------------------------------------------------------------------------------------------------------------------------------------------------------------------------------------------
----------------------------------------------------------------------------------------------------------------------------------------------------------------------------------------g---------------
--------------------------g-----------------------------------------------------------------------------g--g-----g-------------------------U------------------------------------------------------------
--------------------------------g------------------------------------------------------------------------------------------------------------------------------------%%%%%%%%%%%%%%%%%%%%%%-------------
-------------------------------------------------------------------------------gggkggggkgk-----------------------------------------------------ggggkggkgk------------||||||||||||||||||||||-------------
------------------------------%%%%%----------------------%%%%%%-----------------%%%%%%%%%-------------------%%%%%%%------------------------------XXXXXX--------------||||||||||||||||||||||%%%%%%%%%%F%%
-----------------------------%%%|||--------gg--------gg--||||||--------------r--|||||||||-%%%%%%%%%%%%%----%%%%||||---%%%%%%%%%-----%%%%%%%%%%%--XXXXXX--%%%%%%%%%%%%||||||||||||||||||||||||||||||||X||
------%%%%%------------------||||||----------------------||||||---%%%%%%%%%%%%--|||||||||-|||||||||||||----||||||||---|||||||||-----|||||||||||--XXXXXX--||||||||||||||||||||||||||||||||||||||||||||X||
%%%%%%|||||%%%%%%%%%%%%%%---%%%%%%%%%-----%%%%%%%%-----%%%%%%%%%%%||||||||||||%%%%%%%%%%%%|||||||||||||---%%%%%%%%%%%%|||||||||-----|||||||||||%%%%%%%%%%||||||||||||||||||||||||||||||||||||||||||||X||
