--------------------------------------------------------------------------------------------------------------------------------------------------------------------------------------------------------
--------------------------------------------------------------------------------------------------------------------------------------------------------------------------------------------------------
--------------------------------------------------------------------------------------------------------------------------------------------------------------------------------------------------------
--------------------------------------------------------------------------------------------------------------------------------------------------------------------------------------------------------
--------------------------------------------------------------------------------------------------------------------------------------------------------------------------------------------------------
--------------------------------------------------------------------------------------------------------------------------------------------------------------------------------------------------------
--------------------------------------------------------------------------------------------------------------------------------------------------------------------------------------------------------
--------------------------------------------------------------------------------------------------------------------------------------------------------------------------------------------------------
--------------------------------------------------------------------------------------------------------------------------------------------------------------------------------------------------------
-------------------------------------------------------------------------------------------------------------------------------------U------------------------------------------------g------gg---------
----------------------------------------------------------------------------g----------------------------------------------------------------CSC----------------tt-----%%%%%%%%%%%%%%-------------------
-------------------------------%%%%%%%%---------------gggkkgkggggkk--------------%%%-------------------g---------------------------------gggggggkg--------------tt-----||||||||||||||---%%%%%%%%%%%%%F%%
---------------------------g---||||||||-------------r--|||||||||||---------------|%%%%%%------------------------------------------------------------------%%%%%%%%%%%%%||||||||||||||---|||||||||||||%||
-------------------------------||||||||----%%%%%%%%%%--|||||||||||-%%%%%%%%------|||||||-------%%%----%%%%%%%%-------------------%%%%%%%%---------%%%%%%%%|||||||||||||||||||||||||||---||||||||||||||||
------%%%%%--------------------||||||||----||||||||||--|||||||||||-||||||||------|||||||-------|||----||||||||-----%%%%%%%%%%%%%%||||||||---------|||||||||||||||||||||||||||||||||||---||||||||||||||||
XXXXXX|||||XXXXXXXXXXXXXX----XXXXXXXXXXXXXX||||||||||XXXXXXXXXXXXXX||||||||-----XXXXXXXXXX-----|||----||||||||-----||||||||||||||||||||||XXXXXXXXX|||||||||||||||||||||||||||||||||||---||||||||||||||||
