--------------------------------------------------------------------------------------------------------------------------------------------------------------------------------------------------------
--------------------------------------------------------------------------------------------------------------------------------------------------------------------------------------------------------
--------------------------------------------------------------------------------------------------------------------------------------------------------------------------------------------------------
--------------------------------------------------------------------------------------------------------------------------------------------------------------------------------------------------------
--------------------------------------------------------------------------------------------------------------------------------------------------------------------------------------------------------
--------------------------------------------------------------------------------------------------------------------------------------------------------------------------------------------------------
--------------------------------------------------------------------------------------------------------------------------------------------------------------------------------------------------------
------------------------------------------------------------------------------------------------------------------------------------------------------tt------------------------------%%%%%%------------
------------------------------------------------------------------------------------------------------------------------------------------------------tt-----------k------------------||||||------------
-------------------------------------------------------g---------------------------------------------------------------------UCC22C-%%%%%%%%%%%%%%----tt------------------------------||||||------------
----------------------------------kggggkg-------------------------------------------------------------------------------------------||||||||||||||%%%%%%%%%%%%%%%%---%%%%%%%%%%-------||||||--%%%%%%%F%%
--------------------------------r--|||||------------------------Tt-----k------r----------------------------------------S2CSU--------||||||||||||||||||||||||||||||---||||||||||-----%%%%%%%%%%|||||||%||
-------------------------%%%%%%%%--|||||-%%%%%%%%%%%%%----------tt----------------------k-------------------------------------------||||||||||||||||||||||||||||||---||||||||||-----||||||||||||||||||||
-------------------------||||||||--|||||-|||||||||||||-----%%%%%%%%%%%-----%%%%%%%%-------------------------------------------------||||||||||||||||||||||||||||||---||||||||||-----||||||||||||||||||||
------%%%%%--------------||||||||%%%%%%%%|||||||||||||-----|||||||||||-----||||||||-----------------%%%%%%%%%%%---------------------||||||||||||||||||||||||||||||---||||||||||-----||||||||||||||||||||
XXXXXX|||||XXXXXXXXXXXXXX|||||||||||||||||||||||||||||-----|||||||||||---XXXXXXXXXXXXXX----XXXXXXXXX|||||||||||XXXXXXXXXXXXXXXXXXXXX||||||||||||||||||||||||||||||---||||||||||-----||||||||||||||||||||
