--------------------------------------------------------------------------------------------------------------------------------------------------------------------------------------------------------
--------------------------------------------------------------------------------------------------------------------------------------------------------------------------------------------------------
--------------------------------------------------------------------------------------------------------------------------------------------------------------------------------------------------------
--------------------------------------------------------------------------------------------------------------------------------------------------------------------------------------------------------
--------------------------------------------------------------------------------------------------------------------------------------------------------------------------------------------------------
--------------------------------------------------------------------------------------------------------------------------------------------------------------------------------------------------------
--------------------------------------------------------------------------------------------------------------------------------------------------------------------------------------------------------
--------------------------------------------------------------------------------------------------------------------------------------------------------------------------------------------------------
-------------------------------------------------------------------------------------------------------------------------------tt----------%%%%%--------------------------------------------------------
-----------------------------------------------------------------------------------------g-------------------------------------tt----------|||||--------------------------------------------------------
-----------------------------------------------------------------------gkggggg--------------------------------------------%%%%%%%%%%-------|||||--------------------------------------------------------
---------------------------------------------------g-----------------r--|||||---------------------U---gkggkggkg-----------||||||||||-gg---%%|g||------------------SCU-----------------------------------
---------------------------------------------------------%%%%%%%%%%%%%--|||||-%%%%%%%%%%----------------------------------||||||||||-----%%%%%%%%%--------------------------------r---k-%%%%%%%---------
----------------------------------------------g--%%%%%%--|||||||||||||--|||||-||||||||||----------------%%%%%--%%%%%%%%%%%||||||||||-----|||||||||-g------------------------------------|||||||---------
------%%%%%--------------------------------------||||||--|||||||||||||%%%%%%%%||||||||||----------------|||||--|||||||||||||||||||||-----|||||||||--------------------------------------|||||||---%%%F%%
XXXXXX|||||XXXXXXXXXXXXXX-----XXXXXXXXXXXXXX---XXXXXXXXXX|||||||||||||||||||||||||||||||----XXXXXXXXXXXXXXXXXXX|||||||||||||||||||||-----|||||||||XXXXXXXXXXXXXXXXXXXXXXXXXXXXXXX-----XXXXXXXXXXXX|||X||
