--------------------------------------------------------------------------------------------------------------------------------------------------------------------------------------------------------
--------------------------------------------------------------------------------------------------------------------------------------------------------------------------------------------------------
--------------------------------------------------------------------------------------------------------------------------------------------------------------------------------------------------------
--------------------------------------------------------------------------------------------------------------------------------------------------------------------------------------------------------
--------------------------------------------------------------------------------------------------------------------------------------------------------------------------------------------------------
--------------------------------------------------------------------------------------------------------------------------------------------------------------------------------------------------------
--------------------------------------------------------------------------------------------------------------------------------------------------------------------------------------------------------
---------------------------------U----------------------------------------------------------------------------------------------------------------------------------------------------------------------
------------------------------------------------------------g---------------------------------------------------------------------------------------2BBBB---------------------Tt---------kt-------------
---------------------------------------%%%%%%%----------------------------------------------------------------------BBB---------------------------ggkgggkggg------------------tt---------tt-------------
-------------------------------------ggggkgkgggk--------------------tt--------------------------------------------------------------------------r-----------------------%%%%%%%%%%%%%%%%%%%%%%%---------
-------------------------%%%%%%%%%%%%--XXXXXXX----------------------tt-------------------------------------------------------------------%%%%%%%%-----------%%%%%%%%%%%%|||||||||||||||||||||||%%%%%%F%%
-------------------------||||||||||||--XXXXXXX--%%%%%%%%%%%---%%%%%%%%%%%%---------------------------------------------------------------||||||||-----------|||||||||||||||||||||||||||||||||||||||||X||
-------------------------||||||||||||--XXXXXXX--|||||||||||---||||||||||||----------------------------------------%%%%%%%----%%%%%%%%%%%%||||||||%%%%%%%%%%%|||||||||||||||||||||||||||||||||||||||||X||
------%%%%%--------------||||||||||||%%%%%%%%%%%|||||||||||---||||||||||||-----%%%%%%%%%%-------------------------|||||||----||||||||||||||||||||||||||||||||||||||||||||||||||||||||||||||||||||||||X||
%%%%%%|||||%%%%%%%%%%%%%%||||||||||||||||||||||||||||||||||---||||||||||||-----||||||||||----%%%%%%%%%%%%%%-----%%%%%%%%%%%%%||||||||||||||||||||||||||||||||||||||||||||||||||||||||||||||||||||||||X||
