--------------------------------------------------------------------------------------------------------------------------------------------------------------------------------------------------------
--------------------------------------------------------------------------------------------------------------------------------------------------------------------------------------------------------
--------------------------------------------------------------------------------------------------------------------------------------------------------------------------------------------------------
--------------------------------------------------------------------------------------------------------------------------------------------------------------------------------------------------------
--------------------------------------------------------------------------------------------------------------------------------------------------------------------------------------------------------
--------------------------------------------------------------------------------------------------------------------------------------------------------------------------------------------------------
-----------------------------------------------------------g--------------------------------------------------------------------------------------------------------------------------------------------
--------------------------------------------------------------------------------------------------------------------------------------------------------------------------------------------------------
-----------------------------------S2SCCS-----------g----%%%%%%---------------------------CCSUSC--%%%%%%%%%%%%%----gg-g---------------------------------------------------------------------------------
----------------------------------gggkkgggg--------------||||||---g-------------------------------|||||||||||||-----------------------------------------------------------------------------------------
--------------------------------r------------------------||||||----------------------CCUSS--------|||||||||||||---%%%%%%%%------%%%%%-----------------------------------------k------kr-----------------
-------------------------%%%%%%%%----------%%%%%%%%----%%%%%%%%%%---------------------------------|||||||||||||---||||||||------|||||-------------------%%%%%%%%------SCUSC-----------------------------
-------------------------||||||||----------||||||||----||||||||||---%%%%%%%%%---------------------|||||||||||||---||||||||------|||||-------------------||||||||----------------------------------------
-------------------------||||||||%%%%%%%%%%||||||||----||||||||||---|||||||||---------------------|||||||||||||---||||||||----%%%%%%%%%-----------------||||||||-----------------------r----------------
------%%%%%--------------||||||||||||||||||||||||||----||||||||||---|||||||||%%%%%%%%%%%%%%%%%%%%%|||||||||||||---||||||||----|||||||||%%%%%%%%%%-------||||||||----------------------------------------
XXXXXX|||||XXXXXXXXXXXXXX||||||||||||||||||||||||||----||||||||||---|||||||||||||||||||||||||||||||||||||||||||---||||||||----|||||||||||||||||||-----XXXXXXXXXXXXXXXXXXXXXXX----XXXXXXXXXXXXXXXXXXXXFXX
