--------------------------------------------------------------------------------------------------------------------------------------------------------------------------------------------------------
--------------------------------------------------------------------------------------------------------------------------------------------------------------------------------------------------------
--------------------------------------------------------------------------------------------------------------------------------------------------------------------------------------------------------
--------------------------------------------------------------------------------------------------------------------------------------------------------------------------------------------------------
--------------------------------------------------------------------------------------------------------------------------------------------------------------------------------------------------------
--------------------------------------------------------------------------------------------------------------------------------------------------------------------------------------------------------
--------------------------------------------------------------------------------------------------------------------------------------------------------------------------------------------------------
--------------------------------------------------------------------------------------------------------------------------------------------------------------------------------------------------------
--------------------------------------------------------------------------------------------------------------------------------------------------------------------------------------------------------
--------------------------------------------------------------------------------------------------------------------------------------------------------------------------------------------------------
------------------------------------------------------------------------g----------g---------------U----------------------------------------------------------------------------------------------------
------------------------------%%%%%%-----------------gggkggggkg----------------------------------------gggggggk----------------------------------------------------------------------U2BBCBB---%%%%%%F%%
--------------------------g---||||||---------------------------------------------------------------------%%%%-------------%%%%%%%%%%%%---------------------------------------------------------||||||X||
-----------------------------%%%||||---------------r-----------%%%%%%%%-----%%%%%%%%%--------------------||||--%%%%%%%%%%%||||||||||||-g-----g--kk---------------k-----%%%%%%%%----------------||||||X||
------%%%%%------------------|||||||--%%%%%%%%%%%%%%-----------||||||||-----|||||||||-----%%%%%%%%%%%%%--||||--|||||||||||||||||||||||---------------------------------||||||||----------------||||||X||
%%%%%%|||||%%%%%%%%%%%%%%---%%%%%%%%%%||||||||||||||%%%%%%%%%%%||||||||-----|||||||||-----|||||||||||||%%%%%%%%|||||||||||||||||||||||%%%%%%%%%%%----%%%%%%%%%%%-----%%%%%%%%%%%%%%%%%%%%%%%%%%||||||X||
