--------------------------------------------------------------------------------------------------------------------------------------------------------------------------------------------------------
--------------------------------------------------------------------------------------------------------------------------------------------------------------------------------------------------------
--------------------------------------------------------------------------------------------------------------------------------------------------------------------------------------------------------
--------------------------------------------------------------------------------------------------------------------------------------------------------------------------------------------------------
--------------------------------------------------------------------------------------------------------------------------------------------------------------------------------------------------------
--------------------------------------------------------------------------------------------------------------------------------------------------------------------------------------------------------
--------------------------------------------------------------------------------kggkgkgkgggg------------------------------------------------------------------------------------------------------------
------------------------------------------------------------------------------r--XXXXXXXXXX-------------------------------------------------------------------------------------------------------------
-------------------------------------------------------------------%%%%%%%%%%%%--XXXXXXXXXX-%%%%%%%%%-g-------------------------------------------------------------------------------------------------
-------------------------------------BBUBBB2--%%%%%%%%-------------||||||||||||--XXXXXXXXXX-|||||||||---------------------------------------------------------------------------------------------------
----------------------------------------------||||||||-----%%%%%%%%||||||||||||%%%%%%%%%%%%%|||||||||---%%%%%%%%%%---------------------------------------------------------------------r-------%%%%%%F%%
-------------------------------BC2U-----------||||||||-----||||||||||||||||||||||||||||||||||||||||||---||||||||||-----------------------------------------------------------------------------||||||X||
----------------------------------------------||||||||-----||||||||||||||||||||||||||||||||||||||||||---||||||||||------g-------------------------------------------------------------%%%%%%%%%||||||X||
----------------------------------------------||||||||-----||||||||||||||||||||||||||||||||||||||||||---||||||||||-------------------------------------------------g------k-----------|||||||||||||||X||
------%%%%%-----------------------------------||||||||-----||||||||||||||||||||||||||||||||||||||||||---||||||||||-----%%%%%%%%%------------------------------------------------------|||||||||||||||X||
%%%%%%|||||%%%%%%%%%%%%%%%%%%%%%%%%%%%%%%%%%%%||||||||-----||||||||||||||||||||||||||||||||||||||||||---||||||||||-----|||||||||---%%%%%%%%-----%%%----%%%%%%%%---%%%%%%%%----%%%%%%%%|||||||||||||||X||
