--------------------------------------------------------------------------------------------------------------------------------------------------------------------------------------------------------
--------------------------------------------------------------------------------------------------------------------------------------------------------------------------------------------------------
--------------------------------------------------------------------------------------------------------------------------------------------------------------------------------------------------------
--------------------------------------------------------------------------------------------------------------------------------------------------------------------------------------------------------
-------------------------------------------------------------------------------------------------------------U------------------------------------------------------------------------------------------
---------------------------------------------------------------------------------------------------------------------S2CSS2S----------------------------------------------------------------------------
----------------------------------------2U2SCS-%%%%%%%%%%%----------------------------------%%%%--------------------------------------------------------------------------------------------------------
-----------------------------------------------|||||||||||-------%%%%%%---------------------||||-----------------ggkkggggkkgggg-------------------------------------------------------------------------
--------------------------------S2SUSSS--------|||||||||||-------||||||----gg--g-%%%%%--g---|%%%%%%--%%%%%%%%%%%%-------------------------gg-----g--------g--------gk-----------------------------------
-----------------------------------------------|||||||||||-------||||||----------|||||------|||||||--||||||||||||--------------%%%%%%%%%%---------------------------------%%%%%%------------------------
-----------------------------------------------|||||||||||-----%%%%%%%%%%%-----%%%%%%%%----%%%%%%%%%%||||||||||||--------------||||||||||%%%%%%%%%%%%----%%%%%%%%%%%------||||||------------------------
-----------------------------------------------|||||||||||-----|||||||||||-----||||||||----||||||||||||||||||||||%%%%%%%%%%%%%%||||||||||||||||||||||----|||||||||||------||||||------SCSCC2SCS--%%%%F%%
-------------------------%%%%%%%%%%%%%%--------|||||||||||-----|||||||||||-----||||||||----||||||||||||||||||||||||||||||||||||||||||||||||||||||||||----|||||||||||------||||||-----------------||||%||
-------------------------||||||||||||||%%%%%%%%|||||||||||-----|||||||||||-----||||||||----||||||||||||||||||||||||||||||||||||||||||||||||||||||||||----|||||||||||----%%%%%%%%%%%-kr-----------|||||||
------%%%%%--------------|||||||||||||||||||||||||||||||||-----|||||||||||-----||||||||----||||||||||||||||||||||||||||||||||||||||||||||||||||||||||----|||||||||||----|||||||||||--------------|||||||
XXXXXX|||||XXXXXXXXXXXXXX|||||||||||||||||||||||||||||||||-----|||||||||||-----||||||||----||||||||||||||||||||||||||||||||||||||||||||||||||||||||||----|||||||||||----|||||||||||XXXXXXXXXXXXXX|||||||
