--------------------------------------------------------------------------------------------------------------------------------------------------------------------------------------------------------
--------------------------------------------------------------------------------------------------------------------------------------------------------------------------------------------------------
--------------------------------------------------------------------------------------------------------------------------------------------------------------------------------------------------------
--------------------------------------------------------------------------------------------------------------------------------------------------------------------------------------------------------
--------------------------------------------------------------------------------------------------------------------------------------------------------------------------------------------------------
--------------------------------------------------------------------------------------------------------------------------------------------------------------------------------------------------------
--------------------------------------------------------------------------------------------------------------------------------------------------------------------------------------------------------
--------------------------------U-----------------------------------------------------------------------------------------------------------------------------------------------------------------------
----------------------------------------BBB2BBC------------g--------------------------------------------------------------------------------------------------------------------------------------------
---------------------------------------------------------------------------------g-g--------------------------------------------------------------------------------------------------------------------
------------------------------------kgggkkggkggkgg------------------------------------------------------------------------------------------------------------------------------------------------------
-------------------------%%%%%%%%%%%--------------------------------------------------------------------------------------------------------------gkggggggggggg-----------------------------------------
-------------------------|||||||||||--------------%%%%%%%%-----------------------------------------------------------------------------------------%%%%%%%%%%%--------------gg------g-------------------
-------------------------|||||||||||--------------||||||||----------------g-----------------------------------%%%%%%%%-------%%%%%%%%-----------r--|||||||||||-%%%%%%%%%-----------------%%%%%%%%%%%%F%%
------%%%%%--------------|||||||||||%%%%%%%%%%%%%%||||||||----%%%%%%%%----------------------------------------||||||||-------||||||||----%%%%%%%%--|||||||||||-|||||||||---%%%%%%%%%%%%%%||||||||||||X||
%%%%%%|||||%%%%%%%%%%%%%%|||||||||||||||||||||||||||||||||----||||||||---%%%%%%%%-----%%%%%%%%%%%%-----%%%----||||||||-----%%%%%%%%%%%%%%||||||||%%%%%%%%%%%%%%|||||||||---||||||||||||||||||||||||||X||
