--------------------------------------------------------------------------------------------------------------------------------------------------------------------------------------------------------
--------------------------------------------------------------------------------------------------------------------------------------------------------------------------------------------------------
--------------------------------------------------------------------------------------------------------------------------------------------------------------------------------------------------------
--------------------------------------------------------------------------------------------------------------------------------------------------------------------------------------------------------
--------------------------------------------------------------------------------------------------------------------------------------------------------------------------------------------------------
--------------------------------------------------------------------------------------------------------------------------------------------------------------------------------------------------------
--------------------------------------------------------------------------------------------------------------------------------------------------------------------------------------------------------
--------------------------------------------------------------------------------------------------------------------------------------------------------------------------------------------------------
--------------------------------------------------------------------------------------------------------------------------------------------------------------------------------------------------------
-------------------------------------------------------------------------------------------------------U------------------------------------------------------------------------------------------------
---------------------------------------ggggggkk--------------------------------------------g------------------------------------------------------------------------------------------------------------
-------------------------------------r--XXXXXX-------------------------------------------------------------ggkggggkgggg------------------%%%%%%-----%%%%%%-----%%%%%------------------------------------
-------------------------%%%%%%%%%%%%%--XXXXXX-%%%%%%%%%%%%------%%%%%%--------------------------------------XXXXXXXX-------------------%%%%%||-----||||||-----|||||------------------------------------
-------------------------|||||||||||||--XXXXXX-||||||||||||------||||||----g---------g-------%%%%%%%%%%%%%%--XXXXXXXX--%%%%%%%%%%%------|||||||-----||||||-----|||||---g-k-r----------------------------
------%%%%%--------------|||||||||||||%%%%%%%%%||||||||||||-----%%%%%%%----------------------||||||||||||||--XXXXXXXX--|||||||||||------|||||||-----||||||-----|||||------------------------------------
%%%%%%|||||%%%%%%%%%%%%%%||||||||||||||||||||||||||||||||||----%%%%%%%%%%%---%%%%%%%%%%%%----||||||||||||||%%%%%%%%%%%%|||||||||||----%%%%%%%%|---%%%%%%%%%%%%%%%%%%%%%%%%%%%%%%%%%%%%%%%%%%%%%%%%%%%F%%
