--------------------------------------------------------------------------------------------------------------------------------------------------------------------------------------------------------
--------------------------------------------------------------------------------------------------------------------------------------------------------------------------------------------------------
--------------------------------------------------------------------------------------------------------------------------------------------------------------------------------------------------------
--------------------------------------------------------------------------------------------------------------------------------------------------------------------------------------------------------
--------------------------------------------------------------------------------------------------------------------------------------------------------------------------------------------------------
--------------------------------------------------------------------------------------------------------------------------------------------------------------------------------------------------------
----------------------------------------------------------------------------------------------------------------------------------------------------U---------------------------------------------------
--------------------------------------------------------------------------------------------------------------------------------------------------------------------------------------------------------
-----------------------------------------------------------------------------------------------------------------------------------%%%%%%%----------------%%%%%%----------------------------------------
-----------------------------------------------------------------------------------------------------------------------------------|||||||--------------gggrrrkrkk--------------------------------------
------------------------------------------------------------------------------------------------------------------------gg------g--|||||||---%%%%%%%%%%%--XXXXXX---------------%%%%%%%%%%%%-------------
------------------------------%%%%--------------------------------------g-gg-------------------------------------BCBB--------------|||||||---|||||||||||--XXXXXX--%%%%%%%%%%%%%||||||||||||-------------
------------------------------|%%%%%%%----------------------------------------%%%%%%%---------%%%----------------------%%%%%%%%%%%%%%%%%%%%%%|||||||||||--XXXXXX--|||||||||||||||||||||||||-------------
------------------------------||||||||----------ggg---------------------------|||||||---------|||----------------------|||||||||||||||||||||||||||||||||%%%%%%%%%%|||||||||||||||||||||||||-------------
------%%%%%-------------------||||||||----------------------------------------|||||||---------|||----------------------||||||||||||||||||||||||||||||||||||||||||||||||||||||||||||||||||||%%%%%%%%%%F%%
%%%%%%|||||%%%%%%%%%%%%%%----%%%%%%%%%%%%%-----%%%%%%%%%%%%%%%%%%%%%%%%-----%%%%%%%%%%%%%-----|||----%%%%%%%%%%%%%%%%%%||||||||||||||||||||||||||||||||||||||||||||||||||||||||||||||||||||||||||||||X||
