--------------------------------------------------------------------------------------------------------------------------------------------------------------------------------------------------------
--------------------------------------------------------------------------------------------------------------------------------------------------------------------------------------------------------
--------------------------------------------------------------------------------------------------------------------------------------------------------------------------------------------------------
--------------------------------------------------------------------------------------------------------------------------------------------------------------------------------------------------------
--------------------------------------------------------------------------------------------------------------------------------------------------------------------------------------------------------
--------------------------------------------------------------------------------------------------------------------------------------------------------------------------------------------------------
--------------------------------------------------------------------------------------------------------------------------------------------------------------------------------------------------------
--------------------------------------------------------------------------------------------------------------------------------------------------------------------------------------------------------
--------------------------------------------------------------------------------------------------------------------------k-----------------------------------------------------------------------------
-----------------------------------------------------------------------------------------------CCCU2SC-%%%%%%%%%%%%-------------------------------------------------------------------------------------
----------k--------------------------------------------------------------------------------------------||||||||||||%%%%%%%%-----------------------------------------------------------------------------
--------------------------r--------------------------------------------US222SSC2--------SSSU2----------||||||||||||||||||||-------------------------------------2C22USS----SSCC2------2CS2C-------------
-------------------------------------------------------------------------------------------------------||||||||||||||||||||-----------------------------------------------------------------------------
-------------------------------------------k-----r-------------tt-----k--------------------------------||||||||||||||||||||-----%%%--------------k------------------------------------------------------
------%%%%%----------------------------------------------------tt--------------------------------------||||||||||||||||||||-----|||----%%%%%%%%%----------------------------------------------%%%%%%%F%%
XXXXXX|||||XXXXXXXXXXXXXX-----XXXXXXXXXXXX---XXXXXXXX----XXXXXXXXXXXXXXXXXXXXXXXXXXXXXXXXXXXXXXXXXXXXXX||||||||||||||||||||-----|||----|||||||||XXXXXXXXXXXXXXXXXXXXXXXXXXXXXXXXXXXXXXXXXXXXXX|||||||X||
