--------------------------------------------------------------------------------------------------------------------------------------------------------------------------------------------------------
--------------------------------------------------------------------------------------------------------------------------------------------------------------------------------------------------------
--------------------------------------------------------------------------------------------------------------------------------------------------------------------------------------------------------
--------------------------------------------------------------------------------------------------------------------------------------------------------------------------------------------------------
--------------------------------------------------------------------------------------------------------------------------------------------------------------------------------------------------------
--------------------------------------------------------------------------------------------------------------------------------------------------------------------------------------------------------
-------------------------------------------------------------------------------U------------------------------------------------------------------------------------------------------------------------
---------------------------------------------------------------------------------------------------------------------------------------------------------------------------------------BU---------------
-------------------------------------------------------------------------------------%%%%%-------------------------------------------------------------g-g---------------%%%%%%%------------------------
-----------------------------------------------------------------------------------gggkgkggk--------------------------------------BB2BBCBC2UBB-%%%%%%%%------------------|||||||------------------------
----------------------------------------------------------gg-----g-----%%%%%%%%%%%%--XXXXX-----------------------------------------------------||||||||------------------|||||||------------%%%%%%%%%F%%
-------------------------------------kkgggggkgg---------------%%%%%%---||||||||||||--XXXXX--%%%%%%%%%%%-------------------CBBBBUB2-------------||||||||----------------%%%%%%%%%%%%%%%%%%%%%|||||||||X||
--------------------------------------------------------------||||||---||||||||||||--XXXXX--|||||||||||----------------------------------------||||||||----------------||||||||||||||||||||||||||||||X||
-----------------------------------r-----------%%%%%%%%%%-----||||||---||||||||||||%%%%%%%%%|||||||||||----------------------------------------||||||||----%%%%%%%%%%%%||||||||||||||||||||||||||||||X||
------%%%%%--------------%%%%%%%%%%%-----------||||||||||---%%%%%%%%%%%||||||||||||||||||||||||||||||||----------------------------------------||||||||----||||||||||||||||||||||||||||||||||||||||||X||
%%%%%%|||||%%%%%%%%%%%%%%|||||||||||%%%%%%%%%%%||||||||||---|||||||||||||||||||||||||||||||||||||||||||----%%%%%%%%%%%%%%%%%%%%%%%%%%%%%%%%%%%%||||||||----||||||||||||||||||||||||||||||||||||||||||X||
