--------------------------------------------------------------------------------------------------------------------------------------------------------------------------------------------------------
--------------------------------------------------------------------------------------------------------------------------------------------------------------------------------------------------------
--------------------------------------------------------------------------------------------------------------------------------------------------------------------------------------------------------
--------------------------------------------------------------------------------------------------------------------------------------------------------------------------------------------------------
--------------------------------------------------------------------------------------------------------------------------------------------------------------------------------------------------------
--------------------------------------------------------------------------------------------------------------------------------------------------------------------------------------------------------
--------------------------------------------------------------------------------------------------------------------------------------------------------------------------------------------------------
--------------------------------------------------------------------------------------------------------------------------------------------------------------------------------------------------------
--------------------------------------------------------------------------------------------------------g-------------------gg---g----------------------------------------------------------------------
----------------------------------------------------------------------------------------g---------------------------------------------------------------------------------------------------------------
-----------------------------------------g---------------U---------------------------------------tt----%%%%%%%%%%%%%%%%%%%%-----------------------------------------------------------------------------
-------------------------------------------------------------kkgggggkggggkg----------------------tt----||||||||||||||||||||-----------------------------------------------------S2S2SSS-----------------
---------------------------------------------------------------%%%%%%%%%%------------------------tt----||||||||||||||||||||-----%%%%%%%%-----------%%%%%%%%%%%%%------%%%%%%----------------------------
--------------------------g----g---g-g-------------------------||||||||||--%%%%%%%%%%%%----%%%%%%%%%%%%||||||||||||||||||||-----||||||||----gg-----|||||||||||||------||||||---r----r---k---------------
------%%%%%------------------------------------------%%%%%%%%--||||||||||--||||||||||||----||||||||||||||||||||||||||||||||-----||||||||-----------|||||||||||||------||||||----------------------------
XXXXXX|||||XXXXXXXXXXXXXX---XXXXXXXXXXXXX---XXXXXXXXX||||||||XXXXXXXXXXXXXX||||||||||||----||||||||||||||||||||||||||||||||-----||||||||---XXXXXXXX|||||||||||||----XXXXXXXXXXXXXXXXXXXXXXXXXXXXXXXXXFXX
