--------------------------------------------------------------------------------------------------------------------------------------------------------------------------------------------------------
--------------------------------------------------------------------------------------------------------------------------------------------------------------------------------------------------------
--------------------------------------------------------------------------------------------------------------------------------------------------------------------------------------------------------
--------------------------------------------------------------------------------------------------------------------------------------------------------------------------------------------------------
--------------------------------------------------------------------------------------------------------------------------------------------------------------------------------------------------------
--------------------------------------------------------------------------------------------------------------------------------------------------------------------------------------------------------
--------------------------------------------------------------------------------------------------------------------------------------------------------------------------------------------------------
--------------------------------------------------------------------------------------------------------------------------------------------------------------------------------------------------------
-------------------------------------------------------------------------------------------------------------------------------------------------------------------------------k------------------------
--------------------------------------------------------------------------------------------------------------------------------------------------------------------------------------------------------
------------------------------------------------------------------------------------------------------------------------------------------------------------------------------------%%%%%%--------------
--------------------------------%%%%%%----------------------------------------------------------------------------------%%%%%-----------------gggkkkrk-----------%%%%%%%%%%%%%------||||||--------------
--------------------------------||||||--------------------------------------------------------------------%%%%%%%%------|||||------------------------------------|||||||||||||------||||||--------------
--------------------------------||||||-------g--------------------------%%%%%%%--------------------------%%%%%%|||------|||||---------------r---------%%%%%%%%%%%|||||||||||||----%%%%%%%%%%%%%%%%%%%F%%
------%%%%%---------------------||||||----------------------------------|||||||--------------------------|||||||||------|||||--%%%%%%%%%%%%%%---------||||||||||||||||||||||||----|||||||||||||||||||X||
%%%%%%|||||%%%%%%%%%%%%%%-----%%%%%%%%%%%---%%%%%%%%%%%%%%---%%%%%%%%%%%%%%%%%%%%%%-----%%%%%%%%%%%%%---%%%%%%%%%%%%%%%%%%%%%%%||||||||||||||%%%%%%%%%||||||||||||||||||||||||----|||||||||||||||||||X||
