--------------------------------------------------------------------------------------------------------------------------------------------------------------------------------------------------------
--------------------------------------------------------------------------------------------------------------------------------------------------------------------------------------------------------
--------------------------------------------------------------------------------------------------------------------------------------------------------------------------------------------------------
--------------------------------------------------------------------------------------------------------------------------------------------------------------------------------------------------------
--------------------------------------------------------------------------------------------------------------------------------------------------------------------------------------------------------
--------------------------------------------------------------------------------------------------------------------------------------------------------------------------------------------------------
--------------------------------------------------------------------------------------------------------------------------------------------------------------------------------------------------------
--------------------------------------------------------------------------------------------------------------------------------------------------------------------------------------------------------
--------------------------------------------------------------------------------------------------------------------------------------------------------------------------------------------------------
--------------------------------------------------------------------------------------------------------------------------------------------------------------------------------------------------------
--------------------------g------------------------U-------------------------------------------------------------------------------%%%%%%%-------------------k------------------------------------------
-------------------------------------------------------kgkggkkkgg-----------------------%%%%%%%------------------------------------|||||||------------------------%%%%%%----%%%%%%%----r----------------
------------------------------------------------------------------------------g---------|||||||-------------------%%%%%%%%%%%%-----|||||||-----g----g--g----------||||||----|||||||---------------------
----------------------------------g------------------------------%%%%%%%%%--------------|||||||-------------------||||||||||||-----|%%%|||------------------------||||||----|||||||---%%%%%%%%%%%-------
------%%%%%-------------------------------%%%%%%%%%%%%%----------|||||||||---%%%%%%%%%--|||||||-------------------||||||||||||---%%%%%%%%%%%%%%%%%%%%%%%%%%-------||||||----|%%%%%|---|||||||||||-------
%%%%%%|||||%%%%%%%%%%%%%%-----%%%%%%%%%%%%|||||||||||||%%%%%%%%%%|||||||||---|||||||||%%%%%%%%%%%%-----%%%%%%%%%%%||||||||||||---||||||||||||||||||||||||||-----%%%%%%%%%%%%%%%%%%%%%%|||||||||||%%%%F%%
