--------------------------------------------------------------------------------------------------------------------------------------------------------------------------------------------------------
--------------------------------------------------------------------------------------------------------------------------------------------------------------------------------------------------------
--------------------------------------------------------------------------------------------------------------------------------------------------------------------------------------------------------
--------------------------------------------------------------------------------------------------------------------------------------------------------------------------------------------------------
--------------------------------------------------------------------------------------------------------------------------------------------------------------------------------------------------------
--------------------------------------------------------------------------------------------------------------------------------------------------------------------------------------------------------
--------------------------------------------------------------------------------------------------------------------------------------------------------------------------------------------------------
----------------------------------------------------U---------------------------------------------------------------------------------------------------------------------------------------------------
--------------------------------------------------------------------------------------------------------------------------------------------------------------------------------------------------------
----------------------------------------------------------%%%%%%%%%%---------------------------------------SC2CCC-----------g-----g---------------------------------------------------------------------
--------------------------------------------------------ggkkkgggggggkg-----------------------------------kkgggggggg-------------------------------------------------------------------------------------
-------------------------------%%%%%%%%----%%%%%%%%%%%%%--||||||||||-----------------------------------r-------------------%%%%%%%%%--------------------------------------------------------------------
-------------------------------||||||||----|||||||||||||--||||||||||--%%%%%%%%%%%%%------g------%%%%%%%%-----------%%%%%%%%|||||||||--------------------------------------------------------------------
-------------------------------||||||||----|||||||||||||--||||||||||--|||||||||||||-------------||||||||-----------|||||||||||||||||--------------------------------------%%%%%%------------------------
------%%%%%-------------------XXXXX||||----|||||||||||||%%%%%%%%%%%%%%|||||||||||||-----%%%%%%%%||||||||%%%%%%%%%%%|||||||||||||||||--------------------------------------||||||------------------------
XXXXXX|||||XXXXXXXXXXXXXX----XXXXXXXXXXXXXX||||||||||||||||||||||||||||||||||||||||-----||||||||||||||||||||||||||||||||||||||||||||XXXXXXXXXXXXXX-----XXXXXXXXXXXXXX---XXXXXXXXXXX-----XXXXXXXXXXXXXFXX
