--------------------------------------------------------------------------------------------------------------------------------------------------------------------------------------------------------
--------------------------------------------------------------------------------------------------------------------------------------------------------------------------------------------------------
--------------------------------------------------------------------------------------------------------------------------------------------------------------------------------------------------------
--------------------------------------------------------------------------------------------------------------------------------------------------------------------------------------------------------
--------------------------------------------------------------------------------------------------------------------------------------------------------------------------------------------------------
--------------------------------------------------------------------------------------------------------------------------------------------------------------------------------------------------------
-------------------------------------------------------------------------------------------------------------------------------------------------------------------------------%%%%%%%------------------
-------------------------------------------------------------------------------------------------------------------------------------------------------------------------------|%%%%%|------------------
-----------------------------------------S22S------------------%%%%%%%%-----ggg-------U-----------------------------------------------------------------------------g-g-k------|||||||------------------
----------------------------------------gkkgkggg---------------||||||||-----------------------CS----------------------------------------------------UCSS2S-%%%%%%%%------------|||||||------------------
--------------------------------------r-----------------------%%%%%%|||------------------------------------------------------------------------------------||||||||%%%%%%%%%%%%%%%%%%%%%%%%%%%%%%%%%%F%%
-------------------------%%%%%%%%%%%%%%---------%%%%%%%%------|||||||||-------------------gkggggkg-------------------------------CSS----------SCUSS--------||||||||||||||||||||||||||||||||||||||||||%||
-------------------------||||||||||||||---------||||||||-----%%%%%%%%%%%%%%----%%%%%%%%%%%-----------------------------------------------------------------|||||||||||||||||||||||||||||||||||||||||||||
-------------------------||||||||||||||%%%%%%%%%||||||||-----||||||||||||||----|||||||||||--------%%%%%%%%%%-----------------------------------------------|||||||||||||||||||||||||||||||||||||||||||||
------%%%%%--------------|||||||||||||||||||||||||||||||-----||||||||||||||----|||||||||||--------||||||||||-----------------------------------------------|||||||||||||||||||||||||||||||||||||||||||||
XXXXXX|||||XXXXXXXXXXXXXX|||||||||||||||||||||||||||||||-----||||||||||||||----|||||||||||XXXXXXXX||||||||||-----XXXXXXXXXXXXXXXXXXXXXXXXXXXXXXXXXXXXXXXXXX|||||||||||||||||||||||||||||||||||||||||||||
