--------------------------------------------------------------------------------------------------------------------------------------------------------------------------------------------------------
--------------------------------------------------------------------------------------------------------------------------------------------------------------------------------------------------------
--------------------------------------------------------------------------------------------------------------------------------------------------------------------------------------------------------
--------------------------------------------------------------------------------------------------------------------------------------------------------------------------------------------------------
--------------------------------------------------------------------------------------------------------------------------------------------------------------------------------------------------------
--------------------------------------------------------------------------------------------------------------------------------------------------------------------------------------------------------
----------------------------------------------------------------------------------g------------------------------------------------------------------------------------B2C------------------------------
--------------------------------------------------------------------------------------------------------------------------------------------------------------tt----------------------------------------
--------------------------------------------------------------------------------%%%%%%%%-----gg-----------%%%%-----------------------ggkgggkggrk--------------tt---------------r------------------------
--------------------------------------------------------------------------------||||||||-----------------%%%%%%--------------------r--XXXXXXXXX---------------tt----------------------------------------
--------------------------------------------------------------------------------||||||||----%%%%%%%%%%%--||||||------------%%%%%%%%%--XXXXXXXXX-%%%%%%%%%%%%%%%%%%%%%%%%%%%%%---------------------------
------------------------------------------------------------------------------%%%%%%%%%%%%%%|||||||||||--||||||------------|||||||||--XXXXXXXXX-|||||||||||||||||||||||||||||---------------------------
------------------------------------------------------------------------------|||||||||||||||||||||||||%%%%%%%%%%----------|||||||||%%%%%%%%%%%%|||||||||||||||||||||||||||||-----%%%%%%%%%%%%%---------
--------------------------gg-----------------%%%%%%--------%%%----------tt----|||||||||||||||||||||||||||||||||||%%%%%%%%%%||||||||||||||||||||||||||||||||||||||||||||||||||-----|||||||||||||%%%%%%F%%
------%%%%%----------------------------------||||||--------|||----------tt----|||||||||||||||||||||||||||||||||||||||||||||||||||||||||||||||||||||||||||||||||||||||||||||||-----|||||||||||||||||||X||
%%%%%%|||||%%%%%%%%%%%%%%---%%%%%%%%%%%----%%%%%%%%%%%-----|||----%%%%%%%%%%%%|||||||||||||||||||||||||||||||||||||||||||||||||||||||||||||||||||||||||||||||||||||||||||||||-----|||||||||||||||||||X||
