--------------------------------------------------------------------------------------------------------------------------------------------------------------------------------------------------------
--------------------------------------------------------------------------------------------------------------------------------------------------------------------------------------------------------
--------------------------------------------------------------------------------------------------------------------------------------------------------------------------------------------------------
-----------------------------------------------------------------------------------------------U--------------------------------------------------------------------------------------------------------
-------------------------------------------------------------------------------------------------------BBBBBC-------------------------------------------------------------------------------------------
--------------------------------------------------------------------------------------------------------------------------------------------------------------------------------------------------------
---------------------------------------------------------------------------------------------------kkgkgkkgkggg-----------------------------------------------------------------------------------------
---------------------------------------------------------------------------------------%%%%%%%%%%%%-------------------------------------------CC----------------%%%%%-----------------------------------
--------------------------------------------------------------------------g--g---------||||||||||||------------%%%%%%%%---g-------------------------------------|||||-----------------------------------
---------------------------------------------------------------------------------------||||||||||||------------||||||||-----------------------------------------|||||--------------g------r-------------
-------------------------------------------------------------------------%%%%%%%%%%%%%%||||||||||||%%%%%%%%%%%%||||||||-----------------------------------------|||||-------------------------%%%%%%%F%%
---------------------------------------g---------------------------------||||||||||||||||||||||||||||||||||||||||||||||---------------------%%%%%%----g-------%%%%%%%%--2C2B2BUB--%%%%%%%%%%%%|||||||X||
-------------------------------------------------------------------------||||||||||||||||||||||||||||||||||||||||||||||----%%%%%%%%%%%------||||||------------||||||||------------|||||||||||||||||||X||
-------------------------------g-------------------------------%%%%%%%%%%||||||||||||||||||||||||||||||||||||||||||||||----|||||||||||-g----||||||g--%%%%%%%%%||||||||------------|||||||||||||||||||X||
------%%%%%----------------------------------------------------||||||||||||||||||||||||||||||||||||||||||||||||||||||||----|||||||||||------||||||---|||||||||||||||||------------|||||||||||||||||||X||
%%%%%%|||||%%%%%%%%%%%%%%-----%%%%%%%%%----%%%%%%%%-----%%%----||||||||||||||||||||||||||||||||||||||||||||||||||||||||----|||||||||||----%%%%%%%%%%%|||||||||||||||||%%%%%%%%%%%%|||||||||||||||||||X||
