--------------------------------------------------------------------------------------------------------------------------------------------------------------------------------------------------------
--------------------------------------------------------------------------------------------------------------------------------------------------------------------------------------------------------
--------------------------------------------------------------------------------------------------------------------------------------------------------------------------------------------------------
--------------------------------------------------------------------------------------------------------------------------------------------------------------------------------------------------------
--------------------------------------------------------------------------------------------------------------------------------------------------------------------------------------------------------
--------------------------------------------------------------------------------------------------------------------------------------------------------------------------------------------------------
--------------------------------------------------------------------------------------------------------------------------------------------------------------------------------------------------------
-----------------------------------------------U--------------------------------------------------------------------------------------------------------------------------------------------------------
------------------------------------------------------CB2BB------------------------------------------------------------------------------------g---g-----g----------------------------------------------
--------------------------------------------------------------------------------------------------------------------------------------------------------------------------------------------------------
---------------------------------------------------ggkkgkggkk----------------------------------------------------------gkggggggg--------------%%%%%%%%%%%%%------g----------g---------------------------
-------------------------------%%%%%-%%%%%%%%%%%%%%------------------------------------------------%%%%%%%-----------r--XXXXXXX---------------|||||||||||||---------------------C22C--------------------
-------------------------------|||||-||||||||||||||----------%%%%%%%%%%%%%%------------------------|||||||---%%%%%%%%%--XXXXXXX-%%%%%%%%%%%%%%|||||||||||||-----%%%%%%%%%%%%%---------------------------
-------------------------------|||||-||||||||||||||----------||||||||||||||-----g---g--------------|%%%%%%---|||||||||--XXXXXXX-|||||||||||||||||||||||||||-----|||||||||||||---------------------------
------%%%%%--------------------|||||-||||||||||||||%%%%%%%%%%||||||||||||||------------------------|||||||---|||||||||%%%%%%%%%%|||||||||||||||||||||||||||-----|||||||||||||---------------------------
%%%%%%|||||%%%%%%%%%%%%%%----%%%%%%%%||||||||||||||||||||||||||||||||||||||-----%%%%%%%%%%%%-----%%%%%%%%%%%%||||||||||||||||||||||||||||||||||||||||||||||-----|||||||||||||%%%%%%%%%%---%%%%%%%%%%%F%%
