--------------------------------------------------------------------------------------------------------------------------------------------------------------------------------------------------------
--------------------------------------------------------------------------------------------------------------------------------------------------------------------------------------------------------
--------------------------------------------------------------------------------------------------------------------------------------------------------------------------------------------------------
--------------------------------------------------------------------------------------------------------------------------------------------------------------------------------------------------------
--------------------------------------------------------------------------------------------------------------------------------------------------------------------------------------------------------
--------------------------------------------------------------------------------------------------------------------------------------------------------------------------------------------------------
--------------------------------------------------------------------------------------------------------------------------------------------------------------------------------------------------------
---------------------------------------------------------------------------U----------------------------------------------------------------------------------------------------------------------------
----------------------------------------------------------------------------------CBB------------------g---------------------------------------BC2B2CBB-------------------------------------------------
---------------------------------------------------------------------------------------------------------------------%%%%%%%%-----------------ggggggggkkg-----------------------------------------------
-------------------------------------------------------------------------------kgkgggkkg----------%%%%%%%%%%%%-------||||||||---------------r--------------------------------------g--------------------
-------------------------------------------------------------------%%%%%%%%%%%%-------------------||||||||||||-------||||||||----%%%%%%%%%%%%------------%%%%%%%%%%%%%----------------------------------
--------------------------g-g-%%g%%%-------------------------------||||||||||||---------%%%%%%%%%%||||||||||||-------||||||||----||||||||||||------------|||||||||||||---%%%%%%%%%-------------%%%%%%F%%
------------------------------||X|||----------%%%%%%---------------||||||||||||---------||||||||||||||||||||||-----%%%%%%%%%%%%%%||||||||||||%%%%%%%%%%%%|||||||||||||---|||||||||----%%%%%%%%%||||||X||
------%%%%%------------------%%%%|||----------||||||---------------||||||||||||%%%%%%%%%||||||||||||||||||||||-----|||||||||||||||||||||||||||||||||||||||||||||||||||---|||||||||----|||||||||||||||X||
%%%%%%|||||%%%%%%%%%%%%%%---%%%%%%%%%%%-----%%%%%%%%%%%---%%%%%%%%%|||||||||||||||||||||||||||||||||||||||||||-----|||||||||||||||||||||||||||||||||||||||||||||||||||---|||||||||----|||||||||||||||X||
