--------------------------------------------------------------------------------------------------------------------------------------------------------------------------------------------------------
--------------------------------------------------------------------------------------------------------------------------------------------------------------------------------------------------------
--------------------------------------------------------------------------------------------------------------------------------------------------------------------------------------------------------
--------------------------------------------------------------------------------------------------------------------------------------------------------------------------------------------------------
--------------------------------------------------------------------------------------------------------------------------------------------------------------------------------------------------------
--------------------------------------------------------------------------------------------------------------------------------------------------------------------------------------------------------
--------------------------------------------------------------------------------------------------------------------------------------------------------------------------------------------------------
--------------------------------------------------------------------------------------------------------------------------------------------------------------------------------------------------------
--------------------------------------------------------------------------------------------------------------U-----------------------------------------------------------------------------------------
-------------------------------------------------------------------------------------g---------------2U-----------------------------------g---g---------------------------------------------------------
--------------------------------------------------------------------------------------------------------------------%%%%%-------------------------------------------------------------------------------
------------------------------------------------------------------kgkkggk-----------%%%%%%%%%%%%%%----------------ggggkkggg----------------------------------gg-g---------------------------------------
-------------------------------------------------------------------%%%%%------------||||||||||||||--------%%%%%%%%--XXXXX-------------------------------------------------------------------------------
-------------------------------g----g-----------%%%%%%----------r--|||||-%%%%%%%%%%%||||||||||||||%%%%%%%%||||||||--XXXXX--%%%%%%%%%%%%%%------------------------------------------g----g---g-----------
------%%%%%-------------------------------------||||||--%%%%%%%%%--|||||-|||||||||||||||||||||||||||||||||||||||||--XXXXX--||||||||||||||---------------------------------------------------------------
%%%%%%|||||%%%%%%%%%%%%%%---%%%%%%%%%%%%%-----%%%%%%%%%%|||||||||%%%%%%%%|||||||||||||||||||||||||||||||||||||||||%%%%%%%%%||||||||||||||-----%%%%%%%%%%%%%%---%%%%%%%%%%%%%%-----%%%%%%%%%%%%%%%%%%%F%%
