--------------------------------------------------------------------------------------------------------------------------------------------------------------------------------------------------------
--------------------------------------------------------------------------------------------------------------------------------------------------------------------------------------------------------
--------------------------------------------------------------------------------------------------------------------------------------------------------------------------------------------------------
--------------------------------------------------------------------------------------------------------------------------------------------------------------------------------------------------------
--------------------------------------------------------------------------------------------------------------------------------------------------------------------------------------------------------
--------------------------------------------------------------------------------------------------------------------------------------------------------------------------------------------------------
--------------------------------------------------------------------------------------------------------------------------------------------------------------------------------------------------------
--------------------------------------------------------------------------------------------------------------------------------------------------------------------------------------------------------
-------------------------------------------------------------------------------------------------------------------------------------------------------------------rr------r----------------------------
------------------------------------------------------------------------------------------------------------------------------------------CCBBBBB2BU--%%%%%%%%%%%%--------------------------------------
----------------------------------------------------------------%%%%%%--------------------------------------------------------------------------------||||||||||||-------------%%%%%%%%%%%%-------------
-----------------------------------U---gkggkggggg---------------||||||-----UBCC------------------------------------CCB2BBU---------UBCCBB-------------||||||||||||----%%%%%%%%%||||||||||||-------------
----------------------------------------------------------------||||||--------------------------------------------------------------------------------||||||||||||----|||||||||||||||||||||-------------
--------------------------g------g-------%%%%%%--%%%%%%%%%%-----||||||-----------------------------rr-------------------------------------------------||||||||||||----|||||||||||||||||||||-------------
------%%%%%------------------------------||||||--||||||||||---%%%%%%%%%%%-----------------------------------------------------------------------------||||||||||||----|||||||||||||||||||||%%%%%%%%%%F%%
%%%%%%|||||%%%%%%%%%%%%%%-----%%%%%%%%%%%%%%%%%%%||||||||||---|||||||||||%%%%%%%%%----%%%%%%%%%%%%---%%%%%%%%%%%%%%%%%%%%%%%%%%%%%%%%%%%%%%%%%%%%%%%%%||||||||||||----|||||||||||||||||||||||||||||||X||
