--------------------------------------------------------------------------------------------------------------------------------------------------------------------------------------------------------
--------------------------------------------------------------------------------------------------------------------------------------------------------------------------------------------------------
--------------------------------------------------------------------------------------------------------------------------------------------------------------------------------------------------------
--------------------------------------------------------------------------------------------------------------------------------------------------------------------------------------------------------
--------------------------------------------------------------------------------------------------------------------------------------------------------------------------------------------------------
--------------------------------------------------------------------------------------------------------------------------------------------------------------------------------------------------------
--------------------------------------------------------------------------------------------------------------------------------------------------------------------------------------------------------
-------------------------------------------------------------------------------------------------------------------------------------------U------------------------------------------------------------
--------------------------------------------------------------------------------------------------------------------------------------------------------------------------------------------------------
------------------------------------------------------------------------------------------222C---------------------------------------------------%%%%%%%%-----------------------------------------------
----------------------------------------------------------------------------------------gggkgggg-----------------------------------------------gkgggggkgggk---------------------------------------------
--------------------------------------------------------------------g-----------------r--------------------------------------------%%%%%%%%%%%%--||||||||---------------------------C2CSSUC--%%%%%%%%F%%
--------------------------------%%%%%%%-------------------------------------%%%%%%%%%%%---------%%%%%%%%%-------------%%%%%%%%%%%%%||||||||||||--||||||||--%%%%%%%%%%------------------------||||||||%||
--------------------------------|||||||----ggg--------------------%%%%%%%---|||||||||||---------|||||||||----g--------|||||||||||||||||||||||||--||||||||--||||||||||--------------gr-r------|||||||||||
------%%%%%---------------------|||||||---------------------------|||||||---|||||||||||%%%%%%%%%|||||||||-------------|||||||||||||||||||||||||%%%%%%%%%%%%||||||||||------------------------|||||||||||
XXXXXX|||||XXXXXXXXXXXXXX-----XXXXXXXXXXXX----XXXXXXXXXXXXX-----XXXXXXXXXXXX|||||||||||||||||||||||||||||---XXXXXXXXXX|||||||||||||||||||||||||||||||||||||||||||||||---XXXXXXXXXXXXXXXXXXXXX|||||||||||
