--------------------------------------------------------------------------------------------------------------------------------------------------------------------------------------------------------
--------------------------------------------------------------------------------------------------------------------------------------------------------------------------------------------------------
--------------------------------------------------------------------------------------------------------------------------------------------------------------------------------------------------------
--------------------------------------------------------------------------------------------------------------------------------------------------------------------------------------------------------
--------------------------------------------------------------------------------------------------------------------------------------------------------------------------------------------------------
--------------------------------------------------------------------------------------------------------------------------------------------------------------------------------------------------------
--------------------------------------------------------------------------------------------------------------------------------------------------------------------------------------------------------
-----------------------------------------------------------------------------------------------------------------------------------------------------------%%%%%----------------------------------------
--------------------------------------------------------------------------------------U---------------------------------------------------------------k----|%%%%%%%----rr-------------------------------
-------------------------------------------------------U2CS--%%%%%%%%%%----------------------SS2SS------------------------------r--------------------------||||||||-------------------------------------
-------------------------------------------------------------||||||||||------------------------------------------%%%%%%%%%------------------%%%%%%%%%%%%%%%%%%%%%%%%%%%%%%%%%%%%%%----------------------
----------------------------------------------SSCSSSSU-------||||||||||-------------------ggggggkkgk-------------|||||||||-----%%%%%%%%%%%%%||||||||||||||||||||||||||||||||||||||----------------------
-------------------------------------------------------------||||||||||-----%%%%%%%%%%%%%%-----------------------|||||||||-----|||||||||||||||||||||||||||||||||||||||||||||||||||----------------------
--------------------------g--gg----gg------------------------||||||||||-----||||||||||||||----------%%%%%%%%%%%%%|||||||||-----|||||||||||||||||||||||||||||||||||||||||||||||||||-----%%%%%%%%%%%%%%F%%
------%%%%%--------------------------------------------------||||||||||-----||||||||||||||----------||||||||||||||||||||||-----|||||||||||||||||||||||||||||||||||||||||||||||||||-----||||||||||||||%||
XXXXXX|||||XXXXXXXXXXXXXX----XXXXXXXXXXXXXXXXXXXXXXXXXXXXXXXX||||||||||-----||||||||||||||XXXXXXXXXX||||||||||||||||||||||-----|||||||||||||||||||||||||||||||||||||||||||||||||||-----|||||||||||||||||
