--------------------------------------------------------------------------------------------------------------------------------------------------------------------------------------------------------
--------------------------------------------------------------------------------------------------------------------------------------------------------------------------------------------------------
--------------------------------------------------------------------------------------------------------------------------------------------------------------------------------------------------------
--------------------------------------------------------------------------------------------------------------------------------------------------------------------------------------------------------
--------------------------------------------------------------------------------------------------------------------------------------------------------------------------------------------------------
-----------------------------------S2SS2SUS--%%%%%%%%%%-------------------------------------------------------------------------------------------------------------------------------------------------
---------------------------------------------||||||||||-----------------------------------------------------------------------------------------------------------------------CSSCSSSCSS----------------
-------------------------------U-------------||||||||||-------------------------------------------------------------------------------------------------------------------------------------------------
---------------------------------------------||||||||||--------------g----------------g---g-----------------------------------------%%%%%%---kk------------------r----r---------------------------------
---------------------------------------------||||||||||-----------------------------------------------------------------------------||||||--------------------------------------------------------------
---------------------------------------------||||||||||----%%%%%%%%%----------------------------------------------------------------||||||--%%%%%%%%%---%%%%%%%%%%%%%%%%%%%%%%%%%%%%%%%%%%--------------
-------------------------%%%%%%%%------------||||||||||----|||||||||-----%%%%%%%%%%%%---------------------------------------------%%%%%%%%%%|||||||||---||||||||||||||||||||||||||||||||||--------------
-------------------------||||||||------------||||||||||----|||||||||-----||||||||||||---------------------------------------------|||||||||||||||||||---||||||||||||||||||||||||||||||||||--------------
-------------------------||||||||------------||||||||||----|||||||||-----||||||||||||---------------------------kr---------k------|||||||||||||||||||---||||||||||||||||||||||||||||||||||--------------
------%%%%%--------------||||||||%%%%%%%%%%%%||||||||||----|||||||||-----||||||||||||---------------------------------------------|||||||||||||||||||---||||||||||||||||||||||||||||||||||%%%%%%%%%%%F%%
XXXXXX|||||XXXXXXXXXXXXXX||||||||||||||||||||||||||||||----|||||||||-----||||||||||||---XXXXXXXX----XXXXXXXXXXX-----XXXXXXXXXXXXXX|||||||||||||||||||---|||||||||||||||||||||||||||||||||||||||||||||X||
