--------------------------------------------------------------------------------------------------------------------------------------------------------------------------------------------------------
--------------------------------------------------------------------------------------------------------------------------------------------------------------------------------------------------------
--------------------------------------------------------------------------------------------------------------------------------------------------------------------------------------------------------
--------------------------------------------------------------------------------------------------------------------------------------------------------------------------------------------------------
--------------------------------------------------------------------------------------------------------------------------------------------------------------------------------------------------------
--------------------------------------------------------------------------------------------------------------------------------------------------------------------------------------------------------
--------------------------------------------------------------------------------------------------------------------------------------------------------------------------------------------------------
--------------------------------------------------------------------------------------------------------------------------------------------------------------------------------------------------------
--------------------------------------------------------------------------------------------------------------------------------------------------------------------------------------------------------
---------------------------------------------------------------------------g-------g----------------------------------------U---------------------------------------------------------------------------
------------------------------------------------------------------------------------------------------------------------------------------------------g--g-------%%%%%%%%%%%%%----%%%%%%%%%-------------
----------------------------------------------------gkkggkgkkggg---------------------------------------%%%%%%%%%%%%-------------ggggkggggggg---------------------|||||||||||||----|||||||||-------------
--------------------------------------------------r--XXXXXXXXXX-----------------------------------tt---||||||||||||---------------XXXXXXXX------------%%%%%%%%%%%|||||||||||||----|||||||||-------------
--------------------------gg---%%%%%g-%%%%%%%%%%%%%--XXXXXXXXXX-%%%%%%%%%%-----%%%%%%%------------tt---||||||||||||---%%%%%%%%%%--XXXXXXXX--%%%%%%%%%%||||||||||||||||||||||||----|||||||||-------------
------%%%%%--------------------|||||--|||||||||||||--XXXXXXXXXX-||||||||||-----|||||||------------tt---||||||||||||---||||||||||--XXXXXXXX--||||||||||||||||||||||||||||||||||----|||||||||%%%%%%%%%%F%%
%%%%%%|||||%%%%%%%%%%%%%%----%%%%%%%%%|||||||||||||%%%%%%%%%%%%%||||||||||---%%%%%%%%%%%%----%%%%%%%%%%||||||||||||---||||||||||%%%%%%%%%%%%||||||||||||||||||||||||||||||||||----|||||||||||||||||||X||
