--------------------------------------------------------------------------------------------------------------------------------------------------------------------------------------------------------
--------------------------------------------------------------------------------------------------------------------------------------------------------------------------------------------------------
--------------------------------------------------------------------------------------------------------------------------------------------------------------------------------------------------------
--------------------------------------------------------------------------------------------------------------------------------------------------------------------------------------------------------
--------------------------------------------------------------------------------------------------------------------------------------------------------------------------------------------------------
--------------------------------------------------------------------------------------------------------------------------------------------------------------------------------------------------------
--------------------------------------------------------------------------------------------------------------------------------------------------------------------------------------------------------
--------------------------------------------------------------------------------------------------------------------------------------------------------------------------------------------------------
------------------------------------------------------------------g-------------------------------------------------------------------------------------------------------------------------------------
---------------------------------------U---------------------------------------------------------------------------------------------g------------------------------------------------------------------
----------------------------------------------SSSSSC-----------------------------------------------------------SSCSSC-----------------------------------------------------------------------------------
-------------------------------------------gggggggkgggg------------------------------------------------------kgggkggkgkk--------------------------------------------------------------------------------
-----------------------------------------------------------------------------------------------------------r--------------------------------------------------------------------------------------------
------------------------------%%%%%%%%%%%%%------------%%%%%%%%%%----%%%%%%%%%%%%%%-----------------%%%%%%%%------------%%%%%%%%%%%%---------------gg------------g-------g----------tt------------------
------%%%%%-------------------|||||||||||||------------||||||||||----||||||||||||||-----------------||||||||------------||||||||||||------------------------------------------------tt------------------
XXXXXX|||||XXXXXXXXXXXXXX-----|||||||||||||XXXXXXXXXXXX||||||||||----||||||||||||||----XXXXXXXXXXXXX||||||||XXXXXXXXXXXX||||||||||||----XXXXXXXXXX---XXXXXXXXXXXXXXXXXXXXXXXX---XXXXXXXXXXXXXXXXXXXXXFXX
