--------------------------------------------------------------------------------------------------------------------------------------------------------------------------------------------------------
--------------------------------------------------------------------------------------------------------------------------------------------------------------------------------------------------------
--------------------------------------------------------------------------------------------------------------------------------------------------------------------------------------------------------
--------------------------------------------------------------------------------------------------------------------------------------------------------------------------------------------------------
--------------------------------------------------------------------------------------------------------------------------------------------------------------------------------------------------------
--------------------------------------------------------------------------------------------------------------------------------------------------------------------------------------------------------
--------------------------------------------------------------------------------------------------------------------------------------------------------------------------------------------------------
--------------------------------------------------------------------------------------------------------------------------------------------------------------------------------------------------------
---------------------------------------------------------------------------------U----------------------------------------------------------------------------------------------------------------------
--------------------------------------------------------------------------------------------------------------------------------------------------------------------------------------------------------
---------------------------------------------------------------------------------------%%%%-------------------------------------ggkggggkggg-------------------------------------------------------------
-----------------------------------------------kkggggggggg---------------------------gggggkgg---------------------------------r--|||||||||-----------------%%%%%%----------%%%%%%%------CCSSSCS---------
------------------------------%%%%%------------------------------------%%%%%%%%%%%%%%--||||-------------------------%%%%%%%%%%%--|||||||||-%%%%%%%%%%------||||||----------|||||||----------------------
---------------------------g--|||||----------r------------%%%%%%%%%%---||||||||||||||--||||--%%%%%%%%%%%-----g----g-|||||||||||--|||||||||-||||||||||------||||||----g-----|||||||----------------------
------%%%%%-------------------|||||-%%%%%%%%%%------------||||||||||---||||||||||||||--||||--|||||||||||------------|||||||||||%%%%%%%%%%%%||||||||||----%%%%%%%%%%%-----%%%%%%%%%%%%%------------------
XXXXXX|||||XXXXXXXXXXXXXX---XXXXXXXX||||||||||XXXXXXXXXXXX||||||||||---||||||||||||||XXXXXXXX|||||||||||----XXXXXXXX|||||||||||||||||||||||||||||||||----|||||||||||-----|||||||||||||XXXXXXXXXXXXXXXFXX
