--------------------------------------------------------------------------------------------------------------------------------------------------------------------------------------------------------
--------------------------------------------------------------------------------------------------------------------------------------------------------------------------------------------------------
--------------------------------------------------------------------------------------------------------------------------------------------------------------------------------------------------------
--------------------------------------------------------------------------------------------------------------------------------------------------------------------------------------------------------
--------------------------------------------------------------------------------------------------------------------------------------------------------------------------------------------------------
--------------------------------------------------------------------------------------------------------------------------------------------------------------------------------------------------------
--------------------------------------------------------------------------------------------------------------------------------------------------------------------------------------------------------
--------------------------------------------------------------------------------------------------------------------------------------------------------------------------------------------------------
--------------------------------------------------------------------------------------------------------g----------------------------------------------------------------kr-----------------------------
-------------------------------------------g------------------------CBBBBCBUB-%%%%%%%%------------------------------------------------------------------------------------------------------------------
------------------------------------------------------------------------------||||||||------------------------------gr----------------------------------------------------------------------------------
-------------------------------------------------------------CBUC-------------||||||||-----%%%%%%%%%%%%-----------------------------------------------------r--k---k------------------------------------
------------------------------------------------------------------------------||||||||-----||||||||||||---%%%%%%%%%%%%%%%%%%%%-------%%%%-------------------------------------%%%%%%--------------------
---------------------------g--%%%%%%%-----------------------------------------||||||||-----||||||||||||---||||||||||||||||||||------%%%%%%-----------------%%%%%%%%%%%%%------|%%%%%---k----------------
------%%%%%-------------------|||||||-----------------------------------------||||||||-----||||||||||||---||||||||||||||||||||------||||||-----------------|||||||||||||------||||||--------------------
%%%%%%|||||%%%%%%%%%%%%%%---%%%%%%%%%%%%-----%%%%%%%%%%%%%%%%%%%%%%%%%%%%%%%%%||||||||-----||||||||||||---||||||||||||||||||||----%%%%%%%%%%%-----%%%%%%%%%|||||||||||||----%%%%%%%%%%-----%%%%%%%%%%F%%
