--------------------------------------------------------------------------------------------------------------------------------------------------------------------------------------------------------
--------------------------------------------------------------------------------------------------------------------------------------------------------------------------------------------------------
--------------------------------------------------------------------------------------------------------------------------------------------------------------------------------------------------------
--------------------------------------------------------------------------------------------------------------------------------------------------------------------------------------------------------
--------------------------------------------------------------------------------------------------------------------------------------------------------------------------------------------------------
--------------------------------------------------------------------------------------------------------------------------------------------------------------------------------------------------------
--------------------------------------------------------------------------------------------------------------------------------------------------------------SSSS--------------------------------------
--------------------------------------------------------------------------------------------------------------------------------------------------------------------------------------------------------
--------------------------------------------------------------------------------------------------------------------------------------------------------------------------------------------------------
------------------------------------------------------------------------g-------------------------------------------------------------------------------g----gg-----------------------------------------
----------------------------------U------------------------------------------------------------------------------------------------------------%%%%%%%%------%%%%%%-------------------------------------
--------------------------------------gkgggkggggkg--------------------%%%%%%%------------------------------------------------gggggggk----------||||||||------||||||----g-------k---k--------------------
----------------------------------------------------------------------|||||||-----------------------------%%%--------------r--||||||-----------||||||||----%%%%%%%%%%%--------------%%%%%%%%%-----------
--------------------------------------------------%%%%%%%%%%%%%%----%%%%%%%%%%%%%-------------------g----%%%%%-%%%%%%%%%%%%%--||||||-%%%%%%%%%%||||||||----|||||||||||%%%%%%%%%%%%%%|||||||||-----------
------%%%%%-----------------%%%%%%%%%%------------||||||||||||||----|||||||||||||------------------------|||||-|||||||||||||--||||||-||||||||||||||||||----||||||||||||||||||||||||||||||||||-----------
XXXXXX|||||XXXXXXXXXXXXXX---||||||||||XXXXXXXXXXXX||||||||||||||----|||||||||||||-----XXXXXXXXXXXX-----XXXXXXXX|||||||||||||XXXXXXXXX||||||||||||||||||----||||||||||||||||||||||||||||||||||XXXXXXXXFXX
