--------------------------------------------------------------------------------------------------------------------------------------------------------------------------------------------------------
--------------------------------------------------------------------------------------------------------------------------------------------------------------------------------------------------------
--------------------------------------------------------------------------------------------------------------------------------------------------------------------------------------------------------
--------------------------------------------------------------------------------------------------------------------------------------------------------------------------------------------------------
--------------------------------------------------------------------------------------------------------------------------------------------------------------------------------------------------------
--------------------------------------------------------------------------------------------------------------------------------------------------------------------------------------------------------
--------------------------------------------------------------------------------------------------------------------------------------------------------------------------------------------------------
---------------------------------------------U----------------------------------------------------------------------------------------------------------------------------------------------------------
----------------------------------------------------CBCBB----------------------------------------------------------------BBB-----------------g-----%%%%%%------------------BBBBCBCC---------------------
------------------------------------------------------------------------------%%%%%%-----------------------------------gkkgggkk--------------------||||||-----------------------------------------------
-------------------------------------------------ggggggkgkgg------------------|%%%%%%%%------------------------------r-----------------%%%%%%%%%%%%%%%%%%%%--------------------------%%%%%%%%%----------
-----------------------------------------%%%%%%%%-----------------------------|||||||||-----------------------%%%%%%%%---------%%%%%%%%||||||||||||||||||||-g--%g%%%%%%%%------------|||||||||----------
-----------------------------------------||||||||-----------%%%%%%%%%%%%%-----|||||||||-----------------------||||||||---------||||||||||||||||||||||||||||----|X||||||||%%%%%%%%%%%%|||||||||----------
-------------------------------g---------||||||||-----------|||||||||||||----%%%%%%%%%%%%%%------g---g-----g--||||||||%%%%%%%%%||||||||||||||||||||||||||||----|X|||||||||||||||||||||||||||||%%%%%%%F%%
------%%%%%------------------------------||||||||%%%%%%%%%%%|||||||||||||----||||||||||||||-------------------|||||||||||||||||||||||||||||||||||||||||||||----|X||||||||||||||||||||||||||||||||||||X||
%%%%%%|||||%%%%%%%%%%%%%%-----%%%%%%%%%%%||||||||||||||||||||||||||||||||----||||||||||||||-----%%%%%%%%%%%%%%|||||||||||||||||||||||||||||||||||||||||||||----|X||||||||||||||||||||||||||||||||||||X||
