--------------------------------------------------------------------------------------------------------------------------------------------------------------------------------------------------------
--------------------------------------------------------------------------------------------------------------------------------------------------------------------------------------------------------
--------------------------------------------------------------------------------------------------------------------------------------------------------------------------------------------------------
--------------------------------------------------------------------------------------------------------------------------------------------------------------------------------------------------------
--------------------------------------------------------------------------------------------------------------------------------------------------------------------------------------------------------
--------------------------------------------------------------------------------------------------------------------------------------------------------------------------------------------------------
--------------------------------------------------------------------------------------------------------------------------------------------------------------------------------------------------------
--------------------------------------------------------------------------------------------------------------------------------------------------------------------------------------------------------
-------------------------------------------------------------------------------%%%%%%---g---------------------------------------------------------------------------------------------------------------
-----------------------------------------------------BCUCBCCCB--%%%%%%%%%------||||||--------------U----------------------------------------------------------------------------------------------------
----------------------------------------------------------------|||||||||------||||||----------------------------------------------------------------------------------------------g--------------------
------------------------------%%%%%%%--------CBCUC--------------|||||||||------||||||------------------gkgkggggkkk--------------%%%%%%%-----------------ggggggggkggg----------------------------%%%%%F%%
------------------------------|||||||---------------------------|||||||||----%%%%%%%%%%------------------XXXXXXX----------------|||||||---------------r--XXXXXXXXXX---------------%%%%%%%%%%%%%%|||||X||
------------------------------|||||||---------------------------|||||||||----||||||||||---%%%%%%%%%%%%%--XXXXXXX--%%%%%%%%%-----|||||||----%%%%%%%%%%%%--XXXXXXXXXX-%%%%%%%%%%%%%%|||||||||||||||||||X||
------%%%%%-------------------|||||||---------------------------|||||||||----||||||||||---|||||||||||||--XXXXXXX--|||||||||----%%%%%|||----||||||||||||--XXXXXXXXXX-|||||||||||||||||||||||||||||||||X||
%%%%%%|||||%%%%%%%%%%%%%%---%%%%%%%%%%%%%%%%%%%%%%%%%%%%%%%%%%%%|||||||||----||||||||||---|||||||||||||%%%%%%%%%%%|||||||||---%%%%%%%%%%%%%||||||||||||%%%%%%%%%%%%%|||||||||||||||||||||||||||||||||X||
