--------------------------------------------------------------------------------------------------------------------------------------------------------------------------------------------------------
--------------------------------------------------------------------------------------------------------------------------------------------------------------------------------------------------------
---------------------------------------------------------------------------------CBBBB------------------------------------------------------------------------------------------------------------------
--------------------------------------------------------------------------------------------------------------------------------------------------------------------------------------------------------
--------------------------------------------------------------------------------------------------------------------------------------------------------------------------------------------------------
--------------------------------------------------------------------------------------------------------------------------------------------------------------------------------------------------------
--------------------------------------------------------------------------------%%%%%%%-------CCBU-----BBBCC--------------------------------------------------------------------------------------------
--------------------------------------------------------------------------------|||||||-------------------------CB2BBCBCCB---------------------------------------------------------------%%%%%----------
--------------------------------------------------------------------------------|||||||-----g--g-----g------------------------------------------U----------------------------------------|%%%|----------
--------------------------------------------------------------------------------|||||||-------------------------------------------------------------------------------------g------------|||||----------
------------------------------------------------------------------------------%%%%%%%%%%%%%%%%%%%%%%%%%%%%%%%%----------------------------------------%%%%%%%%%--------------------------|||||----------
------------------------------------------------------------------------------||||||||||||||||||||||||||||||||%%%%%%%%%%%%%%------------------------kkkgkkgggkkgg----------%%%%%%%%%%%%%%%%%%%%%--------
--------------------------g----%%%%%%%%---------------------------------------||||||||||||||||||||||||||||||||||||||||||||||-----------%%%%%%%%%%%%%--XXXXXXXXX------------|||||||||||||||||||||--------
-------------------------------||||||||-----g------------------------%%%%%%%%%||||||||||||||||||||||||||||||||||||||||||||||-----------|||||||||||||--XXXXXXXXX--%%%%%%%%%%|||||||||||||||||||||--------
------%%%%%--------------------||||||||-----------------------%%%----|||||||||||||||||||||||||||||||||||||||||||||||||||||||-----------|||||||||||||--XXXXXXXXX--|||||||||||||||||||||||||||||||--------
%%%%%%|||||%%%%%%%%%%%%%%----%%%%%%%%%%%%%%-----%%%%%%%%%-----|||----|||||||||||||||||||||||||||||||||||||||||||||||||||||||---%%%%%%%%|||||||||||||%%%%%%%%%%%%%|||||||||||||||||||||||||||||||%%%%%F%%
