--------------------------------------------------------------------------------------------------------------------------------------------------------------------------------------------------------
--------------------------------------------------------------------------------------------------------------------------------------------------------------------------------------------------------
--------------------------------------------------------------------------------------------------------------------------------------------------------------------------------------------------------
--------------------------------------------------------------------------------------------------------------------------------------------------------------------------------------------------------
--------------------------------------------------------------------------------------------------------------------------------------------------------------------------------------------------------
--------------------------------------------------------------------------------------------------------------------------------------------------------------------------------------------------------
--------------------------------------------------------------------------------------------------------------------------------------------------------------------------------------------------------
--------------------------------------------------------------------------------------------------------------------------------S22CSU------------------------------------------------------------------
------------------------------------------222CC2-----------g--------g-----------------------------------%%%%%%%%-----g-------g--------------------------------------------------------------------------
----------------------------------------kkgkggggkg-------------%%%%%---g--------------------------------||||||||----------------------------------------------------------------------------------------
--------------------------------------r------------------------|||||------------------------------------||||||||----%%%%%%%%%%---------------------U----------------------------------------------------
-------------------------%%%%%%%%%%%%%%-----------%%%%%%%%-----|||||----------------------------------%%%%%%%%%%%%%%||||||||||%%%%%%%%%%%--------------gggggggkgggk-------------------------------------
-------------------------||||||||||||||-----------||||||||-----|||||----------------------%%%%%%%%----|||||||||||||||||||||||||||||||||||---------------------------------------------------------------
-------------------------||||||||||||||%%%%%%%%%%%||||||||---%%%%%%%%%----------g---------||||||||----|||||||||||||||||||||||||||||||||||--------------------------%%%%%%%%%%%%%------------------------
------%%%%%--------------|||||||||||||||||||||||||||||||||---|||||||||--------------------|XXXXXX|----|||||||||||||||||||||||||||||||||||-----%%%%%%%%%------------|||||||||||||------------------------
XXXXXX|||||XXXXXXXXXXXXXX|||||||||||||||||||||||||||||||||---|||||||||-----XXXXXXXXXX---XXXXXXXXXXXXXX|||||||||||||||||||||||||||||||||||-----|||||||||XXXXXXXXXXXX|||||||||||||-----XXXXXXXXXXXXXXXXFXX
