--------------------------------------------------------------------------------------------------------------------------------------------------------------------------------------------------------
--------------------------------------------------------------------------------------------------------------------------------------------------------------------------------------------------------
--------------------------------------------------------------------------------------------------------------------------------------------------------------------------------------------------------
--------------------------------------------------------------------------------------------------------------------------------------------------------------------------------------------------------
--------------------------------------------------------------------------------------------------------------------------------------------------------------------------------------------------------
--------------------------------------------------------------------------------------------------------------------------------------------------------------------------------------------------------
-----------------------------------------------------------------------------------------------------------------------------------------US2SC----------------------------------------------------------
--------------------------------------------------------------------------------------------------------------------------------------------------------------------------------------------------------
--------------------------------------------------------------------------------------------------------------------------------------------------------------------------------------------------------
-----------------------------------------------------------------U----------------------------------r------------------SCUS2--%%%%%%%%------------------------------------------------------------------
-------------------------------------------------------------------------22SS-------------------------------------------------||||||||%%%%%%%%%%%------------CCSUSSSCC----------------------------------
---------------------------------------------------------------------gkgggkgkgk-------------------%%%%%%---------SSCSSU-------|||||||||||||||||||--------------------------SCS2CSSS---------------------
--------------------------------%%%%%%%-----------------------------------------------------------||||||----------------------|||||||||||||||||||%%%%%%%%%----------------------------------------------
--------------------------g-----|g|||||------------g------%%%%%%%%%%%----------%%%%%%%%%%%%-------||||||----------------------||||||||||||||||||||||||||||-----------------------------k----------------
------%%%%%---------------------|||||||-------------------|||||||||||----------||||||||||||-------||||||----------------------||||||||||||||||||||||||||||%%%%%%%%%%%%%%--------------------------------
XXXXXX|||||XXXXXXXXXXXXXX-----XXXXXXXXXXXXX----XXXXXXXXXXX|||||||||||XXXXXXXXXX||||||||||||-----XXXXXXXXXXXXXXXXXXXXXXXXXXXXXX||||||||||||||||||||||||||||||||||||||||||XXXXXXXXXXXXXXXXXXXXXXXXXXXXXFXX
