--------------------------------------------------------------------------------------------------------------------------------------------------------------------------------------------------------
--------------------------------------------------------------------------------------------------------------------------------------------------------------------------------------------------------
--------------------------------------------------------------------------------------------------------------------------------------------------------------------------------------------------------
--------------------------------------------------------------------------------------------------------------------------------------------------------------------------------------------------------
--------------------------------------------------------------------------------------------------------------------------------------------------------------------------------------------------------
--------------------------------------------------------------------------------------------------------------------------------------------------------------------------------------------------------
-------------------------------------------------------------------------------------------------------------------------------------------------------------------SS-----------------------------------
-------------------------------------------------U------------------------------------------------------------------------------------------------------------------------------------------------------
---------------------------------------------------------CSSCSS----------------------------------------------------------------------------------------------------------gg-----------------------------
-------------------------------------------------------------------------------g--g------------------------------------------------2CCCS----------------------------------------------------------------
-----------------------------------------------------gkgkkgkggkgg-----------------------------------------------------------------ggggggkg-------------%%%%%%%%%%%%%%%%%-----------%%%%%%%%%%%----------
--------------------------------%%%%%--%%%%%%%%%%%%%%---------------------------------------------------------------------------r----------------------|||||||||||||||||---%%%%%%%%|||||||||||----------
--------------------------------|||||--||||||||||||||------------%%%%%%%%%%%%%-----------------------------------------%%%%%%%%%%---------%%%%%%%%%%%%%|||||||||||||||||---|||||||||||||||||||%%%%%%%F%%
--------------------------------|||||--||||||||||||||------------|||||||||||||-------------------------------gg---g----||||||||||---------||||||||||||||||||||||||||||||---||||||||||||||||||||||||||%||
------%%%%%---------------------|||||--||||||||||||||%%%%%%%%%%%%|||||||||||||-----------------------------------------||||||||||%%%%%%%%%||||||||||||||||||||||||||||||---|||||||||||||||||||||||||||||
XXXXXX|||||XXXXXXXXXXXXXX-----XXXXXXXXX|||||||||||||||||||||||||||||||||||||||---XXXXXXXXXXXXXX---XXXXXXXXXX---XXXXXXXX|||||||||||||||||||||||||||||||||||||||||||||||||---|||||||||||||||||||||||||||||
