--------------------------------------------------------------------------------------------------------------------------------------------------------------------------------------------------------
--------------------------------------------------------------------------------------------------------------------------------------------------------------------------------------------------------
--------------------------------------------------------------------------------------------------------------------------------------------------------------------------------------------------------
--------------------------------------------------------------------------------------------------------------------------------------------------------------------------------------------------------
--------------------------------------------------------------------------------------------------------------------------------------------------------------------------------------------------------
--------------------------------------------------------------------------------------------------------------------------------------------------------------------------------------------------------
--------------------------------------------------------------------------------------------------------------------------------------------------------------------------------------------------------
--------------------------------------------------------------------------------------------------------------------------------------------------------------------------------------------------------
--------------------------------------------------------------------------------------------------------------------------------------------------------------------------------------------------------
--------------------------------------------------------------------Tt--------------------------------------------------Tt-----------Tt-----------------------------------------------------------------
--------------------Tt----------------------------------------------tt----------------------Tt--------------------------tt-----------tt-----------------------------------------------------------------
--------------------tt--CU------------------------------------------tt----------------------tt--------------------------tt--------F--tt-----------------------------------------------------BBCC22------
--------------------tt------%%%%----%%%%%%%%----%%%%--------%%%--%%%%%%%%%-----------------Gtt---%%%%--------------%%%%%%%%%%----%%%%%%%%%-----------------------------------%%%%%-----%%%%%---G----G---
-----------------%%%%%%%%%--||||----||||||||----||||-UU-----|||--|||||||||---------------%%%%%%%%%%||C-------------||||||||||----|||||||||-%%%%%%----------------------------|||||-----|||||-%%%%%%%%--%
-----------------|||||||||--||||----||||||||----||||--------|||--|||||||||---------------||||||||||||--------------||||||||||----|||||||||-||||||----------------------------|||||-----|||||-||||||||--|
%%%%%%%%%%%%%%%%%%%%%%%%%%%%||||----||||||||----||||%%%%%%%%|||%%%%%%%%%%%%%%%%%%%%%%%%%%%%%%%%%%%%%%%%%%%%%%%%%%%%||||||||||%%%%|||||||||%%%%%%%%%%%%%%%%%%%%%%%%%%%%%%%%%%%|||||-----|||||%%%%%%%%%%%%
