--------------------------------------------------------------------------------------------------------------------------------------------------------------------------------------------------------
--------------------------------------------------------------------------------------------------------------------------------------------------------------------------------------------------------
--------------------------------------------------------------------------------------------------------------------------------------------------------------------------------------------------------
--------------------------------------------------------------------------------------------------------------------------------------------------------------------------------------------------------
--------------------------------------------------------------------------------------------------------------------------------------------------------------------------------------------------------
--------------------------------------------------------------------------------------------------------------------------------------------------------------------------------------------------------
--------------------------------------------------------------------------------------------------------------------------------------------------------------------------------------------------------
--------------------------------------------------------------------------------------------------------------------------------------------------------------------------------------------------------
--------------------------------------------------------------------------------------------------------------------------------------------------------------------------------------------------------
-----------------------------------------------------------------------------------------------------------------------------------------------------------------Tt-------------------------------------
-----------------------------------------------------------------------------------------------------------------------------------------------------------------tt-------------------------------------
----------------------------------------------------------------------------------------------------------------------------------F------------------------------tt----------------------------------K--
---------------------------------------------------------------------------%%%%G-%%-------------------G-------------------------%%%%%--------------------------KGtt---------K%%%%%-------------------%%%
-------------------------------------%%%------%%%--------------------------|||||%||%%%%%%%%%%%%------%%%%----%%%%---------------|||||----%%%%%---------------%%%%%%%%%%%%%%%%|||||222CU%%%%%%%%%%----|||
-------------------------------------|||------|||--------------------------||||||||||||||||||||------||||----||||---------------|||||----|||||---------------|||||||||||||||||||||-----||||||||||----|||
%%%%%%%%%%%%%%%%%%%%%%%%%%%%%%%%%%%%%|||------|||%%%%%%%%%%%%%%%%%%%%%%%%%%|||||%||%%%%||||||||%%%%%%||||----||||%%%%%%%%%%%%%%%%%%%%%%%%%%%%%%%%%%%%%%%%%%%%||||||||||%%%%%%%%%%%%%%%%||||||||||%%%%|||
