--------------------------------------------------------------------------------------------------------------------------------------------------------------------------------------------------------
--------------------------------------------------------------------------------------------------------------------------------------------------------------------------------------------------------
--------------------------------------------------------------------------------------------------------------------------------------------------------------------------------------------------------
--------------------------------------------------------------------------------------------------------------------------------------------------------------------------------------------------------
--------------------------------------------------------------------------------------------------------------------------------------------------------------------------------------------------------
--------------------------------------------------------------------------------------------------------------------------------------------------------------------------------------------------------
--------------------------------------------------------------------------------------------------------------------------------------------------------------------------------------------------------
--------------------------------------------------------------------------------------------------------------------------------------------------------------------------------------------------------
--------------------------------------------------------------------------------------------------------------------------------------------------------------------------------------------------------
------------------------------------------------------------Tt------------------------------------------------------------------------------------------------------------------------------------------
------------------------------------------------------K-----tt---------------------------------------------------------------------------------------------K--------------------------------------------
---------------------------------------------------%%%%%%G%%tt---G---------------------------U2S----------------------------------F---K-------------------%%%%----%%%%%%%%%%--------------KG------------
------------------------K------------2S2U%%%%%%%%%%||||%%%%%%%%%%%-------------------------------------------------------%%%%%%---%---%%%----%%%----------||||----||||||||||-------------%%%----%%%%----
---------------------G-%%%%%----%%%%%----|||||||||||||||||||||||||----------K--------------------------------------------||||||S--|---|||----|||----------||||----||||||||||-------------|||----||||----
--------------%%%%%%%%%|||||----|||||----|||||||||||||||||||||||||----------%%%-----%%%----------------------------------||||||---|---|||----|||----------||||----|||||%%%%%%%%%%%-------|||----||||----
XXXXXXXXXXXXXX||||||||||||||----|||||XXXXXXXXXXXXXXXXXX|||||||||||XXXXXXXXXX|||-----|||XXXXXXXXXXXXXXXXXXXXXXXXXXXXXXXXXX||||||XXXXXXX|||----|||XXXXXXXXXXXXXXXXXXXXXXX|||||||||||XXXXXXX|||----||||XXXX
