--------------------------------------------------------------------------------------------------------------------------------------------------------------------------------------------------------
--------------------------------------------------------------------------------------------------------------------------------------------------------------------------------------------------------
--------------------------------------------------------------------------------------------------------------------------------------------------------------------------------------------------------
--------------------------------------------------------------------------------------------------------------------------------------------------------------------------------------------------------
--------------------------------------------------------------------------------------------------------------------------------------------------------------------------------------------------------
--------------------------------------------------------------------------------------------------------------------------------------------------------------------------------------------------------
--------------------------------------------------------------------------------------------------------------------------------------------------------------------------------------------------------
--------------------------------------------------------------------------------------------------------------------------------------------------------------------------------------------------------
-----------------------------------------------------------------------------------------------------------------------------Tt-------------------------------------------------------------------------
------------------------------------------------------Tt---------------------------------------------------------------------tt-------------------------------------------------------------------------
------------------------------------------------------tt---------------------------------------------------------------------tt-----------Tt------------------------------------------------------------
------------------------------------------------------tt----------------------------------------------------------Tt------%%Tt%%%%F-------tt-------------------------------------------------Tt---------
---------------------UBBCU22--------------------------tt-----------------2C2U-------------------------------------tt------||tt||||X-------tt------------------------------G------------------tt---------
---------------G----------------------------------%%%%%%%%%%%UUUCC2-----------%%%------%%%%-----------------------tt----%%%%%%%%%%%----%%%%%%%%%--------------%%%-----%%%%%%%%%%%%%%---------tt---------
--------%%%%%--%%%--------------%%%%%---%%%%------|||||||||||-----------------|||------||||----%%%%%----%%%%%%%%%%%%%%%-|||||||||||----|||||||||--------------|||-----||||||||||||||-----%%%%%%%%%%-----
%%%%%%%%|||||--|||%%%%%%%%%%%%%%|||||---||||%%%%%%|||||||||||%%%%%%%%%%%%%%%%%|||------||||%%%%|||||----|||||||||||||||%%%%%%%%%%%%%%%%%%%%%%%%%%%%%%%%%%%%%%%|||-----|||%%%%%%%%%%%%%%%%||||||||||%%%%%
