--------------------------------------------------------------------------------------------------------------------------------------------------------------------------------------------------------
--------------------------------------------------------------------------------------------------------------------------------------------------------------------------------------------------------
--------------------------------------------------------------------------------------------------------------------------------------------------------------------------------------------------------
--------------------------------------------------------------------------------------------------------------------------------------------------------------------------------------------------------
--------------------------------------------------------------------------------------------------------------------------------------------------------------------------------------------------------
--------------------------------------------------------------------------------------------------------------------------------------------------------------------------------------------------------
--------------------------------------------------------------------------------------------------------------------------------------------------------------------------------------------------------
--------------------------------------------Tt----------------------------------------------------------------------------------------------------------------------------------------------------------
--------------------------------------------tt----------------------------------------------------------------------------------------------------------------------------------------------------------
--------------------------------------------tt----------------------------------------Tt----------------------------------------------------------------------------------------------------------------
--------------------------------------------tt----------------------------------------tt--------------K-------------------------------------------------------------------------------------------------
---------------------------------------%%%%%%%%%%%%-----------------------------------tt------------K-%%%%%-----------G-----------F-------------------------%%%------------------------------G----------
--------------------2S-----------------||||||||||||---------------------------------K-tt-----%%%%%-%%K|||||-%%%%%%%%%%%-----------%-----------%%%%------%%%-|||---%%%-----------%%%%%%%%%----%%%--------
------------------------%%%%%----%%%---||||||||||||--------------------------------%%%%%%%%%%||%%%%%%%%||||-|||||||||||-----------|-----------||||------|||-|||---|||-----------|||||||||----|||CC---K--
------------------------|||||----|||---||||||||||||----------%%%%%%%%--------------||||||||||||||||||||||||-|||||||||||-----------|-----------||||------|||-|||---|||-----------|||||||||----|||--%%%%%-
XXXXXXXXXXXXXXXXXXXXXXXX|||||----|||XXXXXXXXXXXXXXXXXXXXXXXXX||||||||XXXXXXXXXXXXXXXXXXXXXXXXXX||||||||XXXXX|||||||||||XXXXXXXXXXXXXXXXXXXXXXX||||------|||XXXXXXXXXXXXXXXXXXXXXXXXX|||||----|||XX|||||-
