--------------------------------------------------------------------------------------------------------------------------------------------------------------------------------------------------------
--------------------------------------------------------------------------------------------------------------------------------------------------------------------------------------------------------
--------------------------------------------------------------------------------------------------------------------------------------------------------------------------------------------------------
--------------------------------------------------------------------------------------------------------------------------------------------------------------------------------------------------------
--------------------------------------------------------------------------------------------------------------------------------------------------------------------------------------------------------
--------------------------------------------------------------------------------------------------------------------------------------------------------------------------------------------------------
--------------------------------------------------------------------------------------------------------------------------------------------------------------------------------------------------------
----------------------------------------------------Tt--------------------------------------------------------------------------------------------------------------------------------------------------
----------------------------------------------------tt--------------------------------------------------------------------------------------------------------------------------------------------------
----------------------------------------------------tt--------------------------------------------------------------------------------------------------------------------------------------------------
----------------------------------------------------tt--------------------------------------------------------------------------------------------------------------------------------------------------
-------------------------------------------------%%%%%%%%%----%%%%%Tt%%%----------------------------------------------------------F------------------------------------------------------------K-------%
----------------------------UB2B---------------------|||||----|||||tt|||2BBB------------------------------------------------------------------------------------%%%%------------------------%%%%%--%%%%|
-------------------%%%%------------%%%%%%%%%--------X|||||----U%%%%%%%%%%%------%%%%------------------------%%%-----%%%%%--------------%%%----------------%%%%--||||------------------------|||||--|||||
-----------%%%%%%%%%%||------------|||||||||-----XXXX|||||----X|||||||||||------||||------------------------|||-----|||||--------------|||-%%%%-----%%%---||||--||||------------------------|||||--|||||
%%%%%%%%%%%||||||||||%%%%%%%%%%%%%%%%%%%%%%%%%%%%%%%%%%%%%%%%%%%%%%%%%%%%%%%%%%%%%%%%%%%%%%%%%%%%%%%%%%%%%%%|||-----|||||%%%%%%%%%%%%%%%%%%||||-----|||%%%%%%%%%||||%%%%%%%%%%%%%%%%%%%%%%%%|||||--||||%
