--------------------------------------------------------------------------------------------------------------------------------------------------------------------------------------------------------
--------------------------------------------------------------------------------------------------------------------------------------------------------------------------------------------------------
--------------------------------------------------------------------------------------------------------------------------------------------------------------------------------------------------------
--------------------------------------------------------------------------------------------------------------------------------------------------------------------------------------------------------
--------------------------------------------------------------------------------------------------------------------------------------------------------------------------------------------------------
--------------------------------------------------------------------------------------------------------------------------------------------------------------------------------------------------------
--------------------------------------------------------------------------------------------------------------------------------------------------------------------------------------------------------
--------------------------------------------------------------------------------------------------------------------------------------------------------------------------------------------------------
--------------------------------------------------------------------------------------------------------------------------------------------------------------------------------------------------------
----------------------------------------------------------------------------------------------Tt--------------------------------------------------------------------------------------------------------
----------------------------------------------------------------------------------------------tt--------------------------------------------------------------------------------------------------------
------------------------------------------------------------%%%%%%----------------------------tt---------K-------K----------------F-------Tt-----G---------Tt---------------------------USSS------------
---------------------------------%%%%%------%%%-------------||||||------------------------%%%%%%%%%%-%%%%%------%%%---------------%-------tt-----SSS2S-----tt----%%%%%--%%%-----------------------------
-------------------%%%%---G------|||||------|||-------------||||||--%%%---%%%%------------||||||||||-|||||------|||---------------|-%%%%%Gtt---------------tt----|||||--|||-----------------------------
-------------------||||---%%%----|||||------|||--%%%%%%%%%%%||||||--|||---||||------------||||||||||-|||||------|||----%%%%%%-----|-||%%%%%%%%%%%-------%%%%%%%%%|||||--|||-----------------------------
XXXXXXXXXXXXXXXXXXXXXXXXXX|||XXXX|||||------|||XX|||||||||||XXXXXXXXXXXXXXXXXXXXXXXXXXXXXX||||||||||X|||||------|||XXXX||||||XXXXXXXXX|||||||||||XXXXXXX||||||||||||||--|||XXXXXXXXXXXXXXXXXXXXXXXXXXXXX
