--------------------------------------------------------------------------------------------------------------------------------------------------------------------------------------------------------
--------------------------------------------------------------------------------------------------------------------------------------------------------------------------------------------------------
--------------------------------------------------------------------------------------------------------------------------------------------------------------------------------------------------------
--------------------------------------------------------------------------------------------------------------------------------------------------------------------------------------------------------
--------------------------------------------------------------------------------------------------------------------------------------------------------------------------------------------------------
--------------------------------------------------------------------------------------------------------------------------------------------------------------------------------------------------------
--------------------------------------------------------------------------------------------------------------------------------------------------------------------------------------------------------
---------------------------------------------------------------------------------------------------------------Tt---------------------------------------------------------------------------------------
------------------------------------------------------------------------------Tt-------------------------------tt---------------------------------------------------------------------------------------
------------------------------------------------------------------------------tt-------------------------------tt---------------------------------------------------------------------------------------
------------------------------------------------------------------------------tt--------G----------------------tt---------G--------KK-------------------------------------------------------------------
------------------------------------------------------------------------------tt%%%G%%%%%%--Tt--------------%%%%%%%%%----2UCBC--BBFCC-------------------------------------------------------------------
----------------------%%%%-------------------------------------%%%-------%%%%%%%%%%%---|||--tt--------------|||||||||------------------------------------------GG-----------C2U-------------------------
--------%%%%%%%%%-----||||-----------------------K-------------|||-------|||||||||||-XX|||--tt--------------|||||||||--------------------------------%%%%%-----%%%%%--U2U-------------------------------
--------|||||||||-----||||-------------------%%%%%--%%%%%------|||-------|||||||||||XXX%%%%%%%%%%%----------|||||||||--------------------------------|||||-----|||||-------------------%%%%%------%%%---
%%%%%%%%|||||||||%%%%%||||%%%%%%%%%%%%%%%%%%%|||||--|||||%%%%%%|||%%%%%%%|||||||||||%%%|||||||||||%%%%%%%%%%%%%%%%%%%%%%%%%%%%%%%%%%%%%%%%%%%%%%%%%%%|||||-----|||||%%%%%%%%%%%%%%%%%%%|||||------|||%%%
