--------------------------------------------------------------------------------------------------------------------------------------------------------------------------------------------------------
--------------------------------------------------------------------------------------------------------------------------------------------------------------------------------------------------------
--------------------------------------------------------------------------------------------------------------------------------------------------------------------------------------------------------
--------------------------------------------------------------------------------------------------------------------------------------------------------------------------------------------------------
--------------------------------------------------------------------------------------------------------------------------------------------------------------------------------------------------------
--------------------------------------------------------------------------------------------------------------------------------------------------------------------------------------------------------
--------------------------------------------------------------------------------------------------------------------------------------------------------------------------------------------------------
--------------------------------------------------------------------------------------------------------------------------------------------------------------------------------------------------------
--------------------------------------------------------------------------------------------------------------------------------------------------------------------------------------------------------
------------------------------------------------------------------------Tt------------------------------------------------------------------------------------------------------------------------------
----------------------Tt------------------------------------------------tt------------------------------------------------------------------------------------------------------------------------------
----------------------tt---------------------------------------K--------tt--------------------------------------------------------F--G------------------------------------------------------------------
----------------------tt------------------------------%%%%%%%%%%%%------tt---------------------------------------------------------B2UU-----------------------------------------------------------------
----------------------tt------------------------------||||||||||||-%%%%%%%%%%%-----------%%%%%%%%%------------------------------------------B2CCB2C------------------------------------------------G----
-------------------%%%%%%%%%--------------------------||||||||||||-|||||||||||-----------|||||||||-------------------------------------------------------------------------------------------------%%%%-
%%%%%%%%%%%%%%%%%%%|||||||||%%%%%%%%%%%%%%%%%%%%%%%%%%||||||||||||%|||||||||||%%%%%%%%%%%|||||||||%%%%%%%%%%%%%%%%%%%%%%%%%%%%%%%%%%%%%%%%%%%%%%%%%%%%%%%%%%%%%%%%%%%%%%%%%%%%%%%%%%%%%%%%%%%%%%%%%||||-
