--------------------------------------------------------------------------------------------------------------------------------------------------------------------------------------------------------
--------------------------------------------------------------------------------------------------------------------------------------------------------------------------------------------------------
--------------------------------------------------------------------------------------------------------------------------------------------------------------------------------------------------------
--------------------------------------------------------------------------------------------------------------------------------------------------------------------------------------------------------
--------------------------------------------------------------------------------------------------------------------------------------------------------------------------------------------------------
--------------------------------------------------------------------------------------------------------------------------------------------------------------------------------------------------------
--------------------------------------------------------------------------------------------------------------------------------------------------------------------------------------------------------
--------------------------------------------------------------------------------------------------------------------------------------------------------------------------------------------------------
--------------------------------------------------------------------------------------------------------------------------------------------------------------------------------------------------------
---------------------------------------------------------------------------------------------------Tt-------------------------------------Tt------------------------------------------------------------
----------------------------------------Tt---------------------------------------------------------tt------K------------------------------tt------------------------------------------------------------
-------------------------CB2U2----------tt-------------BBU---------------------------------G-------tt-----BCC2B-G-K---------------F----KK-tt------------------------------------------------------------
----------------------------------------tt----------%%%%--------%%%%%--%%%--------------BB2CBB-%%%%%%%%%%%-----%%%%---%%%-----UU2U----%%%%%%%%%%---------------------------------------------------U2BU2
------------------------------------%%%%%%%%%-------||||--------|||||--|||---------------------|||||||||||-----||||---|||-------------||||||||||--------------------------------------------------------
------------------------------------|||||||||-------||||--------|||||--|||---------------------|||||||||||-----||||---|||-------------||||||||||--------------------------------------------------------
%%%%%%%%%%%%%%%%%%%%%%%%%%%%%%%%%%%%|||||||||%%%%%%%%%%%%%%%%%%%|||||--|||%%%%%%%%%%%%%%%%%%%%%|||||||||||%%%%%||||---|||%%%%%%%%%%%%%||||||||||%%%%%%%%%%%%%%%%%%%%%%%%%%%%%%%%%%%%%%%%%%%%%%%%%%%%%%%%
