--------------------------------------------------------------------------------------------------------------------------------------------------------------------------------------------------------
--------------------------------------------------------------------------------------------------------------------------------------------------------------------------------------------------------
--------------------------------------------------------------------------------------------------------------------------------------------------------------------------------------------------------
--------------------------------------------------------------------------------------------------------------------------------------------------------------------------------------------------------
--------------------------------------------------------------------------------------------------------------------------------------------------------------------------------------------------------
--------------------------------------------------------------------------------------------------------------------------------------------------------------------------------------------------------
--------------------------------------------------------------------------------------------------------------------------------------------------------------------------------------------------------
--------------------------------------------------------------------------------------------------------------------------------------------------------------------------------------------------------
------------------------------------------------------------------------------------------------------------------------------------Tt----------------Tt------------------------------------------------
------------------------------------------------------------------------------------------------------------------------------------tt----------------tt------------------------------------------------
-------------------------------------------------------------------------------------------K----------------------Tt----------------tt----------------tt------------------------------------------------
-------------------------------------------G-----------------------------------------------%%%%-------------------tt-----------%%%F%%%%%%-------------tt%G%%--------------------------------------------
-------%%%%-------------------------%%%%--%%%------------%%%%%%%%%--------------------%%%%%%%%%%------------------tt-----------|||%||||||--------%%%%%%%%%%%-%%%%%%%%%%%-----------------------CS2SUU---
-------||||----------------------CSS||||--|||------------|||||||||------%%%%----------||||||||||-----------------Ktt-----------||||||||||--------|||||||||||-|||||||||||-------%%%%-----%%%%%----%%%%%%%
-------||||-------------------------||||--|||------------|||||||||------||||----------||||||||||---------------%%%%%%%%--------||||||||||%%%%%%%%|||||||||||-|||||||||||-------||||-----|||||----|||||||
XXXXXXX||||XXXXXXXXXXXXXXXXXXXXXXXXX||||--|||XXXXXXXXXXXX|||||||||XXXXXX||||XXXXXXXXXXXXXXXXXXXXXXXXXXXXXXXXXXX||||||||XXXXXXXXXXXXXXXXXX|||||||||||||||||||XXXXXXXXXXXXXXXXXXX||||-----|||||XXXXXXXXXXX
