--------------------------------------------------------------------------------------------------------------------------------------------------------------------------------------------------------
--------------------------------------------------------------------------------------------------------------------------------------------------------------------------------------------------------
--------------------------------------------------------------------------------------------------------------------------------------------------------------------------------------------------------
--------------------------------------------------------------------------------------------------------------------------------------------------------------------------------------------------------
--------------------------------------------------------------------------------------------------------------------------------------------------------------------------------------------------------
--------------------------------------------------------------------------------------------------------------------------------------------------------------------------------------------------------
--------------------------------------------------------------------------------------------------------------------------------------------------------------------------------------------------------
--------------------------------------------------------------------------------------------------------------------------------------------------------------------------------------------------------
--------------------------------------------------------------------------------------------------------------------------------------------------------------------------------------------------------
--------------------------------------------------------------------------------------------------------------------------------------------------------------------------------------------------------
--------------------------------------------------------------------------------------------------------------------------------------------------K-----------------------------------------------------
----------------------------------------------------------------------------------Tt----2SS---------------------------------------F---------%%%%%%%%%---------------------------------------------------
---------------CU----------------------------------%%%%%%-------------------------tt----------------------------------------------%--------%%%%||||||---------------------------------------------------
--------------------------------------G------------||||||----------------------G--tt--------------------%%%%%-----%%%%%-----------|--------||||||||%%%-----------%%%%%---%%%%%--------------------------
-----------------------------%%%%%---%%%%----------||||||--------------------%%%%%%%%%%%----------------|||||-----|||||-----------|--------|||||||||||-----------|||||---|||||--------------------------
XXXXXXXXXXXXXXXXXXXXXXXXXXXXX|||||---||||XXXXXXXXXX||||||XXXXXXXXXXXXXXXXXXXX|||||||||||XXXXXXXXXXXXXXXX|||||-----|||||XXXXXXXXXXXXXXXXXXXXXXXXXXXXXXXXXXXXXXXXXX|||||---|||||XXXXXXXXXXXXXXXXXXXXXXXXXX
