--------------------------------------------------------------------------------------------------------------------------------------------------------------------------------------------------------
--------------------------------------------------------------------------------------------------------------------------------------------------------------------------------------------------------
--------------------------------------------------------------------------------------------------------------------------------------------------------------------------------------------------------
--------------------------------------------------------------------------------------------------------------------------------------------------------------------------------------------------------
--------------------------------------------------------------------------------------------------------------------------------------------------------------------------------------------------------
--------------------------------------------------------------------------------------------------------------------------------------------------------------------------------------------------------
--------------------------------------------------------------------------------------------------------------------------------------------------------------------------------------------------------
--------------------------------------------------------------------------------------------------------------------------------------------------------------------------------------------------------
--------------------------------------------------------------------------------------------------------------------------------------------------------------------------------------------------------
--------------------------Tt----------------------------------------------------------------------------------------------------------------------------------------------------------------------------
--------------------------tt---------------------------------------------------------------------------------------G------------------------------------------------------------------------------------
--------------------------tt---------K-------------------Tt-------------------------------------------------------%%%%%%---%%%%%%%F---------------------------------------------------------------------
------------------G-------tt-------%%%-------------------tt----------%%%--------------------K---------------------||||||---|||||%%%%%--%%%%-------------------------------------------------------------
---------------%%%%----%%%%%%%%----|||-----------------K-tt----------|||-------------------%%%---%%%--------------||||||---||||||||||--||||-------------G----SS2S22-------------K---------------K-------
---------------||||----||||||||----|||----------------%%%%%%%%%------|||-------------------|||---|||--------------||||||---||||||||||--||||--------%%%%%%--------------%%%%%%%%%%%%-----%%%%%%%%%%----%%
XXXXXXXXXXXXXXX||||XXXX||||||||XXXX|||XXXXXXXXXXXXXXXX|||||||||XXXXXX|||XXXXXXXXXXXXXXXXXXX|||---|||XXXXXXXXXXXXXXXXXXXXXXXXXXXX|||||XXXXXXXXXXXXXX||||||XXXXXXXXXXXXXX||||||||||||XXXXX||||||||||XXXX||
