--------------------------------------------------------------------------------------------------------------------------------------------------------------------------------------------------------
--------------------------------------------------------------------------------------------------------------------------------------------------------------------------------------------------------
--------------------------------------------------------------------------------------------------------------------------------------------------------------------------------------------------------
--------------------------------------------------------------------------------------------------------------------------------------------------------------------------------------------------------
--------------------------------------------------------------------------------------------------------------------------------------------------------------------------------------------------------
--------------------------------------------------------------------------------------------------------------------------------------------------------------------------------------------------------
--------------------------------------------------------------------------------------------------------------------------------------------------------------------------------------------------------
-----------------------------------------------------------Tt-------------------------------------------------------------------------------------------------------------------------------------------
-----------------------------------------------------------tt------------------------------------------Tt-----------------------------------------------------------Tt----------------------------------
-----------------------------------------------------------tt----------------------------Tt------------tt-----------------------------------------------------------tt----------------------------------
-----------------------Tt----------------------------------tt----------------------------tt------------tt-------------------Tt--------------------------------------tt----------------------------------
-----------CCUC--------tt------------------------------%%%-%%K%%%%-----------------------tt------------tt-------------------tt----F----------%%%--------------------tt-K--------------------------------
-----------------------tt----------------------------K-%%%%%%%%%||-----------------------tt-K------%%%%%%%%%G---------------tt----%----------|||-----------------%%%%%%%%%-------------------------%%%--
-----------------------tt-------------------------UUCC2|||||||||||------------------%%%%%%%%%%%----||||||%%%%%-----------%%%%%%%%%|----------|||---G---------G---|||||||||-------------------------|||--
------------------%%%%%%%%%%%%-------------------------|||||||||||------------------|||||||||||--%%%%%||||||||-----------||||||||||-%%%%%%%%%%||--%%%%%----%%%%%-|||||||||--------%%%%%%%%%%%%-----|||--
XXXXXXXXXXXXXXXXXX||||||||||||XXXXXXXXXXXXXXXXXXXXXXXXXXXXXXXXXXXXXXXXXXXXXXXXXXXXXXXXXXXXXXXXXXX|||||XXXXXXXXXXXXXXXXXXXXXXXXXXXXXX||||||||||XXXX|||||----|||||XXXXXXXXXXXXXXXXXX||||||||||||XXXXX|||--
