--------------------------------------------------------------------------------------------------------------------------------------------------------------------------------------------------------
--------------------------------------------------------------------------------------------------------------------------------------------------------------------------------------------------------
--------------------------------------------------------------------------------------------------------------------------------------------------------------------------------------------------------
--------------------------------------------------------------------------------------------------------------------------------------------------------------------------------------------------------
--------------------------------------------------------------------------------------------------------------------------------------------------------------------------------------------------------
--------------------------------------------------------------------------------------------------------------------------------------------------------------------------------------------------------
--------------------------------------------------------------------------------------------------------------------------------------------------------------------------------------------------------
----------------------------------Tt--------------------------------------------------------------------------------------------------------------------------------------------------------------------
----------------------Tt----------tt----------Tt--------Tt--------Tt------------------------------------------------------------------------------------------------------------------------------------
----------------------tt----------tt----------tt--------tt--------tt------------------------------------------------------------------------------------------------------------------------------------
----------------------tt-------K--tTt---------ttK-------tt--------tt------------------------------------------------------------------------------------------------------------------------------------
-----------------%%%%%%%%%%%-%%%%%%tt%%-%%%%%%%%%%K%%%%%%%%%%%---%%%%-------------------------------------------------------------F-----------------------------G-G-------------------------------------
-----------------|||||||||||-||||||tt||-G|%%%%%%%%%%%|||||||||%%%%%%%%%------------------------------------------G--------K-----------------------%%%-----------%%%%%%-------------------------G--------
-----------------|||||||||||-|%%%%%%%%%%BU|||||||||||||||||||||||||||||--------------%%%%----%%%---%%%%%%%%----%%%%---%%%%%-----K-----------------|||-----------||||||---------------%%%----%%%%%-------
-----------------|||||||||||-|||||||||||XX|||||||||||||||||||||||||||||--------------||||----|||---||||||||----||||---|||||-----%%%----%%%%%------|||-----------|||%%%%%%%%%%--------|||----|||||-------
%%%%%%%%%%%%%%%%%%%%%%%%%%%%%%%%%%%%%%%%%%%%%%%%%%%%%%%%%%%%%%%%%%%%%%%%%%%%%%%%%%%%%||||----|||%%%%%%%%%%%%%%%||||---|||||%%%%%|||----|||||%%%%%%|||%%%%%%%%%%%%%%||||||||||%%%%%%%%|||----|||||%%%%%%%
