--------------------------------------------------------------------------------------------------------------------------------------------------------------------------------------------------------
--------------------------------------------------------------------------------------------------------------------------------------------------------------------------------------------------------
--------------------------------------------------------------------------------------------------------------------------------------------------------------------------------------------------------
--------------------------------------------------------------------------------------------------------------------------------------------------------------------------------------------------------
--------------------------------------------------------------------------------------------------------------------------------------------------------------------------------------------------------
--------------------------------------------------------------------------------------------------------------------------------------------------------------------------------------------------------
--------------------------------------------------------------------------------------------------------------------------------------------------------------------------------------------------------
--------------------------------------------------------------------------------------------------------------------------------------------------------------------------------------------------------
------------------------------------------------------------------------------------------------------------------------------------------------------------------------------Tt------------------------
------------------------------------------------------------------------------------------------------------------------------------------------------------------------------tt------------------------
------------------------------------------------------------------------------------------------------------------------------------------------------------------------------tt------------------------
------------------K----------------------------------------------------------------------G----------------------------------------F-----------------------------------%%%%%%%%%t------------------------
----------%%%%---%%%----C22UC2C-------------------------------------%%%%%------------%%%%%%---K--------------------------------------2UC---------------------%%%%-----||||%%%%%%%%%---------G-----------
----------||||---|||------------%%%%%---%%%-------------%%%%---%%%%%|||||------------||||||222CUB------------------------------------------------------------||||-----||CC|||||||||---------UUUU2BC-----
----------||||---|||------------|||||---|||%%%---%%%%%--||||---||||||||||------------||||||---------------------%%%----%%%%%---------------------------------||||-----||XX|||||||||---------------------
%%%%%%%%%%||||---|||%%%%%%%%%%%%|||||---||||||---|||||%%||||---||||||||||%%%%%%%%%%%%%%%%%%%%%%%%%%%%%%%%%%%%%%%|||----|||||%%%%%%%%%%%%%%%%%%%%%%%%%%%%%%%%%||||%%%%%%%%%%%%%%%%%%%%%%%%%%%%%%%%%%%%%%%
