--------------------------------------------------------------------------------------------------------------------------------------------------------------------------------------------------------
--------------------------------------------------------------------------------------------------------------------------------------------------------------------------------------------------------
--------------------------------------------------------------------------------------------------------------------------------------------------------------------------------------------------------
--------------------------------------------------------------------------------------------------------------------------------------------------------------------------------------------------------
--------------------------------------------------------------------------------------------------------------------------------------------------------------------------------------------------------
--------------------------------------------------------------------------------------------------------------------------------------------------------------------------------------------------------
--------------------------------------------------------------------------------------------------------------------------------------------------------------------------------------------------------
--------------------------------------------------------------------------------------------------------------------------------------------------------------------------------------------------------
--------------------------------------------------------------------Tt----------------------------------------------------------------------------------------------------------------------------------
--------------------------------------------------------------------tt---------------------------------------------------------------------------------Tt-----------------------------------------------
--------------------------------------------------------------------tt---------------------------------------------------------------------------------tt-----------------------------------------------
-----------------------------------------------------------G--------tt------------------------------------------------------------F----%%%%%--------G--tt-----------------------------------------------
-----------C2UBU---------------------------------%%%%%----%%%%---%%%%%%%%%%----%%%%------------------------------------------------%%%%%%%%|-------%%%%%%%%%%%%%%%%%---------%%%%----%%%---------K------
--------%%%%------------%%%-----%%%%%------------|||||----||||---||||||||||----||||------------G------%%%%%-------G-G--------------|||||||||-------|||||||||||||||||---------||||----|||-%%%%%%%%%------
--------||||------------|||-----|||||------------|||||----||||---||||||||||----||||-----%%%--%%%%%----|||||------%%%%%%%%%%%-------|||||||||-------|||||||||||||||||---------||||----|||-|||||||||------
%%%%%%%%%%%%%%%%%%%%%%%%|||-----|||||%%%%%%%%%%%%|||||----||||%%%%%%%%%%%%%%%%%||||%%%%%|||--|||||%%%%%%%%%%%%%%%|||||||||||%%%%%%%||||||||%%%%%%%%%%%%%%%%%%%%%%%%%%%%%%%%%%||||----|||%%%%%%%%%%%%%%%%
