--------------------------------------------------------------------------------------------------------------------------------------------------------------------------------------------------------
--------------------------------------------------------------------------------------------------------------------------------------------------------------------------------------------------------
--------------------------------------------------------------------------------------------------------------------------------------------------------------------------------------------------------
--------------------------------------------------------------------------------------------------------------------------------------------------------------------------------------------------------
--------------------------------------------------------------------------------------------------------------------------------------------------------------------------------------------------------
--------------------------------------------------------------------------------------------------------------------------------------------------------------------------------------------------------
--------------------------------------------------------------------------------------------------------------------------------------------------------------------------------------------------------
------------------------------------------------------------------------------------------Tt------------------------------------------------------------------------------------------------------------
------------------------------------------------------------------------------------------tt-----------------------------------------------------------------------Tt-------------------Tt--------------
------------------------------------------------------------------------------------------tt-----------------------------------------------------------------------tt-------------------tt--------------
------------------------------------------K-----------------------------------------------tt-----------------------------------------------------------------------tt-------------------tt--------------
---------------------------------------SCC2------------------------------Tt------------%%%%%%%%%----------------------------------F--------------------------------tt-------------------tt%%%%----------
-----------%%%%--------%%%%%%-%%%%------------------------------K--%%%%--tt--------2SSS|||||||||---%%%%---------------------------%---------------------------%%%%%%%%%%%------------%%%%%%%%K%---------
-----------||||--------||||||-||||-------------------%%%%%----%%%%%||||G-tt------------|||||||||---||||-----------------K---------|-----%%%%------------------|||||||||||------------||||||||%|%--------
-----------||||--------||%%%%%%%%%%------------------|||||----|||||||%%%%%%%%%%--------|||||||||---||||----------------%%%----%%%%%-----||||------------------|||||||||||------------|||||||||||--------
XXXXXXXXXXXXXXXXXXXXXXXXX||||||||||XXXXXXXXXXXXXXXXXX|||||----|||||XX||||||||||XXXXXXXXXXXXXXXXXXXX||||XXXXXXXXXXXXXXXX|||----|||||XXXXXXXXXXXXXXXXXXXXXXXXXXX|||||||||||XXXXXXXXXXXX||||||||XXXXXXXXXXX
