--------------------------------------------------------------------------------------------------------------------------------------------------------------------------------------------------------
--------------------------------------------------------------------------------------------------------------------------------------------------------------------------------------------------------
--------------------------------------------------------------------------------------------------------------------------------------------------------------------------------------------------------
--------------------------------------------------------------------------------------------------------------------------------------------------------------------------------------------------------
--------------------------------------------------------------------------------------------------------------------------------------------------------------------------------------------------------
--------------------------------------------------------------------------------------------------------------------------------------------------------------------------------------------------------
--------------------------------------------------------------------------------------------------------------------------------------------------------------------------------------------------------
--------------------------------------------------------------------------------------------------------------------------------------------------------------------------------------------------------
-------------------------------------------------------Tt------------------------------------------------------------------------------Tt---------------------------------------------------------------
-------------------------------------------Tt----------tt------------------------------------------------------------------------------tt---------------------------------------------------------------
-------------------------------------------tt----------tt------------------------------------------------------------------------------tK--------------------------------------------------------------T
-------------%%%---------------------------tt--------%%tt--K-------------------------------CUUB2----------------------------------F-CBCCB--------------------------------------------------------------t
-------------|||-------------------------G-tt---G-%%%%%%%%%%%%-------------G-----------------------------------%%%-----%%%----------%%%%%%%%---------------------%%%%%%--------------------------------t
---------------|-----------------%%%%%%%%%%%%%%%%%||||||||||||------%%%----%%%%--------------------------------|||-----|||----------||||||||---------------------||||||------------------------------G-t
-------------XX|-----------------|||||||||||||||||||||||||||||------|||----||||--------------------------------|||-----|||----------|%%%||||---------------------||||||%%%%---%%%-------------------%%%%
%%%%%%%%%%%%%%%%%%%%%%%%%%%%%%%%%||||||%%%%%%%%%%%||||||||||||%%%%%%|||----||||%%%%%%%%%%%%%%%%%%%%%%%%%%%%%%%%|||-----|||%%%%%%%%%%%|||%%%%%%%%%%%%%%%%%%%%%%%%%%%%%%%||||---|||%%%%%%%%%%%%%%%%%%%||||
