--------------------------------------------------------------------------------------------------------------------------------------------------------------------------------------------------------
--------------------------------------------------------------------------------------------------------------------------------------------------------------------------------------------------------
--------------------------------------------------------------------------------------------------------------------------------------------------------------------------------------------------------
--------------------------------------------------------------------------------------------------------------------------------------------------------------------------------------------------------
--------------------------------------------------------------------------------------------------------------------------------------------------------------------------------------------------------
--------------------------------------------------------------------------------------------------------------------------------------------------------------------------------------------------------
--------------------------------------------------------------------------------------------------------------------------------------------------------------------------------------------------------
-------------------------Tt-----------------------------------------------------------------------------------------------------------------------------------------------------------------------------
-------------------------tt-----------------------------------------------------------------------------------------------------------------------------------------------------------------Tt----------
-------------------------tt----------------------------------------------------------------------------------------Tt-----------------------------------------------------------------------tt----------
-------GK----------------tt---K-------------------------------------G---------------Tt-----------------------------tt-----------------------------------------------------------------------tt----------
------SCCSSS---------%%%%%%%%%%-----------------------------%%%%%%%%%---2SC---------tt-----------------------------tt---G---------F------------SS-------------------------%%%%%%%%%---------tt--------%%
---------------------||||||||||%%%%%%%%%%%---------CCUCC----|||||||||---------------tt---G---------G-------K--%%%%%%%%%%%%------%%%%-----%%%%-----------------------------|||||||||------%%%%%%%%%----||
---------------------|||||||||||||||||||||------------------|||||||||----------%%%%%%%%%%%-------%%%%%%%%%%%--||||||||||||------||||-----||||-----------------------------|||||||||------|||||||||----||
---------------------|||||||||||||||||||||------------------|||||||||----------|||||||||||-------|||||||||||--||||||||||||------||||-----||||-----------------------------|||||||||------|||||||||----||
XXXXXXXXXXXXXXXXXXXXXXXXXXXXXXX|||||||||||XXXXXXXXXXXXXXXXXXXXXXXXXXXXXXXXXXXXXXXXXXXXXXXXXXXXXXX|||||||||||XX||||||||||||XXXXXX||||-----||||XXXXXXXXXXXXXXXXXXXXXXXXXXXXXXXXXXXXXXXXXXXXXXXXXXXXXXXXXXX
