--------------------------------------------------------------------------------------------------------------------------------------------------------------------------------------------------------
--------------------------------------------------------------------------------------------------------------------------------------------------------------------------------------------------------
--------------------------------------------------------------------------------------------------------------------------------------------------------------------------------------------------------
--------------------------------------------------------------------------------------------------------------------------------------------------------------------------------------------------------
--------------------------------------------------------------------------------------------------------------------------------------------------------------------------------------------------------
--------------------------------------------------------------------------------------------------------------------------------------------------------------------------------------------------------
--------------------------------------------------------------------------------------------------------------------------------------------------------------------------------------------------------
--------------------------------------------------------------------------------------------------------------------------------------------------------------------------------------------------------
------------Tt------------------------------------------------------------------------------------------------------------------------------------------------------------------------------------------
------------tt--------------------------------------------------------------------------------------------------------------------------------Tt--------------------------------------------------------
------------tt--------------------------------Tt----------------------------------------------------------------------------------------Tt----tt---Tt---------------------------------------------------
------------tt--------------------------------tt----------------------------------------------------------------------------------F---KGtt----tt---tt---------------%%%%-----------BBBCCC2--------------
-------%%%%%%%%%%%--------------------------K-tt---------------------------------%%%%%%%%%%------------------------------------%%%%%%%%%tt-%K%%%%%Ktt---------------||||-----------%%%%%----------------
-------|||||||||||------------------------%%%%%%%%%%--------%%%%----%%%%---------||||||||||-%%%%---%%%%----------%%%%%%%%%%----|||||%%%%%%%%%%%|%%%%%%%%------------||||------%%%%-|||||---G-----K------
-------|||||||||||------------------------||||||||||--------||||----||||---------||||||||||-||||---||||----------||||||||||----|||||||||||||||||||||||||------------||||------||||-|||||--%%%%---%%%----
%%%%%%%%%%%%%%%%%%%%%%%%%%%%%%%%%%%%%%%%%%||||||||||%%%%%%%%||||----||||%%%%%%%%%%%%%%%%%%%%||||---||||%%%%%%%%%%%%%%%%%%%%%%%%%%%%%%%%%%%%%%%%%%%%%%%%%%%%%%%%%%%%%%%%%%%%%%%||||%%%%%%%%||||---|||%%%%
