--------------------------------------------------------------------------------------------------------------------------------------------------------------------------------------------------------
--------------------------------------------------------------------------------------------------------------------------------------------------------------------------------------------------------
--------------------------------------------------------------------------------------------------------------------------------------------------------------------------------------------------------
--------------------------------------------------------------------------------------------------------------------------------------------------------------------------------------------------------
--------------------------------------------------------------------------------------------------------------------------------------------------------------------------------------------------------
--------------------------------------------------------------------------------------------------------------------------------------------------------------------------------------------------------
--------------------------------------------------------------------------------------------------------------------------------------------------------------------------------------------------------
--------------------------------------------------------------------------------------------------------------------------------------------------------------------------------------------------------
-------------Tt-----------------------------------------------------------------------------------------------------------------------------------------------------------------------------------------
-------------tt-------------------------------------------------------------------------------------------------------------Tt--------------------------------------------------------------------------
-------------tt-G-------------------TG----------------------------------------------------------Tt--------------------G-----tt------------------------------------------------------Tt------------------
--------%%%%%%%%%%%--------%%%%%%-%%tt%%%%%%%%--------------------------------------------------tt--------------------B-----tt----F---------------%%%%%%%%%%%%--------------------%%tt%%%%--------------
--------|||||||||||--------||||||-||tt||||||||--------------------------------------------------tt------------------K-------tt----------------%%%%%%%%%|||||||--------------------||tt||||--------------
--------||||-----||--------||||||-||tt||||||||---%%%%%%%%%%-----%%%%%%%%-%-------------------%%%%%%%%%%----%%%%--%%%%%--%%%%%%%%%-------------||||||||||||||||--------------------K|tt|G||--------------
--------||||XXXXX||--------||||||%%%%%%%%%%|||---||||||||||-----||||%%%%%%%%%%---------------||||||||||----||||--|||||-%%%|||||||-------%%%%%-||||||||||||||||---%%%%%-----------%%%%%%%%|--------------
%%%%%%%%%%%%%%%%%%%%%%%%%%%%%%%%%||||||||||%%%%%%||||||||||%%%%%%%%%||||||||||%%%%%%%%%%%%%%%||||||||||%%%%||||--|||||%|||%%%%%%%%%%%%%%|||||%%%%%%%%%%%%%%%%%%%%|||||%%%%%%%%%%%||||||||%%%%%%%%%%%%%%%
