--------------------------------------------------------------------------------------------------------------------------------------------------------------------------------------------------------
--------------------------------------------------------------------------------------------------------------------------------------------------------------------------------------------------------
--------------------------------------------------------------------------------------------------------------------------------------------------------------------------------------------------------
--------------------------------------------------------------------------------------------------------------------------------------------------------------------------------------------------------
--------------------------------------------------------------------------------------------------------------------------------------------------------------------------------------------------------
--------------------------------------------------------------------------------------------------------------------------------------------------------------------------------------------------------
--------------------------------------------------------------------------------------------------------------------------------------------------------------------------------------------------------
--------------------------------------------------------------------------------------------------------------------------------------------------------------------------------------------------------
--------------------------------------------------------------------------------------------------------------------------------------------------------------------------------------------------------
--------------------------------------------------------------------------------------------------------------------------------------------------------------------Tt----------------------------------
--------------------------------------------------------------------------------------------------------------------------------------------------------------------tt----------------------------------
---------------------K-K----------------------------------------------------------------------------------------------------------F---------------------------------tt----------------------------------
-----------------U22BUBC--------------------------------------------------------------------------------------------------------------%%%%%%%%%%%%-------------%%%%%%%%%%%%-----------------------------
-------------------------------------------------------------------K------------%%%%%%%%---------------------------------22BCUCB------||||||||||||-------------||||||||||||-----------------------------
----------------------------------%%%%%%%%----------------%%%%%----%%%%---------||||||||----------------------------------------------||||||||||||-------------||||||||||||-----------------------------
%%%%%%%%%%%%%%%%%%%%%%%%%%%%%%%%%%||||||||%%%%%%%%%%%%%%%%|||||----||||%%%%%%%%%%%%%%%%%%%%%%%%%%%%%%%%%%%%%%%%%%%%%%%%%%%%%%%%%%%%%%%||||||||||||%%%%%%%%%%%%%||||||||||||%%%%%%%%%%%%%%%%%%%%%%%%%%%%%
