--------------------------------------------------------------------------------------------------------------------------------------------------------------------------------------------------------
--------------------------------------------------------------------------------------------------------------------------------------------------------------------------------------------------------
--------------------------------------------------------------------------------------------------------------------------------------------------------------------------------------------------------
--------------------------------------------------------------------------------------------------------------------------------------------------------------------------------------------------------
--------------------------------------------------------------------------------------------------------------------------------------------------------------------------------------------------------
--------------------------------------------------------------------------------------------------------------------------------------------------------------------------------------------------------
--------------------------------------------------------------------------------------------------------------------------------------------------------------------------------------------------------
---------------------------------------------------------------------------------------------------------Tt---------------------------------------------------------------------------------------------
---------------------------------------------------------------------------------------------------------tt--------------------------------------------------------Tt-----------------------------------
---------------------------------------------------------------------------------------------------------tt--------------------------------------------------------tt-----------------------------------
---------------------------------------------------------------------------------------------------------tt--------------------------------------------------------tt-----------------------Tt----------
-----------------------------G%%%%%%%%%%------------K--------------------------------------%%%%-----%%%%%%%%%%%-------------------F-----------------------------K-Ktt-G---------------------tt%%%%%%----
---------------------%%%%%%%-%%K||||||||-%%%-----C2CBCB---------------------------BU-------||||-----|||||||||||-----------------------------------------------%%%%%%%%%%-------%%%%%--------tt||||||----
---------------------||%%%%%%%%%%|||||||-|||------K----%%%-----%%%-------------K-----------||||-----|||||||||||-----------------------------------------------||||||||||-------|||||------GGtt||||||----
---------------------|||||||||||||||||||-|||---%%%%----|||-----|||------------%%%----------||||-----|||||||||||---------------%%%%%---------------------------||||||||||-------|||||---%%%%%%%%%%|||----
%%%%%%%%%%%%%%%%%%%%%%%%%%%%%%%%%%%%%%%%%%%%%%%||||%%%%|||-----|||%%%%%%%%%%%%|||%%%%%%%%%%%%%%%%%%%%%%%%%%%%%%%%%%%%%%%%%%%%%|||||%%%%%%%%%%%%%%%%%%%%%%%%%%%||||||||||%%%%%%%%%%%%%%%||||||||||%%%%%%%
