--------------------------------------------------------------------------------------------------------------------------------------------------------------------------------------------------------
--------------------------------------------------------------------------------------------------------------------------------------------------------------------------------------------------------
--------------------------------------------------------------------------------------------------------------------------------------------------------------------------------------------------------
--------------------------------------------------------------------------------------------------------------------------------------------------------------------------------------------------------
--------------------------------------------------------------------------------------------------------------------------------------------------------------------------------------------------------
--------------------------------------------------------------------------------------------------------------------------------------------------------------------------------------------------------
--------------------------------------------------------------------------------------------------------------------------------------------------------------------------------------------------------
--------------------------------------------------------------------------------------------------------------------------------------------------------------------------------------------------------
--------------------------------------------------------------------------------------------------------------------------------------------------------------------------------------------------------
----------------------------------------------------Tt--------------------------------------------------------------------Tt----------------------------------------------------------------------------
----------------------------------------------------tt-----------------------------------------G--------------------------tt----------------------------------------------------------------------------
----------------------------------------------------tt-----------------------G---------------%%%%%%%%%%%----------%%%%----tt---%%%F%%%%%%--------------------------------------------------------------K
-------------------------------%%%---%%%------------tt%%%--------------UCCUBCU---------------|||||||||||CBCB------|||%%%%%%%%%%%||X||||||------------------G------G-----------------%%%%---%%%%%%%%%%%%%
-------------------------------|||---|||---------%%%%%%%%------------------------------------|||||||||||----------||||||||||||||||X||||||---------------%%%%%-----%%%%-------%%%----||||---|||||||||||||
-------------------------------|||---|||---------||||||||------------------------------------|||%%%||%%%----------||||||||||||||||%%%%%||--%%%%%--%%%%%-|||||-----||||-------|||----||||---|||||||||||||
%%%%%%%%%%%%%%%%%%%%%%%%%%%%%%%|||---|||%%%%%%%%%||||||||%%%%%%%%%%%%%%%%%%%%%%%%%%%%%%%%%%%%%%%||||||||%%%%%%%%%%%%%|||||||||||%%|||||%%%%|||||--|||||%|||||-----||||%%%%%%%|||%%%%||||---|||||||||||||
