--------------------------------------------------------------------------------------------------------------------------------------------------------------------------------------------------------
--------------------------------------------------------------------------------------------------------------------------------------------------------------------------------------------------------
--------------------------------------------------------------------------------------------------------------------------------------------------------------------------------------------------------
--------------------------------------------------------------------------------------------------------------------------------------------------------------------------------------------------------
--------------------------------------------------------------------------------------------------------------------------------------------------------------------------------------------------------
--------------------------------------------------------------------------------------------------------------------------------------------------------------------------------------------------------
--------------------------------------------------------------------------------------------------------------------------------------------------------------------------------------------------------
--------------------------------------------------------------------------------------------------------------------------------------------------------------------------------------------------------
--------------------------------------------------------------------------------------------------------------------------------------------------------------------------------------------------------
--------------------------------------------------------------------------------------------------------------------------------------------------------------------------------------------------------
-------------------------------------G----------------------------Tt------------------------------------------------------------------------------------------------------------------------------------
----------B22C222-----------------BU2B----------------------------tt--UB---------------------------CU--------------%%%%%%---------F---------------------------------------------------------------------
------------KK--------------G------------------------%%%%%%%%%%---tt-K---------------------------------------------||||G|-------------------------------------------------------------------------------
----------%%%%%%------------%%%----------------------||||||||||%%%%%%%%%-------%%%------%%%----------%%%%%%%%%%----||%%%%-%%%%%%%%%%--------------------------------------------------------------------
----------||||||------------|||----------------------|||||||||||||||||||-------|||------|||----------||||||||||----||||||-||||||||||--------------------------------------------------------------------
%%%%%%%%%%||||||%%%%%%%%%%%%|||%%%%%%%%%%%%%%%%%%%%%%||||||||||%%%%%%%%%%%%%%%%|||------|||%%%%%%%%%%||||||||||%%%%%%||||%%%%%%%%%%%%%%%%%%%%%%%%%%%%%%%%%%%%%%%%%%%%%%%%%%%%%%%%%%%%%%%%%%%%%%%%%%%%%%%
