--------------------------------------------------------------------------------------------------------------------------------------------------------------------------------------------------------
--------------------------------------------------------------------------------------------------------------------------------------------------------------------------------------------------------
--------------------------------------------------------------------------------------------------------------------------------------------------------------------------------------------------------
--------------------------------------------------------------------------------------------------------------------------------------------------------------------------------------------------------
--------------------------------------------------------------------------------------------------------------------------------------------------------------------------------------------------------
--------------------------------------------------------------------------------------------------------------------------------------------------------------------------------------------------------
--------------------------------------------------------------------------------------------------------------------------------------------------------------------------------------------------------
--------------------------------------------------------------------------------------------------------------------------------------------------------------------------------------------------------
--------------------------------------------------------------------------------------------------------------------------------------------------------------------------------------------------------
--------------------------------Tt----------------------------------------------------------------------------------------------------------------------------------------------------------------------
--------------------------------tt---------------------------KK--------------------------------------------G--------------------------------------------------------------------------------------------
--------------------%%%%------G-tt--------%%%------%%%%%%%%%%%%-----------------------------------------%%%%%%%%%%----------------F--K-------------------------------------%K%%%%%%---------------------
--------------------||||-----%%%%%%%%-----|||------||||||||||||-------------SSSC22---------------%%%%%%-||||||||||--------------2CSCS%%%%---%%%----------------------------%%%%%%%%%%------------------%
--------------------||||-----||||||||-----|||------||||||||%%%%----------------------------------||||||-||||||||||-------------------||||---|||---K-----------------K------||||||||||------------------|
--------------------||||-----||||||||-----|||------||||||||||||--------------------------%%%%%%%%%%%|||-||||||||||-------------------||||---|||%%%%%%---%%%%%----%%%%%-----||||||||||------------------|
XXXXXXXXXXXXXXXXXXXXXXXXXXXXX||||||||XXXXXXXXXXXXXXXXXXXXXXXXXXXXXXXXXXXXXXXXXXXXXXXXXXXX|||||||||||XXXXXXXXXXXXXXXXXXXXXXXXXXXXXXXXX||||---|||||||||XXX|||||----|||||XXXXXXXXXXXXXXXXXXXXXXXXXXXXXXXXX|
