--------------------------------------------------------------------------------------------------------------------------------------------------------------------------------------------------------
--------------------------------------------------------------------------------------------------------------------------------------------------------------------------------------------------------
--------------------------------------------------------------------------------------------------------------------------------------------------------------------------------------------------------
--------------------------------------------------------------------------------------------------------------------------------------------------------------------------------------------------------
--------------------------------------------------------------------------------------------------------------------------------------------------------------------------------------------------------
--------------------------------------------------------------------------------------------------------------------------------------------------------------------------------------------------------
--------------------------------------------------------------------------------------------------------------------------------------------------------------------------------------------------------
--------------------------------------------------------------------------------------------------------------------------------------------------------------------------------------------------------
--------------------------------------------------------------------------------------------------------------------------------------------------------------------------------------------------------
--------------Tt----------------------------------------------------------------------------------------------------------------------------------------------------------------------------------------
--------------tt-------------------------------------------------------------------------------------------------------------------------G-----------------------G--------------------------------------
--------------tt---G-----------------------------------%%%%%%%%%------------------------------------------------------------------F------BB---------------------2C2BUUU---------------------------------
-----------%%%%%%%%%-------BUBC------------------------|||||||||----------%%%---------------------------------K%K%%%%%%%---------------------------------------------------------------------------%%%%%
------------||||||||--------------%%%---%%%%-----------|||||||||----------|||-------------------------K-----%%%%%%%%%%%|----G---------K--------%%%%------------------------------------------------|||||
-----------X||||||||--------------|||---||||-----------|||||||||----------|||-------------------%%%%%%%%%%--||||||||||||----%%%%%---%%%%%------||||------------------------------------------------|||||
%%%%%%%%%%%%%%%%%%%%%%%%%%%%%%%%%%|||---||||%%%%%%%%%%%%%%%%%%%%%%%%%%%%%%%%%%%%%%%%%%%%%%%%%%%%||||||||||%%%%%%%%%%%%%%%%%%|||||---|||||%%%%%%||||%%%%%%%%%%%%%%%%%%%%%%%%%%%%%%%%%%%%%%%%%%%%%%%%|||||
