--------------------------------------------------------------------------------------------------------------------------------------------------------------------------------------------------------
--------------------------------------------------------------------------------------------------------------------------------------------------------------------------------------------------------
--------------------------------------------------------------------------------------------------------------------------------------------------------------------------------------------------------
--------------------------------------------------------------------------------------------------------------------------------------------------------------------------------------------------------
--------------------------------------------------------------------------------------------------------------------------------------------------------------------------------------------------------
--------------------------------------------------------------------------------------------------------------------------------------------------------------------------------------------------------
--------------------------------------------------------------------------------------------------------------------------------------------------------------------------------------------------------
--------------------------------------------------------------------------------------------------------------------------------------------------------------------------------------------------------
--------------------------------------------------------------------------------------------------------------------------------------------------------------------------------------------------------
--------------------------------------------------------------------------------------------------------------------------------------------------------------------------------------------------------
-------------------G------------------------------------------------------------------------------------------------------------------------------------------------------------------------------------
------------%%-%%%%%%%------------------------------------------------------------------------------------------------------------F---------------------------------------------------------------------
------%%%%%%||-|||K|||----------------------------------------------------------------------------%%%%%%%%%%%---------------------%%%%----K-------------------------------------------------------------
------|||%%%%%%%%%%%||------------------------------------------------K---------------------------|||||||||||---------------------||||--%%%%%%%%%%%---------------------------------------%%%%----------
------||||||||||||||||------------------------------------------%%%%--%%%%%-----------------------|||||||||||---------------------||||--|||||||||||---------------------------------------||||---------%
%%%%%%%%%%%%%%%%%%%%%%%%%%%%%%%%%%%%%%%%%%%%%%%%%%%%%%%%%%%%%%%%||||--|||||%%%%%%%%%%%%%%%%%%%%%%%%%%%%%%%%%%%%%%%%%%%%%%%%%%%%%%%||||%%%%%%%%%%%%%%%%%%%%%%%%%%%%%%%%%%%%%%%%%%%%%%%%%%%%||||%%%%%%%%%|
