--------------------------------------------------------------------------------------------------------------------------------------------------------------------------------------------------------
--------------------------------------------------------------------------------------------------------------------------------------------------------------------------------------------------------
--------------------------------------------------------------------------------------------------------------------------------------------------------------------------------------------------------
--------------------------------------------------------------------------------------------------------------------------------------------------------------------------------------------------------
--------------------------------------------------------------------------------------------------------------------------------------------------------------------------------------------------------
--------------------------------------------------------------------------------------------------------------------------------------------------------------------------------------------------------
--------------------------------------------------------------------------------------------------------------------------------------------------------------------------------------------------------
--------------------------------------------------------------------------------------------------------------------------------------------------------------------------------------------------------
-------------------------------Tt---------------------------------------------------Tt------------------------Tt----------------------------------------------------------------------------------------
-------------------------Tt----tt---------------------------------------------------tt------------------------tt-----------------------Tt---------------------------------------------------------------
-------------------------tt----tt---------------------------------------------------tt------------------------tt-----------------------tt---------------------------------------------------------------
-------------------------tt%%%%%%%%%----------------------G-KBCU----------------G-UB22BC----------------------tt------------------F----tt---------------------------------------------------------------
--------------K----------tt|||%G%%%|-%%%------------------%%%---%%%%%----%%%%--%%%%%%%%%%%%---------------%%%%%%%%%%----------------X-%%%%%%--------------------G---------------------------------------
-------%%%--%%%------%%%%%%%%%%%||||-|||------------------|||---|||||----||||--||||||||||||-%%%---%%%%----||||||||||----------------X-||||||-U---K--------------%%%%------------------------------------
-------|||--|||------|||||||||||||||-|||------------------|||---|||||----||||--||||||||||||-|||---||||----||||||||||--------------%%%%||||||--%%%%-----%%%%%----||||------------------------------------
%%%%%%%|||--|||%%%%%%%%%%%%%%%%%%%%%%|||%%%%%%%%%%%%%%%%%%|||%%%|||||----||||%%%%%%%%%%%%%%%|||---||||%%%%%%%%%%%%%%%%%%%%%%%%%%%%||||||||||%%||||-----|||||%%%%%%%%%%%%%%%%%%%%%%%%%%%%%%%%%%%%%%%%%%%%
