--------------------------------------------------------------------------------------------------------------------------------------------------------------------------------------------------------
--------------------------------------------------------------------------------------------------------------------------------------------------------------------------------------------------------
--------------------------------------------------------------------------------------------------------------------------------------------------------------------------------------------------------
--------------------------------------------------------------------------------------------------------------------------------------------------------------------------------------------------------
--------------------------------------------------------------------------------------------------------------------------------------------------------------------------------------------------------
--------------------------------------------------------------------------------------------------------------------------------------------------------------------------------------------------------
--------------------------------------------------------------------------------------------------------------------------------------------------------------------------------------------------------
--------------------------------------------------------------------------------------------------------------------------------------------------------------------------------------------------------
--------------------------------------------------------------------------------------------------------------------------------------------------------------------------------------------------------
--------------------------------------------------------------------------------------------------------------------------------------------------------------------------------------------------------
---------------------------------------------------------------G-G--------------------------------------------------------------------------------------------------------------------------------------
--------------------------------------------------------------2CUC----------------------------------------G-----------------------F--------------------------------------------G-------------G--------K-
--------------------------------------------------------------K-----------------------------------------%%%%%%%%%-----------------%----------------------------------------C2SSU-------%%%%%%%-%----%%%-
----------------------------------------%%%%%%---------------%%%%%%%%%----------------------------------|||||||||-----------------|------------------------------------------------%%%-|||||||-|-K--|||-
----------------------------------------||||||---------------|||||||||---%%%%%--------------------------|||||||||-----------------|------------------------------------------------|||-|||%%%%%%%%%-|||-
XXXXXXXXXXXXXXXXXXXXXXXXXXXXXXXXXXXXXXXX||||||XXXXXXXXXXXXXXXXXXXXXXXXXXX|||||XXXXXXXXXXXXXXXXXXXXXXXXXX|||||||||XXXXXXXXXXXXXXXXXXXXXXXXXXXXXXXXXXXXXXXXXXXXXXXXXXXXXXXXXXXXXXXXXX|||XXXX|||||||||XXXXX
