--------------------------------------------------------------------------------------------------------------------------------------------------------------------------------------------------------
--------------------------------------------------------------------------------------------------------------------------------------------------------------------------------------------------------
--------------------------------------------------------------------------------------------------------------------------------------------------------------------------------------------------------
--------------------------------------------------------------------------------------------------------------------------------------------------------------------------------------------------------
--------------------------------------------------------------------------------------------------------------------------------------------------------------------------------------------------------
--------------------------------------------------------------------------------------------------------------------------------------------------------------------------------------------------------
--------------------------------------------------------------------------------------------------------------------------------------------------------------------------------------------------------
--------------------------------------------------------------------------------------------------------------------------------------------------------------------------------------------------------
-------------------------------------------------------------------------------------------------------------------------------------------------------------------------Tt-----------------------------
-------------------------------------------------------------------------------------------------------------------------------------------------------------------------tt-----------------------------
----------------------------------------------------------------Tt-------------------------------------------------------------------------------------------------------tt-----------------------------
--------------------------------------------------------%%%%%%%%tt----------------------------------------------------------------F--------------------------------------tt-G-%%%%-------------------%%%
-------------------------------------------G------------||||||||tt----------------------------------------------------------------%-----------------------------------%%%%%%%%||||-------------2S2C2-|||
---------------------K-----------------%%%%%---%%%%%----||||||||tt------------------------------------------%%%%%-----------------|--------222SUS---------------------||||||||||||--------%%%%%------||C
-------------%%%%%--%%%%%--------------|||||---|||||----|||%%%%%%%%%%%%-------------------------------------|||||-----------------|-----------------------%%%---------||||||||||||--------|||||------|||
XXXXXXXXXXXXX|||||--|||||XXXXXXXXXXXXXX|||||---|||||XXXXXXX||||||||||||XXXXXXXXXXXXXXXXXXXXXXXXXXXXXXXXXXXXX|||||XXXXXXXXXXXXXXXXXXXXXXXXXXXXXXXXXXXXXXXXX|||XXXXXXXXXXXXXXXXXXXXXXXXXXXXXXXXXXXXXXXXXXX
