--------------------------------------------------------------------------------------------------------------------------------------------------------------------------------------------------------
--------------------------------------------------------------------------------------------------------------------------------------------------------------------------------------------------------
--------------------------------------------------------------------------------------------------------------------------------------------------------------------------------------------------------
--------------------------------------------------------------------------------------------------------------------------------------------------------------------------------------------------------
--------------------------------------------------------------------------------------------------------------------------------------------------------------------------------------------------------
--------------------------------------------------------------------------------------------------------------------------------------------------------------------------------------------------------
--------------------------------------------------------------------------------------------------------------------------------------------------------------------------------------------------------
--------------------------------------------------------------------------------------------------------------------------------------------------------------------------------------------------------
--------------------------------------------------------------------------------------------------------------------------------------------------------------------------------------------------------
--------------------------Tt---------------------------------------------------------------------------------------------------------------------------------------------------------Tt-----------------
--------------------------tt-----------------Tt--------------------------------------------------------------------------------------------------------------------------------------tt-----------------
------------------%%%%%---tt-----------------tt-----------------------------------------------------------------------------------F----------------------K----G----------------------tt---K-------------
------------------||||K---tt-G-%%%-----------tt-----------------------------------------KK-------------------------2UCSUU---------%%%%---%%%%%---------%%%%%%%%%%%---------------%%%%%%G%%--------------
------------------|||%%%%%%%%%%%%|-----------tt---------------K--------%%%%%%%%%%-------%%%%%%-----------------------------2USS22-||||---|||||---------|||||||||||---------------||||||%||%%%%%---------
------------------||||||||||||||||-------%%%%%%%%%------------%%%------||||||||||-------||||||--%%%%--%%%%--%%%%%-----------------||||---|||||---------|||||||||||%%%%%%%%%%-----||||||||||||||---------
XXXXXXXXXXXXXXXXXXXXXXXXXXXXXXXXXXXXXXXXX|||||||||XXXXXXXXXXXX|||XXXXXX||||||||||XXXXXXX||||||XX||||--||||XX|||||XXXXXXXXXXXXXXXXXX|||---|||||XXXXXXXXXXXXXXXXXXXX||||||||||XXXXX||||||X||XXXXXXXXXXXXXX
