--------------------------------------------------------------------------------------------------------------------------------------------------------------------------------------------------------
--------------------------------------------------------------------------------------------------------------------------------------------------------------------------------------------------------
--------------------------------------------------------------------------------------------------------------------------------------------------------------------------------------------------------
--------------------------------------------------------------------------------------------------------------------------------------------------------------------------------------------------------
--------------------------------------------------------------------------------------------------------------------------------------------------------------------------------------------------------
--------------------------------------------------------------------------------------------------------------------------------------------------------------------------------------------------------
--------------------------------------------------------------------------------------------------------------------------------------------------------------------------------------------------------
--------------------------------------------------------------------------------------------------------------------------------------------------------------------------------------------------------
--------------------------------------------------------------------------------------------------------------------------------------------------------------------------------------------------------
----------------------------------------------------------------------------------------------------------------------------------Tt--------------------------------------------------------------------
----------------------------------------------------------------------------------------------------------------------------------tt--------------------------------------------------------------------
------------------------------------G-------------------------------------------------------------K-------------------------------Ft--------G-----------------------------Tt----------------------------
----------------------%%%%------%%%%C------%%%---------------------%%%%%----%%%---G--------------%%%%%-CCCUU----------------------tt------SU22SUS-----%%%%%%CU------------tt----------------------------
----------------------||||------||||-----%%%%|---------------------|||||----|||--%%%%%%----------|||||%%%%--------------------%%%%%%%%%---------------||||||------------KGtt-----%%%------%%%-%%%------%
----------------------||||------||||-----|||||---------------------|||||----|||--||||||----------|||||||||--------------------|||||||||---------------||||||----------%%%%%%%%%--|||------|||-|||------|
XXXXXXXXXXXXXXXXXXXXXX||||------||||XXXXXXXXXXXXXXXXXXXXXXXXXXXXXXX|||||----|||XXXXXXXXXXXXXXXXXX|||||XXXXXXXXXXXXXXXXXXXXXXXXXXXXXXXXXXXXXXXXXXXXXXXXXXXXXXXXXXXXXXXX|||||||||XX|||------|||X|||------|
