--------------------------------------------------------------------------------------------------------------------------------------------------------------------------------------------------------
--------------------------------------------------------------------------------------------------------------------------------------------------------------------------------------------------------
--------------------------------------------------------------------------------------------------------------------------------------------------------------------------------------------------------
--------------------------------------------------------------------------------------------------------------------------------------------------------------------------------------------------------
--------------------------------------------------------------------------------------------------------------------------------------------------------------------------------------------------------
--------------------------------------------------------------------------------------------------------------------------------------------------------------------------------------------------------
--------------------------------------------------------------------------------------------------------------------------------------------------------------------------------------------------------
--------------------------------------------------------------------------------------------------------------------------------------------------------------------------------------------------------
--------------------------------------------------------------------------------------------------------------------------------------------------------------------------------------------------------
-------------------------------------------------------------------------------------------------------------------------------------Tt------------Tt-------------------------------------Tt------------
-------------------------------------------------------------------------------------------------------------------------------------tt------------tt-------------------------------------tt------------
-----------------------------G---GK---------------------%%%%%%%%%---%%%%%%%%Tt----------------%%%%--------------------------------F--tt--------2---tt-------------------------------------tt-G----------
----------------------------2U22CBB---------------------|||||||||---||||||||tt----------------||||-----K-----------------------------tt------------tt----------------------------------%%%%%%%%%%-------
-----------%%%%%%%%%%%%---%%%----%%%%%%%%%%%%-----------|||||||||%%%%%|%%%%%%%%%%------%%%----||||-%%%%%%------------------------%%%%%%%%%------%%%%%%%%%%--------------%%%%%%%%%%%----||||||||||----%%%
-----------||||||||||||---|||----||||||||||||-----------|||||||||||||||||||||||||------|||----||||-||||||------------------------|||||||||------||||||||||--------------|||||||||||----||||||||||----|||
%%%%%%%%%%%%%%%%%%%%%%%%%%|||%%%%%%%%%%%%%%%%%%%%%%%%%%%%%%%%%%%%%%%%%%%%%%%%%%%%%%%%%%%%%%%%%%%%%%||||||%%%%%%%%%%%%%%%%%%%%%%%%|||||||||%%%%%%||||||||||%%%%%%%%%%%%%%|||||||||||%%%%||||||||||%%%%%%%
