--------------------------------------------------------------------------------------------------------------------------------------------------------------------------------------------------------
--------------------------------------------------------------------------------------------------------------------------------------------------------------------------------------------------------
--------------------------------------------------------------------------------------------------------------------------------------------------------------------------------------------------------
--------------------------------------------------------------------------------------------------------------------------------------------------------------------------------------------------------
--------------------------------------------------------------------------------------------------------------------------------------------------------------------------------------------------------
--------------------------------------------------------------------------------------------------------------------------------------------------------------------------------------------------------
--------------------------------------------------------------------------------------------------------------------------------------------------------------------------------------------------------
--------------------------------------------------------------------------------------------------------------------------------------------------------------------------------------------------------
----------------------------------------------------------------------Tt--------------------------------------------------------------------------------------------------------------------------------
----------------------------------------------------------------------tt-------------------------------------------Tt-----------------------------------------------------------------------------------
----------------------------------------------------------------------tt-------------------------------------------tt-----------------------------------G-----------Tt----------------------------------
----------------------------------------G-----------------------------tt--K----------------------------------------tt-%%%%%%%-----F------------------2BCBU----------tt--------------------G-------------
---------%%%------------------------%%%%%%-------------------------%%%%%%%%----%%%%%%%%%-------------------K-------tt-KK|||||---------------------------------------tt-----%%%%%%-X-%%%%%%%-------------
---------|||------------G-----------||||||-------------------------||||||||----|||||||||------------%%%%---%%%%%%%%%%%%%|||||-------------%%%%%%%%%%%---------------tt-----||||||%X%|||||||-------------
---------|||-----%%%--%%%%%---------||||||-------------------------||||||||----|||||||||------------||||---||||||||||||||||||-------------|||||||||||-----------%%%%%%%%%--|||||||X||||||||-------------
%%%%%%%%%%%%%%%%%|||--|||||%%%%%%%%%||||||%%%%%%%%%%%%%%%%%%%%%%%%%%%%%%%%%%%%%|||||||||%%%%%%%%%%%%||||---|||||||||||||%%%%%%%%%%%%%%%%%%%%%%%%%%%%%%%%%%%%%%%%|||||||||%%||||||%%%|||||||%%%%%%%%%%%%%
