--------------------------------------------------------------------------------------------------------------------------------------------------------------------------------------------------------
--------------------------------------------------------------------------------------------------------------------------------------------------------------------------------------------------------
--------------------------------------------------------------------------------------------------------------------------------------------------------------------------------------------------------
--------------------------------------------------------------------------------------------------------------------------------------------------------------------------------------------------------
--------------------------------------------------------------------------------------------------------------------------------------------------------------------------------------------------------
--------------------------------------------------------------------------------------------------------------------------------------------------------------------------------------------------------
--------------------------------------------------------------------------------------------------------------------------------------------------------------------------------------------------------
--------------------------------------------------------------------------------------------------------------------------------------------------------------------------------------------------------
--------------------------------------------------------------------------------------------------------------------------------------------------------------------------------------------------------
-------------------------------------------------------------------------------------------------------------------------------------------------Tt-----------------------------------------------------
------------------------------------------------------------------------Tt-----------------------------------------------------------------------tt-----------------------------------------------------
------------------------------Tt----------------------------------------tt------------Tt------------------------------------------F----------K---tt-----------------------------------------------------
-----------------KK--------%%%tt-%%%-------KG---------------------------tt----G-------tt-------------------K----------------------%----US2SSU2---tt--G--------------------------------------------K-K---
---------%%%%%%%%-%%%------|||tt-|||------%%%%---%%%%%---------------%%%%%%%%%2C------tt-------%%%%----%%%%%%---------------------|-----------%%%%%%%%%%-----------------------------------%%%----%%%---
---------||||%%%%%%%%%%%-%%|||%%-|||------||||---|||||---------------|||||||||----%%%%%%%%%%%--||||----||||||--------------%%%%%--%%%%%-------||||||||||---------------------------%%%-----|||----|||---
XXXXXXXXXXXXX|||||||||||X|||||||-|||XXXXXX||||---|||||XXXXXXXXXXXXXXX|||||||||XXXX|||||||||||XXXXXXXXXXXXXXXXXXXXXXXXXXXXXX|||||--|||||XXXXXXX||||||||||XXXXXXXXXXXXXXXXXXXXXXXXXXX|||XXXXX|||----|||XXX
