--------------------------------------------------------------------------------------------------------------------------------------------------------------------------------------------------------
--------------------------------------------------------------------------------------------------------------------------------------------------------------------------------------------------------
--------------------------------------------------------------------------------------------------------------------------------------------------------------------------------------------------------
--------------------------------------------------------------------------------------------------------------------------------------------------------------------------------------------------------
--------------------------------------------------------------------------------------------------------------------------------------------------------------------------------------------------------
--------------------------------------------------------------------------------------------------------------------------------------------------------------------------------------------------------
--------------------------------------------------------------------------------------------------------------------------------------------------------------------------------------------------------
--------------------------------------------------------------------------------------------------------------------------------------------------------------------------------------------------------
-------------------------------------------------Tt-------------------------------------------------------------------------------------------------------------Tt--------------------------------------
-------------------------------------------------tt-------------------------------------------------------------------------------------------------------------tt--------------------------------------
-------------------------------------------G-----tt-------------------------------------------------------------------------------------------------------------tt--------------------------------------
-----------------------------------U%%%%%%%%-----t---K--------------------------------------------------------------------------K-F-----------------------------tt---%%%---------C2C2------------------%
-------------------%%%------%%%%%---%%%|||||--%%%%%%%%-%%%%%%%%%-------%%%%%-%%%--%%%%-----------------------------------------%%%-------------------------%%%%%%%%%%|||-------------------------------|
--------G---G------|||------|||||---||||||||--||||||||-|||||||||-------|||||-|||--||||---------------%%%%%---------------------|%%%%%%%%%%-----------------|||||||||||||-------------------------------|
--------%%%%%------|||------|||||---||||||||--||||||||-|||||||||-------|||||-|||--||||---------------|||||---------------------|||||||||||-----------------|||||||||||||-------------------------------|
%%%%%%%%|||||%%%%%%|||------|||||%%%%%%%%%%%%%%%%%%%%%%%%%%%%%%%%%%%%%%%%%%%%|||--||||%%%%%%%%%%%%%%%|||||%%%%%%%%%%%%%%%%%%%%%%||||||||||%%%%%%%%%%%%%%%%%%%%%%%%%%%%%%%%%%%%%%%%%%%%%%%%%%%%%%%%%%%%%%
