--------------------------------------------------------------------------------------------------------------------------------------------------------------------------------------------------------
--------------------------------------------------------------------------------------------------------------------------------------------------------------------------------------------------------
--------------------------------------------------------------------------------------------------------------------------------------------------------------------------------------------------------
--------------------------------------------------------------------------------------------------------------------------------------------------------------------------------------------------------
--------------------------------------------------------------------------------------------------------------------------------------------------------------------------------------------------------
--------------------------------------------------------------------------------------------------------------------------------------------------------------------------------------------------------
--------------------------------------------------------------------------------------------------------------------------------------------------------------------------------------------------------
--------------------------------------------------------------------------------------------------------------------------------------------------------------------------------------------------------
------------------------------------------------------------------------------------------------------------------Tt------------------------------------------------------------------------------------
------------------------------------------------------------------------------------------------------------------tt------------------------------------------------------------------------------------
-----------------------------------------------K-----------------------------------------------------G------------tt------------------------------------------------------------------G-----------------
----------------------------------------------%%%%%%---------------------------------------------%%%%%%-----------tt--------------F----------------------------------------%%%%%%%%%%%Tt------------%%%%
-------------------K------K-------------------||||||-----------------%%%%%%----------------------||||||--%%%%%-%%%%%%%%%----------%----------%%%%%--%%%--------------------|G|||||||||tt------------K|||
----------%%%%---%%%%%---%%%------%%%----U2UCS||||||-----------------||||||----------------------||||||--|||||-|||||||||----------|-------SUU|||||--|||---------------%%%%%%%%%|||||||tt-----------%%%%%
----------||||---|||||---|||------|||---------||||||-----------------||||||-----%%%---%%%%-------||||||--|||||-|||||||||----------|----------|||||--|||---------------|||||||||||||%%%%%%%%%-------|||||
XXXXXXXXXX||||---|||||XXX|||------|||XXXXXXXXXXXXXXXXXXXXXXXXXXXXXXXX||||||XXXXX|||---||||XXXXXXXXXXXXXXX|||||X|||||||||XXXXXXXXXXXXXXXXXXXXX|||||--|||XXXXXXXXXXXXXXXXXXXXXXXXXXXX|||||||||XXXXXXX|||||
