--------------------------------------------------------------------------------------------------------------------------------------------------------------------------------------------------------
--------------------------------------------------------------------------------------------------------------------------------------------------------------------------------------------------------
--------------------------------------------------------------------------------------------------------------------------------------------------------------------------------------------------------
--------------------------------------------------------------------------------------------------------------------------------------------------------------------------------------------------------
--------------------------------------------------------------------------------------------------------------------------------------------------------------------------------------------------------
--------------------------------------------------------------------------------------------------------------------------------------------------------------------------------------------------------
--------------------------------------------------------------------------------------------------------------------------------------------------------------------------------------------------------
--------------------------------------------------------------------------------------------------------------------------------------------------------------------------------------------------------
--------------------------------------------------------------------------------------------------------------------------------------------------------------------------------------------------------
----------------------------------------------------------------------------------------------------------------------------------------------Tt--------------------------------------------------------
-------------------------------------G------------------------------------------Tt------------------------------------------------------------tt--------------------------------------------------------
----------------%%%%%%%%------------%%%%%%%%%%-----%%%%%%%%------K--------------tt--------------------Tt--------------------------F-----------tt-------------------------------------%%%%%--------------
----------------||||||||-%%%%%%%-%%%%|||||||||-----||||||||------%%%---%%%%-----tt---------K----------tt-------------G--------------------%%%%%%%%%----------------------------------|||||--------------
----------------||||||||-||||K|G-|||||||||||||-----||||||||------|||---||||--%%%%%%%%%%----%%%%---K--%tt%%%%%-%%%%%--%%%%%-----%%%%%--%%%%|||||||||----------------------------------|||||--------------
----------------||%%%%||-||%%%%%%%%%%|||||||||-----||||||||------|||---||||--||||||||||----||||--%%%%%%%%%%%%-|||||--|||||-----|||||--|||||||||||||----------------------------------|||||---------%%%%-
%%%%%%%%%%%%%%%%%%||||%%%%%||||||||||%%%%%%%%%%%%%%%%%%%%%%%%%%%%|||---||||%%%%%%%%%%%%%%%%||||%%||||||||||||%|||||--|||||%%%%%|||||--|||||||||||||%%%%%%%%%%%%%%%%%%%%%%%%%%%%%%%%%%%%%%%%%%%%%%%%||||-
