--------------------------------------------------------------------------------------------------------------------------------------------------------------------------------------------------------
--------------------------------------------------------------------------------------------------------------------------------------------------------------------------------------------------------
--------------------------------------------------------------------------------------------------------------------------------------------------------------------------------------------------------
--------------------------------------------------------------------------------------------------------------------------------------------------------------------------------------------------------
--------------------------------------------------------------------------------------------------------------------------------------------------------------------------------------------------------
--------------------------------------------------------------------------------------------------------------------------------------------------------------------------------------------------------
--------------------------------------------------------------------------------------------------------------------------------------------------------------------------------------------------------
--------------------------------------------------------------------------------------------------------------------------------------------------------------------------------------------------------
--------------------------------------------------------------------------------------------------------------------------------------------------------------------------------------------------------
--------------------------------------------------------------------------------------------------------------------------------------------------------------------------------------------------------
-----------------------------------------------------------------------------------------------------------------------Tt-------------------------------------------------------------------------------
-----------------K--------------------------------------------------------------------------------KK-------------------tt---------F-----G---------------------------------------------------------UCB2BU
------------C2UCU2B-----G------------------------------------------------------------------%%%%%--%%%%%----------%%%%%%tt----------%%%--%%%%------------------------------------------------------------
-----------------------BU--------%%%%-----------------------K----------------%%%%%%--------|||||--|||||----------||||||tt----B-----|||--||||---G----K------------------------------------G--------------
-------------------------%%%%%%%%%%%|-------------%%%%------%%%--------------||||||--------|||||--|||||----------|%%%%%%%%%%%------|||--||||--%%%%--%%%------------------%%%-------------%%%%%%---------
%%%%%%%%%%%%%%%%%%%%%%%%%|||||||||||%%%%%%%%%%%%%%||||------|||%%%%%%%%%%%%%%||||||%%%%%%%%|||||--|||||%%%%%%%%%%%|||||||||||%%%%%%|||--||||%%||||--|||%%%%%%%%%%%%%%%%%%|||%%%%%%%%%%%%%||||||%%%%%%%%%
