--------------------------------------------------------------------------------------------------------------------------------------------------------------------------------------------------------
--------------------------------------------------------------------------------------------------------------------------------------------------------------------------------------------------------
--------------------------------------------------------------------------------------------------------------------------------------------------------------------------------------------------------
--------------------------------------------------------------------------------------------------------------------------------------------------------------------------------------------------------
--------------------------------------------------------------------------------------------------------------------------------------------------------------------------------------------------------
--------------------------------------------------------------------------------------------------------------------------------------------------------------------------------------------------------
--------------------------------------------------------------------------------------------------------------------------------------------------------------------------------------------------------
--------------------------------------------------------------------------------------------------------------------------------------------------------------------------------------------------------
--------------------------------------------------------------------------------------------------------------------------------------------------------------------------------------------------------
---------------------------------------------------------------------Tt---------------------------------------------------------------------------------------------------------------------------------
---------------------------------------------------------------------tt---------------------------------------------------------------------------------------------------------------------------------
----------------K-----------G-------G--K--------------K--------------tt---K-----------------------K-------------------------------F---------------------------------------------------------------------
-------------%%%%%%%%%----%%%%%-----%%%%%------------%%%%%%%%%%-%%%%%%%%%%%%--------------------%%%%%%%%%%----------------------------------------------------------------------------------------------
-------------|||||||||----|||||-----|||||------------||||||||||-||||||||||||--K-G---------------||||||||||----------------------------------------------%%%%%%%%%---------------------------------------
-------------|||||||||----|||||-----|||||------------||||||||||-||||||||||||--%%%---%%%---------||||||||||----------------------------------------------|||||||||---------------------------------------
%%%%%%%%%%%%%%%%%%%%%%%%%%|||||-----|||||%%%%%%%%%%%%%%%%%%%%%%%%%%%%%%%%%%%%%|||---|||%%%%%%%%%%%%%%%%%%%%%%%%%%%%%%%%%%%%%%%%%%%%%%%%%%%%%%%%%%%%%%%%%%%%%%%%%%%%%%%%%%%%%%%%%%%%%%%%%%%%%%%%%%%%%%%%%
