--------------------------------------------------------------------------------------------------------------------------------------------------------------------------------------------------------
--------------------------------------------------------------------------------------------------------------------------------------------------------------------------------------------------------
--------------------------------------------------------------------------------------------------------------------------------------------------------------------------------------------------------
--------------------------------------------------------------------------------------------------------------------------------------------------------------------------------------------------------
--------------------------------------------------------------------------------------------------------------------------------------------------------------------------------------------------------
--------------------------------------------------------------------------------------------------------------------------------------------------------------------------------------------------------
--------------------------------------------------------------------------------------------------------------------------------------------------------------------------------------------------------
--------------------------------------------------------------------------------------------------------------------------------------------------------------------------------------------------------
---------------------------------------------------------------------------------------------------------------------------------------Tt---------------------------------------------------------------
----------------Tt---------------------------------------------------------------------------------------------------------------------tt---------------------------------------------------------------
----------------tt---------------Tt----------------------------------------------------------------------------------------------------tt---------------------------------------------------------------
------------G---tt---------------tt------------------------------------------------------------------------------------------K----F----tt-----------------------------------------------UU-UCCS---K-----
-----------%%%%%%%%%%---------G--tt----------------------------------------------------------------------------------%%%%%%%%%%---%-%%%%%%%%-K--------------------------------------------------%%%%%%%%
-----------||||||||||--------%%%%%%%%%--------------------GK------G--------------------------------------------------||||||||||---|-||||%%%%%%-----------------------------G-%%%%--%%%%%--------||||||||
-----------||||||||||--------|||||||||-------------------%%%%--%%%%--------------------------------------------------||||||||||---|-||||||||||%%%%%%%%%%----------%%%%%%%%%%%||||--|||||--------||||||||
XXXXXXXXXXX||||||||||XXXXXXXX|||||||||XXXXXXXXXXXXXXXXXXX||||--||||XXXXXXXXXXXXXXXXXXXXXXXXXXXXXXXXXXXXXXXXXXXXXXXXXXXXXXXXXXXXXXXXXXXXX||||||||||||||||XXXXXXXXXX|||||||||||||||--|||||XXXXXXXXXXXXXXXX
