--------------------------------------------------------------------------------------------------------------------------------------------------------------------------------------------------------
--------------------------------------------------------------------------------------------------------------------------------------------------------------------------------------------------------
--------------------------------------------------------------------------------------------------------------------------------------------------------------------------------------------------------
--------------------------------------------------------------------------------------------------------------------------------------------------------------------------------------------------------
--------------------------------------------------------------------------------------------------------------------------------------------------------------------------------------------------------
--------------------------------------------------------------------------------------------------------------------------------------------------------------------------------------------------------
--------------------------------------------------------------------------------------------------------------------------------------------------------------------------------------------------------
--------------------------------------------------------------------------------------------------------------------------------------------------------------------------------------------------------
--------------------------------------------------------------------------------------------------------------------------------------------------Tt----------------------------------------------------
----------------------------------------------------------------------------------------------------------Tt--------------------------------------tt----------------------------------------------------
----------------------------------------------------------------------------------------------------------tt----------Tt--------------------------tt----------------------------------------------------
------------------------K---------------------------------------------------------------------------------tt----------tt----------F---------------tt------------------------------------------%%%%%%%-%-
----------%%%%-----%%%%%%%%%%%----------------------%%%--------------%%%%%-K-K-----------CUB--------------tt---K------tt-----%%%%--%%%---------%%%%%%%%-----%%%%%%----------------------------||%%%%%%%%
----------||||-----|||||||||||---------%%%%%%%%%%%--|||-------------%|||||%%%%-----------------------%%%%%%%%%%%---%%%%%%%%%U||||--|||---------||||||||-----||||||--%%%-----------------------||||||||||
----------||||-----|||||||||||%%%------|||||||||||--|||%%%%%%%%-----||||||||||---------------%%%--%%%|||||||||||---|||||||||-||||--|||---------||||||||-----||||||--|||-----------------------||||||||||
%%%%%%%%%%||||-----||||||||||||||%%%%%%|||||||||||%%%%%||||||||%%%%%%|||||%%%%%%%%%%%%%%%%%%%|||--||||||||||||||%%%|||||||||%||||--|||%%%%%%%%%%%%%%%%%%%%%%%%%%%%%%|||%%%%%%%%%%%%%%%%%%%%%%%%%||||||||
