--------------------------------------------------------------------------------------------------------------------------------------------------------------------------------------------------------
--------------------------------------------------------------------------------------------------------------------------------------------------------------------------------------------------------
--------------------------------------------------------------------------------------------------------------------------------------------------------------------------------------------------------
--------------------------------------------------------------------------------------------------------------------------------------------------------------------------------------------------------
--------------------------------------------------------------------------------------------------------------------------------------------------------------------------------------------------------
--------------------------------------------------------------------------------------------------------------------------------------------------------------------------------------------------------
--------------------------------------------------------------------------------------------------------------------------------------------------------------------------------------------------------
--------------------------------------------------------------------------------------------------------------------------------------------------------------------------------------------------------
--------------------------------------------------------------------------------------------------------------------------------------------------------------------------------------------------------
------------------------------------------------------------------------Tt------------------------------------------------------------------------------------------------------------------------------
----------------------Tt------------------------------------------------tt------------------------------------------------------------------------------------------------------------------------------
----------------------tt---------------------------------------K--------tt--------------------------------------------------------F--G------------------------------------------------------------------
----------------------tt------------------------------%%%%%%%%%%%%------tt--------------------------------------------------------%S2UU-----------------------------------------------------------------
----------------------tt------------------------------||||||||||||-%%%%%%%%%%%-----------%%%%%%%%%--------------------------------|---------S2CCS2C------------------------------------------------G----
-------------------%%%%%%%%%--------------------------||||||||||||-|||||||||||-----------|||||||||--------------------------------|----------------------------------------------------------------%%%%-
XXXXXXXXXXXXXXXXXXX|||||||||XXXXXXXXXXXXXXXXXXXXXXXXXX||||||||||||X|||||||||||XXXXXXXXXXX|||||||||XXXXXXXXXXXXXXXXXXXXXXXXXXXXXXXXXXXXXXXXXXXXXXXXXXXXXXXXXXXXXXXXXXXXXXXXXXXXXXXXXXXXXXXXXXXXXXXXX||||-
