--------------------------------------------------------------------------------------------------------------------------------------------------------------------------------------------------------
--------------------------------------------------------------------------------------------------------------------------------------------------------------------------------------------------------
--------------------------------------------------------------------------------------------------------------------------------------------------------------------------------------------------------
--------------------------------------------------------------------------------------------------------------------------------------------------------------------------------------------------------
--------------------------------------------------------------------------------------------------------------------------------------------------------------------------------------------------------
--------------------------------------------------------------------------------------------------------------------------------------------------------------------------------------------------------
--------------------------------------------------------------------------------------------------------------------------------------------------------------------------------------------------------
--------------------------------------------------------------------------------------------------------------------------------------------------------------------------------------------------------
--------------------------------------------------------------------------------------------------------------------Tt----------------------------------------------------------------------------------
--------------------------------------------------------------------------------------------------------------------tt----------------------------------------------------------------------------------
---------------------------------------------------Tt-----------------------------------Tt------------------------G-tt----------------------------------------------------------------------------------
-----------G---------------------------------------tt----------------------BCC2UCU------tt----------------------%%%%%%%%%%--------F---Tt--------------------------G---------K---------------------------
---------%%%%%%%%%%%%------------------------------tt---------------------G-------------tt------G---------------|||G|K||||------------tt--------------------------%%%%%--%%%%%--------------------------
---------||||||||||||----------%%%%%%%%%-----------tt---------------------C2%%%%%%%%%%K-tt----%%%%K-------------|||%%%%%||------------tt--------------------------|||||--|||||--------------------------
---------||||||||||||----------|||||||||-------%%%%%%%%%%-------------------|||||||||%%%%%%%%-|||%%%%-----------||||||||||-------%%%%%%%%%%%----------------------|||||--|||||--------------------------
%%%%%%%%%||||||||||||%%%%%%%%%%%%%%%%%%%%%%%%%%||||||||||%%%%%%%%%%%%%%%%%%%%%%%%%%%%||||||||%%%%||||%%%%%%%%%%%%%%|||||%%%%%%%%%|||||||||||%%%%%%%%%%%%%%%%%%%%%%|||||--|||||%%%%%%%%%%%%%%%%%%%%%%%%%%
