--------------------------------------------------------------------------------------------------------------------------------------------------------------------------------------------------------
--------------------------------------------------------------------------------------------------------------------------------------------------------------------------------------------------------
--------------------------------------------------------------------------------------------------------------------------------------------------------------------------------------------------------
--------------------------------------------------------------------------------------------------------------------------------------------------------------------------------------------------------
--------------------------------------------------------------------------------------------------------------------------------------------------------------------------------------------------------
--------------------------------------------------------------------------------------------------------------------------------------------------------------------------------------------------------
--------------------------------------------------------------------------------------------------------------------------------------------------------------------------------------------------------
-------------------------------------------------------------------------------Tt-----------------------------------------------------------------------------------------------------------------------
-------------------------------------------------Tt----------------------------tt---Tt------------------------------------------------------------------------------------------------------------------
----------Tt-------------------------------------tt----------------------------tt---tt------------------------------------------------------------------------------------------------------------------
----------tt--G----------------------------------tt-KG-------------------------tt-K-tt------------------------------------------------------------------------Tt----------------------Tt----------------
----------tt%%%%%%-----------------K----------%%%%%%%%%---------------------%%%%%%%%tt---------K----------------------------------F---------------------------tt----------------------tt------K---------
------%%%%%%%%%%%|-----------%%%%--%%%--------|||||||||---------------------||||%%%%%%%%%%--%%%%-----%%%%%-%%%--%%%%%--------------K--------------------------tt----------------------tt----%%%%%%%%%%--
------|||||||||||%%%%%%------||||--|||--------|||||||2CU--------------------||||||||||||||--||||-----|||||-|||--|||||-------------BB2B-%%%%%------%%%%---%%%%%%%%%%-------------------tt----||------||--
------|||||||||||||||||------||||--|||--------|||||||XX---------------------||||||||||||||--||||-----|||||-|||--|||||------------------|||||------||||---||||||||||--------------%%%%%%%%%%%||XXXXXX||--
%%%%%%%%%%%%%%%%%||||||%%%%%%||||--|||%%%%%%%%%%%%%%%%%%%%%%%%%%%%%%%%%%%%%%%%%%%%%%%%%%%%%%||||-----|||||%|||--|||||%%%%%%%%%%%%%%%%%%|||||------||||%%%||||||||||%%%%%%%%%%%%%%|||||||||||%%%%%%%%%%%%
