--------------------------------------------------------------------------------------------------------------------------------------------------------------------------------------------------------
--------------------------------------------------------------------------------------------------------------------------------------------------------------------------------------------------------
--------------------------------------------------------------------------------------------------------------------------------------------------------------------------------------------------------
--------------------------------------------------------------------------------------------------------------------------------------------------------------------------------------------------------
--------------------------------------------------------------------------------------------------------------------------------------------------------------------------------------------------------
--------------------------------------------------------------------------------------------------------------------------------------------------------------------------------------------------------
--------------------------------------------------------------------------------------------------------------------------------------------------------------------------------------------------------
--------------------------------------------------------------------------------------------------------------------------------------------------------------------------------------------------------
--------------------------------------------------------------------------------------------------------------------------------------------------------------------------------------------------------
--------------------------------------------------------------Tt----------------------------------------------------------------------------------------------------------------------------------------
--------------------------------------------------------------tt-------------------------------------------------------------------------------------------------------------K--------------------------
------------------------------------------------------------G-tt-------%%%-%---------------------K--------------------------------F---------G----------------------------S2CCS2------K------------------
----------------------------------------------------------%%%%%%%%%%---|||-|---------------------%%%------%%%-------------G-------%--%%%%---%%%%%--------%%%%%------%%%%%------------%%%--%%%%%%%%----%%
------SC22CC------------K---------------------------------||||||||||--G|||-|--------------K------|||------|||----------%%%%%%%%%%%%--||||---|||||--------|||||------|||||------------|||--||||||||----||
--------------------%%%%%--%%%---%%%-----%%%%-------------||||||||||-%%%%%%%%%%%%--%%%%---%%%%---|||------|||----------||||||||||||--||||---|||||--------|||||------|||||------------|||--||||||||----||
XXXXXXXXXXXXXXXXXXXX|||||--|||XXX|||-----||||XXXXXXXXXXXXX||||||||||X||||||||||||XX||||---||||XXX|||------|||XXXXXXXXXX||||||||||||XX||||---|||||XXXXXXXX|||||------|||||XXXXXXXXXXXX|||--||||||||----||
