--------------------------------------------------------------------------------------------------------------------------------------------------------------------------------------------------------
--------------------------------------------------------------------------------------------------------------------------------------------------------------------------------------------------------
--------------------------------------------------------------------------------------------------------------------------------------------------------------------------------------------------------
--------------------------------------------------------------------------------------------------------------------------------------------------------------------------------------------------------
--------------------------------------------------------------------------------------------------------------------------------------------------------------------------------------------------------
--------------------------------------------------------------------------------------------------------------------------------------------------------------------------------------------------------
--------------------------------------------------------------------------------------------------------------------------------------------------------------------------------------------------------
--------------------------------------------------------------------------------------------------------------------------------------------------------------------------------------------------------
---------------------------------------------------------------------------------------------------------------------------Tt---------------------------------------------------------------------------
---------------------------------------------------------------------------------------------------------------------------tt---------------------------------------------------------------------------
---------------------------------------------------------------------------------------------------------------------------tt---------------------------------------------------------------------------
---------------------------------%%%%%%--------------%%-%%%-%%%-----------------------------BB------------------%%%%-------tt%%%%%F-------K----K--G---------------------------2U%%%%%%%%%%--------------
---------------------------------||||||--------------|%-%%%%%%%%------------------------------%%%%%%%%%%--------||||--%%%%%%%%%%%|X------%%%---%%%%%----------------------------||||||||||--------------
----------------%%%----%%%%%-----||||||--------------||-||||||||-------G----------------------||||||||||--------||||--||||||||||||X------|||---|||||-2UCCC----------------------||||||||||--------------
----------------|||----|||||-----||||||-------------%%%%%%%%||||----%%%%%--%%%-%%%%%----------||||||||||--------||||--||||||||||||X------|||---|||||----------------------------||||||||||--------------
%%%%%%%%%%%%%%%%|||%%%%|||||%%%%%%%%%%%%%%%%%%%%%%%%||||||||%%%%%%%%|||||--|||%|||||%%%%%%%%%%||||||||||%%%%%%%%%%%%%%|||||||||||%%%%%%%%|||---|||||%%%%%%%%%%%%%%%%%%%%%%%%%%%%%%%%%%%%%%%%%%%%%%%%%%%%
