--------------------------------------------------------------------------------------------------------------------------------------------------------------------------------------------------------
--------------------------------------------------------------------------------------------------------------------------------------------------------------------------------------------------------
--------------------------------------------------------------------------------------------------------------------------------------------------------------------------------------------------------
--------------------------------------------------------------------------------------------------------------------------------------------------------------------------------------------------------
--------------------------------------------------------------------------------------------------------------------------------------------------------------------------------------------------------
--------------------------------------------------------------------------------------------------------------------------------------------------------------------------------------------------------
--------------------------------------------------------------------------------------------------------------------------------------------------------------------------------------------------------
--------------------------------------------------------------------------------------------------------------------------------------------------------------------------------------------------------
------------------------------------------------------------------------------------------------------------------------------------------------------------------------------Tt------------------------
------------------------------------------------------------------------------------------------------------------------------------------------------------------------------tt------------------------
-----------------------------------------G-K-------------------------------------------------------------------------------------G--------------------------------------------tt------------------------
----------------------------------------CUCBBBB-------------------------------------------------%%%%---------------------------%TtF%%---%%%%%%-------G------------------------tt------------------------
------------------G-----------------------------------------------------------------------------||||---------------------------|ttX||---||||||-%%%--%%%--------------------%%%%%%%%%----------------%%%%
---------%%%--%%%%%----------------------------GK-----------------------------------------------||||----------------------UB2--|ttX||---||||||-|||--|||--------------------|||||||||-------G--------||%%
---------|||--|||||---------------------------%%%%----------------------------------------------||||-------------------------%%%%%%%%%%-||||||-|||--|||-----%%%%%%%%-------|||||||||-----%%%%-------||||
%%%%%%%%%|||--|||||%%%%%%%%%%%%%%%%%%%%%%%%%%%||||%%%%%%%%%%%%%%%%%%%%%%%%%%%%%%%%%%%%%%%%%%%%%%%%%%%%%%%%%%%%%%%%%%%%%%%%%%%||||||||||%%%%%%%%|||--|||%%%%%||||||||%%%%%%%|||||||||%%%%%||||%%%%%%%%%%%
