--------------------------------------------------------------------------------------------------------------------------------------------------------------------------------------------------------
--------------------------------------------------------------------------------------------------------------------------------------------------------------------------------------------------------
--------------------------------------------------------------------------------------------------------------------------------------------------------------------------------------------------------
--------------------------------------------------------------------------------------------------------------------------------------------------------------------------------------------------------
--------------------------------------------------------------------------------------------------------------------------------------------------------------------------------------------------------
--------------------------------------------------------------------------------------------------------------------------------------------------------------------------------------------------------
--------------------------------------------------------------------------------------------------------------------------------------------------------------------------------------------------------
-------------------------------------------------------------------------------------------------------------Tt-----------------------------------------------------------------------------------------
-------------------------------------------------------------------------------------------------------------tt-----------------------------------------------------------------------------------------
----------------------------------------------------------------------------------------Tt-------------------tt---------------------------------------------Tt------------------------------------------
----------------------------------------------------------------------------------------tt-------------------tt---G-----------------------------------------tt------------------------------------------
---------------------------------------------------------------------------------------Gtt-GG------------%%%%%%%%%%---------------F-------------------------Gt--------------------------------------K---
---------------K-------------------------------------------------K------------------%%%%%%%%%%-----------||||||||||--%%%%%%%%%-----------------------------%%%-----------------------------------%%%%---
------------%%%%%%%%%%%2UU------------------K---------%%%%%--%%%%%------------------||||||||||-----------||||||||||--|||||||||---------------------------%%|||%%%%-------------------------------||||---
------------|||||||||||--------------%%%%%%%%---------|||||--|||||------------------||||||||||-----------||||||||||--|||||||||---------------------------|||||||||--------%%%%%%%%%%-------------||||---
%%%%%%%%%%%%%%%%%%%%%%%%%%%%%%%%%%%%%||||||||%%%%%%%%%|||||--|||||%%%%%%%%%%%%%%%%%%||||||||||%%%%%%%%%%%%%%%%%%%%%%%%%%%%%%%%%%%%%%%%%%%%%%%%%%%%%%%%%%%%%|||%%%%%%%%%%%%||||||||||%%%%%%%%%%%%%%%%%%%%
