--------------------------------------------------------------------------------------------------------------------------------------------------------------------------------------------------------
--------------------------------------------------------------------------------------------------------------------------------------------------------------------------------------------------------
--------------------------------------------------------------------------------------------------------------------------------------------------------------------------------------------------------
--------------------------------------------------------------------------------------------------------------------------------------------------------------------------------------------------------
--------------------------------------------------------------------------------------------------------------------------------------------------------------------------------------------------------
--------------------------------------------------------------------------------------------------------------------------------------------------------------------------------------------------------
--------------------------------------------------------------------------------------------------------------------------------------------------------------------------------------------------------
--------------------------------------------------------------------------------------------------------------------------------------------------------------------------------------------------------
-------------------------------------------------------------------------------------------------------------------------------------Tt-----------------------------------------------------------------
-------------------------------------------------------------------------------------------------------------------------------------tt----------------------------------------------------------------T
-------------------------------------------------------------------------------------------------------------------------------------tt----------------------------------------------------------------t
-----------------------------------------------------------------------------------------------GK------K---G----------------------F--tt----------------------------------------------------------------t
-----------------------------------------------------------------------------------------------%%%%----%%%%%---------------------%%%%%%%%%------------------------------%%%%%%%%-----------------------t
-----------------------------------%%%%%%%%--------------------------------------GK------------||||----|||||---------------------|||||||||------------------------------||||||||----------------CC%%%%%%
-----------------------------------||||||||-------------------------------------%%%---%%%%-----||||----|||||---------------------|||||||||------------------------------||||||||------------------||||||
XXXXXXXXXXXXXXXXXXXXXXXXXXXXXXXXXXXXXXXXXXXXXXXXXXXXXXXXXXXXXXXXXXXXXXXXXXXXXXXX|||---||||XXXXX||||----|||||XXXXXXXXXXXXXXXXXXXXX|||||||||XXXXXXXXXXXXXXXXXXXXXXXXXXXXXX||||||||XXXXXXXXXXXXXXXXXXXXXXXX
