--------------------------------------------------------------------------------------------------------------------------------------------------------------------------------------------------------
--------------------------------------------------------------------------------------------------------------------------------------------------------------------------------------------------------
--------------------------------------------------------------------------------------------------------------------------------------------------------------------------------------------------------
--------------------------------------------------------------------------------------------------------------------------------------------------------------------------------------------------------
--------------------------------------------------------------------------------------------------------------------------------------------------------------------------------------------------------
--------------------------------------------------------------------------------------------------------------------------------------------------------------------------------------------------------
--------------------------------------------------------------------------------------------------------------------------------------------------------------------------------------------------------
--------------------------------------------------------------------------------------------------------------------------------------------------------------------------------------------------------
-------------Tt-----------------------------------------------------------------------------------------------------------------------------------------------------------------------------------------
-------------tt---------------Tt------------------------------------------Tt----------------------------------------------------------------------------------------------------------------------------
-------------tt---------------tt------------------------------------------tt---------------------------------------Tt-------G---------------------------------------------------------------------------
-------------tt--------------Ktt--------------------------G--K------------tt------------------------%%%%-%%%%------tt------%%%%%-%F%%-----------------------BC------------------------------------------
---------%%%%%%%%%%-----CC-%%%%%%%%%------------%%%%%%%%%%%-%%%%--%%%%----tt-G----------------------||||-||||------tt----G-|||||-|X||-----------------------UB-------%%%%%--------------%%%%%-----------
---------||||||||||--------|||||||||------------|||||||||||-||||--||||%%%%%%%%%%%-------------------%%%%%%%%%-%%%%%%%%%%%%-||K||-|X||----%%%%----%%%%----------------|||||--G---K--G----|||||-----------
---------||||||||||--------|||||||||------------|||||||||||-||||--|||||||||||||||-------------------|||||||||-||||||||||||-%%%%%%%%%%%%--||||----||||----------------|||||%%%--%%%%%----|||||-----------
%%%%%%%%%%%%%%%%%%%%%%%%%%%%%%%%%%%%%%%%%%%%%%%%|||||||||||%||||--||||%%%%%%%%%%%%%%%%%%%%%%%%%%%%%%%%%%%%%%%%||||||||||||%||||||||||||%%||||----||||%%%%%%%%%%%%%%%%%%%%%|||--|||||%%%%%%%%%%%%%%%%%%%%
