--------------------------------------------------------------------------------------------------------------------------------------------------------------------------------------------------------
--------------------------------------------------------------------------------------------------------------------------------------------------------------------------------------------------------
--------------------------------------------------------------------------------------------------------------------------------------------------------------------------------------------------------
--------------------------------------------------------------------------------------------------------------------------------------------------------------------------------------------------------
--------------------------------------------------------------------------------------------------------------------------------------------------------------------------------------------------------
--------------------------------------------------------------------------------------------------------------------------------------------------------------------------------------------------------
--------------------------------------------------------------------------------------------------------------------------------------------------------------------------------------------------------
--------------------------------------------------------------------------------------------------------------------------------------------------------------------------------------------------------
--------------------------------------------------------------------------------------------------------------------------------------------------------------------------------------------------------
--------------------------------------------------------------------------------------------------------------------------------------------------------------------------------------------------------
-------------------------------------------------------------------------------------------------------G-----------------------Tt-----------------------------------------------------------------------
---------------------------------------------------------------------------------------------------%%%%%%----------------------tt-F---------------------------------------------------------------------
----------S22UCS---------------%%%%------%%%%%----%%%----------------------------------------------||||||----------------G-----tt-%-------2U2---------------------------------------------------%%%%%%%%
---------------SSUSCUC---------||||------|||||----|||-%%%%%%%%%%%--------------------------------2U||||||---------------%%%%%%%tt%%--------------%%%%%-----%%%%%--------%%%%%%%%%%%%SSC---------||||||||
-------------------------------||||------|||||----|||-|||||||||||----------------------------------||||||---------------||||%%%%%%%%%------------|||||-----|||||--------||||||||||||------------||||||||
XXXXXXXXXXXXXXXXXXXXXXXXXXXXXXXXXXXXXXXXX|||||----|||X|||||||||||XXXXXXXXXXXXXXXXXXXXXXXXXXXXXXXXXXXXXXXXXXXXXXXXXXXXXXXXXXX|||||||||XXXXXXXXXXXX|||||-----|||||XXXXXXXX||||||||||||XXXXXXXXXXXXXXXXXXXX
