--------------------------------------------------------------------------------------------------------------------------------------------------------------------------------------------------------
--------------------------------------------------------------------------------------------------------------------------------------------------------------------------------------------------------
--------------------------------------------------------------------------------------------------------------------------------------------------------------------------------------------------------
--------------------------------------------------------------------------------------------------------------------------------------------------------------------------------------------------------
--------------------------------------------------------------------------------------------------------------------------------------------------------------------------------------------------------
--------------------------------------------------------------------------------------------------------------------------------------------------------------------------------------------------------
--------------------------------------------------------------------------------------------------------------------------------------------------------------------------------------------------------
--------------------------------------------------------------------------------------------------------------------------------------------------------------------------------------------------------
------------------------------------------------------------------------------------------Tt------------------------------------------------------------------------------------------------------------
------------------------------------------------------------------Tt----------------------tt------------------------------------------------------------------------------------------------------------
------------------------------------------------------------------tt----------------------tt------------------------------------------------------------------------------------------------------------
------------------------K-CUSC-------------------K-------K--------tt----G-----------------tt--------------------------------------F---------------------------------------------------------------------
-----------%%%%------%%%%%---------------------%%%%%%%%%SS2----%%%%%%%%%%-------------%%%%%%%%%%%--------------------------G------%-----------------------------------G---------------------------------
-----------||||------|||||---------------------|||||||||-------||||||||||---%%%%%--%%%|||||||||||------------------------SSS2U22--|---------------------------------%%%%----CU2C2UC-----------UC2-----%%
-----------||||------|||||---------------------|||||||||-------||||||||||---|||||--||||||||||||||---------------------------------|--------------------------------%%%%|------------------------------||
XXXXXXXXXXX||||------|||||XXXXXXXXXXXXXXXXXXXXX|||||||||XXXXXXXXXXXXXXXXXXXX|||||--||||||||||||||XXXXXXXXXXXXXXXXXXXXXXXXXXXXXXXXXXXXXXXXXXXXXXXXXXXXXXXXXXXXXXXXXX||||XXXXXXXXXXXXXXXXXXXXXXXXXXXXXXX||
