--------------------------------------------------------------------------------------------------------------------------------------------------------------------------------------------------------
--------------------------------------------------------------------------------------------------------------------------------------------------------------------------------------------------------
--------------------------------------------------------------------------------------------------------------------------------------------------------------------------------------------------------
--------------------------------------------------------------------------------------------------------------------------------------------------------------------------------------------------------
--------------------------------------------------------------------------------------------------------------------------------------------------------------------------------------------------------
--------------------------------------------------------------------------------------------------------------------------------------------------------------------------------------------------------
--------------------------------------------------------------------------------------------------------------------------------------------------------------------------------------------------------
--------------------------------------------------------------------------------------------------------------------------------------------------------------------------------------------------------
--------------------------------------------------Tt----------------------------------------------------------------------------------------------------------------------------------------------------
--------------------------------------------------tt----------------------------------------------------------------------------------------------------------------------------------------------------
--------------------------------------------------tt----------------------------------------------------------------------------------------------------------------------------------------------------
---------------------------------K-------------%%%%%%%%--------------------------------------UCB2B2U--G---------------------------F----------------------------%%%%-------------------------------------
---------------------------%%%--%%%------------||||||||--------------------------------------------%%%%%%%%%%------------K-------------------------------------||||-------------------------------------
---------------------------|||--|||------------||||||||--------------------------------------------||||||||||---------UCBC-------------------------------------||||-------------------------------------
---------------%%%---------|||--|||------------||||||||--------------------------------------------||||||||||--------------------------------------------------||||-------------------------------------
%%%%%%%%%%%%%%%|||%%%%%%%%%|||--|||%%%%%%%%%%%%%%%%%%%%%%%%%%%%%%%%%%%%%%%%%%%%%%%%%%%%%%%%%%%%%%%%%%%%%%%%%%%%%%%%%%%%%%%%%%%%%%%%%%%%%%%%%%%%%%%%%%%%%%%%%%%%%%%%%%%%%%%%%%%%%%%%%%%%%%%%%%%%%%%%%%%%%
