--------------------------------------------------------------------------------------------------------------------------------------------------------------------------------------------------------
--------------------------------------------------------------------------------------------------------------------------------------------------------------------------------------------------------
--------------------------------------------------------------------------------------------------------------------------------------------------------------------------------------------------------
--------------------------------------------------------------------------------------------------------------------------------------------------------------------------------------------------------
--------------------------------------------------------------------------------------------------------------------------------------------------------------------------------------------------------
--------------------------------------------------------------------------------------------------------------------------------------------------------------------------------------------------------
--------------------------------------------------------------------------------------------------------------------------------------------------------------------------------------------------------
--------------------------------------------------------------------------------------------------------------------------------------------------------------------------------------------------------
--------------------------------------------------------------------------------------------------------------------------------------------------------------------------------------------------------
--------------------------------------------------------------------------------------------------------------------------------------------------------------------------------------------------------
----------------------------------G---------------------------------------------------------------------------------------------------------------------------------------------------------------------
--------------------------%%%%%%%%%-----------------------------------------------------------------------------------------------F--------------K--------------------------------------------G---------
--------------------------|||G|G-----------------------------------------------------------------------------GK-------------------------%%%%%%%%%%%------------------------------------------BU---------
--------------------------%%%%%%XXX------------------------------------------------------------------------%%%%%%%%%%-------------------|||||||||||-------------------------------G---K-----------------
--------------------------||||||XXX------------------------------------------------------------------------||||||||||-------------------|||||||||||----------%%%%---%%%%--------%%%%%%%%%%------------%%
%%%%%%%%%%%%%%%%%%%%%%%%%%%%%%%%%%%%%%%%%%%%%%%%%%%%%%%%%%%%%%%%%%%%%%%%%%%%%%%%%%%%%%%%%%%%%%%%%%%%%%%%%%%%%%%%%%%%%%%%%%%%%%%%%%%%%%%%%%%%%%%%%%%%%%%%%%%%%||||---||||%%%%%%%%||||||||||%%%%%%%%%%%%||
