--------------------------------------------------------------------------------------------------------------------------------------------------------------------------------------------------------
--------------------------------------------------------------------------------------------------------------------------------------------------------------------------------------------------------
--------------------------------------------------------------------------------------------------------------------------------------------------------------------------------------------------------
--------------------------------------------------------------------------------------------------------------------------------------------------------------------------------------------------------
--------------------------------------------------------------------------------------------------------------------------------------------------------------------------------------------------------
--------------------------------------------------------------------------------------------------------------------------------------------------------------------------------------------------------
--------------------------------------------------------------------------------------------------------------------------------------------------------------------------------------------------------
--------------------------------------------------------------------------------------------------------------------------------------------------------------------------------------------------------
----------------------------------------------------------------------------------------------------------------------------------------Tt--------------------------------------------------------------
----------------------------------------------------------------------------------------------------------------------------------------tt--------------------------------------------------------------
-----------------------------------------------------Tt---------------------------------------------------------------------------------tt--------------------------------------------------------------
-----------Tt-------------------------G--------------tt-------------G-------------------------------------------------------------F--G--tt--------------------------------------------------------------
-----------tt-----------------------%%%%%----%%%-----tt-----------%%%%---------------------------------------------%%%%%%%%%%------%%%%%%%%%%%------------------------------------G---------------------
-----------tt%%%%%%%%%--------------|||||----|||-----tt-------%%%%||||------------------K%%%--------------%%%--%%%%|||---||||------|||||||||||-----------------------------------%%%%%%%%%%%---------%%%
-------%%%%%%%%%%|||||--------------|||||----|||-%%%%%%%%%----||||||||-------%%%%%%%%%%%%|||--------------|||--|||||||XXX||||------|||||||||||-----------------------------------|||||||||||---------|||
%%%%%%%||||||||||%%%%%%%%%%%%%%%%%%%|||||----|||%|||||||||%%%%%%%%%%%%%%%%%%%||||||||||||%%%%%%%%%%%%%%%%%|||--||||%%%%%%%%%%%%%%%%%%%%%%%%%%%%%%%%%%%%%%%%%%%%%%%%%%%%%%%%%%%%%%%%%%%%%%%%%%%%%%%%%%|||
