--------------------------------------------------------------------------------------------------------------------------------------------------------------------------------------------------------
--------------------------------------------------------------------------------------------------------------------------------------------------------------------------------------------------------
--------------------------------------------------------------------------------------------------------------------------------------------------------------------------------------------------------
--------------------------------------------------------------------------------------------------------------------------------------------------------------------------------------------------------
--------------------------------------------------------------------------------------------------------------------------------------------------------------------------------------------------------
--------------------------------------------------------------------------------------------------------------------------------------------------------------------------------------------------------
--------------------------------------------------------------------------------------------------------------------------------------------------------------------------------------------------------
----------------------------------------------------Tt-------------------------------------------------------Tt-----------------------------------------------------------------------------------------
----------------------------------------------------tt-------------------------------------------------------tt-----------------------------------------------------------------------------------------
----------------------------------------------------tt-------------------------------------------------------tt-----------------------------------------------Tt----------------------------------------
-------------------------------------------------K--tt-------------------------------------------------------tt-----------------------------------------------tt---------------------------------------K
-------------G----------------------------------%%%G%%%%%%%-----------------C2S---------------------------%%%%%%%%%%--------------F---------------------------tt--------------------------------------%%
------------%%%%%-------------------------G-K-G-||%%%%%%|||-----------------------------------------------||||||||||--------------%--------%%%%---%%%%--------tt--------------------------------------||
------------|||%%%%%%%%%----%%%%------%%%%%%%%%-|||||||||||%%%%%%%%%%----------------------------SCC------||||||||||--------------|---G----||||---||||----%%%%%%%%%-----------------------------------||
------------||||||||||||----||||------|||||||||-|||||||||||||||||||||-------------------------------------||||||||||------%%%%----|-%%%----||||---||||----|||||||||--------%%%%%-----%%%%%------------||
XXXXXXXXXXXXXXX|||||||||XXXX||||------|||||XXXXXXX||||||XXXXXXXXXXXXXXXXXXXXXXXXXXXXXXXXXXXXXXXXXXXXXXXXXXXXXXXXXXXXXXXXXX||||----|-|||XXXX||||---||||XXXX|||||||||XXXXXXXX|||||-----|||||XXXXXXXXXXXXXX
