--------------------------------------------------------------------------------------------------------------------------------------------------------------------------------------------------------
--------------------------------------------------------------------------------------------------------------------------------------------------------------------------------------------------------
--------------------------------------------------------------------------------------------------------------------------------------------------------------------------------------------------------
--------------------------------------------------------------------------------------------------------------------------------------------------------------------------------------------------------
--------------------------------------------------------------------------------------------------------------------------------------------------------------------------------------------------------
--------------------------------------------------------------------------------------------------------------------------------------------------------------------------------------------------------
--------------------------------------------------------------------------------------------------------------------------------------------------------------------------------------------------------
-------------------------------------------------Tt-----------------------------------------------------------------------------------------------------------------------------------------------------
-------------------------------------------------tt----------------------------------------------------------------------------------------------------------------------Tt-----------------------------
-------------------------------------------------tt----------------------------------------------------------------------------------------------------------------------tt-----------------------------
-------------------------------------------------tt-------------------------------------------------------------------------K--------------------GG----------------------tt-----------------------------
---------------------------------------------%%%%%%%%%---------------------------------------------------------------------%%%%%--F-----------%%%%%%---------------------tt----G-----------US2UU2C---%%%
-------------KK---------------G--------------|||||||||------------G----------------%%%%%%%-%%%%----------------------------|||||--%-----------||||||------------------%%%%%%%%%%---------------------|||
------------%%%%------%%%---%%%%-------------|||||||||-%%%%------%%%%%-------G-----||||%%%%%%%%%%--------------------------|||||--|-----------||||||------------------||||||||||---------G-----------|||
------------||||------|||---||||-------------|||||||||-||||------|||||------%%%%%%%%%%%||||||||||--------------------------|||||--|-----------||||||------------------||||||||||--------%%%----------|||
XXXXXXXXXXXX||||------|||XXX||||XXXXXXXXXXXXXXXXXXXXXXX||||------|||||XXXXXX|||||||||||||||||||||XXXXXXXXXXXXXXXXXXXXXXXXXXXXXXXXXXXXXXXXXXXXXXXXXXXXXXXXXXXXXXXXXXXXX||||||||||XXXXXXXX|||XXXXXXXXXXXXX
