--------------------------------------------------------------------------------------------------------------------------------------------------------------------------------------------------------
--------------------------------------------------------------------------------------------------------------------------------------------------------------------------------------------------------
--------------------------------------------------------------------------------------------------------------------------------------------------------------------------------------------------------
--------------------------------------------------------------------------------------------------------------------------------------------------------------------------------------------------------
--------------------------------------------------------------------------------------------------------------------------------------------------------------------------------------------------------
--------------------------------------------------------------------------------------------------------------------------------------------------------------------------------------------------------
--------------------------------------------------------------------------------------------------------------------------------------------------------------------------------------------------------
--------------------------------------------------------------------------------------------------------------------------------------------------------------------------------------------------------
----------------------------------------------------Tt--------------------------------------------------------------------------------Tt----------------------------------------------------------------
----------------------------------------------------tt----------------------------------------------------------------------Tt--------tt----------------------------------------------------------------
-------------------------------------------------G--t---K-------------------------------------------------------------------tt--------tt----------------------------------------------K-----------------
------------------------------------------------%%%%%-%%%%%-----------------------------------------------------------------tt----F---tt---------------------------------------------%%%----------------
-----------------------------------------K------||||G-|||K|---------------------------------------------------------------G-tt--G--%%%%%%%%----G-------------------------------------|||----------------
----------------------------------------%%%%%%%%||%%%%%%%%|-------------------------%%%%%%%%%%%%-----------------------%%%%%%%%%%%%||||||||---%%%------------------------------------|||----------------
----------------------------------------|||||||||||||||||||-------------------------||||||||||||-----------------------||||||||||||||||||||---|||------------------------------------|||----------------
%%%%%%%%%%%%%%%%%%%%%%%%%%%%%%%%%%%%%%%%||||||||%%%%%%%%%%%%%%%%%%%%%%%%%%%%%%%%%%%%||||||||||||%%%%%%%%%%%%%%%%%%%%%%%||||||||||||||||||||%%%|||%%%%%%%%%%%%%%%%%%%%%%%%%%%%%%%%%%%%%%%%%%%%%%%%%%%%%%%
