--------------------------------------------------------------------------------------------------------------------------------------------------------------------------------------------------------
--------------------------------------------------------------------------------------------------------------------------------------------------------------------------------------------------------
--------------------------------------------------------------------------------------------------------------------------------------------------------------------------------------------------------
--------------------------------------------------------------------------------------------------------------------------------------------------------------------------------------------------------
--------------------------------------------------------------------------------------------------------------------------------------------------------------------------------------------------------
--------------------------------------------------------------------------------------------------------------------------------------------------------------------------------------------------------
--------------------------------------------------------------------------------------------------------------------------------------------------------------------------------------------------------
-----------------------------------------------------------------------Tt-------------------------------------------------------------------------------------------------------------------------------
-----------------------------------------------------------------------tt-------------------------------------------------------------------------------Tt----------------------------------------------
-----------------------------------------------------------------Tt----tt-------------------------------------------------------------------------------tt----------------------------------------------
-----------------------------------------------------------------tt----tt-------------------------------------------------------------------------------tt------------------Tt--------------------------
-----------------------------------------------------------------tt%%%%%%%%%%-----------------------------------------------------F2UCU-----------------tt------------------tt--------------------------
-------------K---K----------------------------K--G---------------tt||||||----------G------------------------------K----------------------------------%%%%%%%%%%-------------tt----------------------GG--
-----------%%%%%%%%%%-------------------%%%%%%%%%%----------%%%%%%%%%%%||XXXX----%%%--%%%---------BU---%%%%%%%%%%%%-----G----------------------------||||||||||-------%%%%%%tt%-----------%%%%-----%%%%%
-----------||||||||||-------------------||||||||||----------|||||||||||||XXXX----|||--|||--------------||||||||||||---%%%%%---%%%%-------------------||||||||||-------|||%%%%%%%%%--------||||-----|||||
%%%%%%%%%%%||||||||||%%%%%%%%%%%%%%%%%%%||||||||||%%%%%%%%%%%%%%%%%%%%%%%%%%%%%%%|||--|||%%%%%%%%%%%%%%%%%%%%%%%%%%%%%|||||---||||%%%%%%%%%%%%%%%%%%%%%%%%%%%%%%%%%%%%%%%|||||||||%%%%%%%%||||-----|||||
