--------------------------------------------------------------------------------------------------------------------------------------------------------------------------------------------------------
--------------------------------------------------------------------------------------------------------------------------------------------------------------------------------------------------------
--------------------------------------------------------------------------------------------------------------------------------------------------------------------------------------------------------
--------------------------------------------------------------------------------------------------------------------------------------------------------------------------------------------------------
--------------------------------------------------------------------------------------------------------------------------------------------------------------------------------------------------------
--------------------------------------------------------------------------------------------------------------------------------------------------------------------------------------------------------
--------------------------------------------------------------------------------------------------------------------------------------------------------------------------------------------------------
--------------------------------------------------------------------------------------------------------------------------------------------------------------------------------------------------------
------------------------------------------------Tt------------------------------------------------------------------------------------------------------------------------------------------------------
-----------------------------------Tt-----------tt------------------------------------------------------------------------------------------------------------------------------------------------------
-----------------------------------tt-----------tt------------------------------------------------------------------------------------------------------------------------------------------------------
-----------------------------------tt%%%%%%%----tt-----------------------%%%%-----------------------------------------------------F---------------------------------------------------------------------
--------------G--------------------tt||GG||%%%%%%%%%%-------------%%%%%--||||----------------%%%%%%--------------------------%%%%%%%%%%-----------------------------------------------------------%%%%%%
--------------%%%---------------%%%%%%%%%%|||||||||||------22C----|||||--||||----------------||||||-----------------2CUS22---||||||||||-----G---------------------------------------%%%%%---------||||||
--------------|||---------------|||||||||||||||||||||----------%%%|||||--||||----------------||||||--------------------------||||||||||--%%%%%--%%%%----------%%%%%%%%%%%-----------|||||---------||||||
XXXXXXXXXXXXXXXXXXXXXXXXXXXXXXXXXXXXXXXXXXXXXXXXXXXXXXXXXXXXXXX|||XXXXXXXXXXXXXXXXXXXXXXXXXXXXXXXXXXXXXXXXXXXXXXXXXXXXXXXXXXXXXXXXXXXXXXX|||||--||||XXXXXXXXXX|||||||||||XXXXXXXXXXXXXXXXXXXXXXXXX||||||
