--------------------------------------------------------------------------------------------------------------------------------------------------------------------------------------------------------
--------------------------------------------------------------------------------------------------------------------------------------------------------------------------------------------------------
--------------------------------------------------------------------------------------------------------------------------------------------------------------------------------------------------------
--------------------------------------------------------------------------------------------------------------------------------------------------------------------------------------------------------
--------------------------------------------------------------------------------------------------------------------------------------------------------------------------------------------------------
--------------------------------------------------------------------------------------------------------------------------------------------------------------------------------------------------------
--------------------------------------------------------------------------------------------------------------------------------------------------------------------------------------------------------
--------------------------------------------------------------------------------------------------------------------------------------------------------------------------------------------------------
--------------------------------------------------------------------------------------------------------------------------------------------------------------------------------------------------------
-------------------------------------------Tt-----------------------------------------------------------------------------------------------------------------------------------------------------------
-------------------------------------------tt-----------------------------------------------------------------------------------------------------------------------------------------------------------
-------------------%%%%%%%%%%------------G-tt----K--------------------------------------------------------------------------------F-----------------USCC------------------------------------------------
-------------------||||||||||----------%%%%%%%G%%%-%%%%%-----%%%%%----------------------------------------------%%%----%%%--------%%%---------------G-%%%%%%%%%-----------------------------------------
-------------------||||||||||%%%%%%%%%-|||||||%|||-|||||-----|||||---------%%%%%--%%%%-%%%%%----------K---------|||----|||--------|||---------------%%%%%||||||---------------------%%%----%%%%%--------
-------------------|||||||||||||||||||-|||||||||||-|||||-----|||||---------|||||--||||-|||||--%%%%---%%%--------|||----|||--------|||---%%%%%--%%%%%|||||||||||--------%%%----%%%%--|||----|||||--------
XXXXXXXXXXXXXXXXXXXXXXXXXXXXXXXXXXXXXXX|||||||X|||X|||||-----|||||XXXXXXXXX|||||--||||X|||||XX||||---|||XXXXXXXX|||----|||XXXXXXXX|||XXX|||||--|||||XXXXXXXXXXXXXXXXXXX|||----||||XX|||----|||||XXXXXXXX
