--------------------------------------------------------------------------------------------------------------------------------------------------------------------------------------------------------
--------------------------------------------------------------------------------------------------------------------------------------------------------------------------------------------------------
--------------------------------------------------------------------------------------------------------------------------------------------------------------------------------------------------------
--------------------------------------------------------------------------------------------------------------------------------------------------------------------------------------------------------
--------------------------------------------------------------------------------------------------------------------------------------------------------------------------------------------------------
--------------------------------------------------------------------------------------------------------------------------------------------------------------------------------------------------------
--------------------------------------------------------------------------------------------------------------------------------------------------------------------------------------------------------
--------------------------------------------------------------------------------------------------------------------------------------------------------------------------------------------------------
-------------------------------------------------------------------------------------------------------------------------------------------------------------------------------Tt-----------------------
-------------------------------------------------------------------------------------------------------------------------------------------------------------------------------tt-----------------------
-----------------------------------------------------------------------------------------------------------------------------------------------------G-------------------------tt-----------------------
------------------------------------------------------S2USSCU---------------------------------------------------------------------F-------------%%%%%%-------------------------tt-----------------------
-------------------%%%%%%%%%%%%----------------------------------------------------K----------G---------%%%%%------%%%%-----------%-------------||||||--------------------%%%%%%%%%%--------------------
-------------------||||||||||||--------------------------------------------%%%%%--%%%%-------CUSUS------|||||------||||-----------|-------------|||UC2SCCS-K--------KG----||||||||||--------------------
-------------------||||||||||||----------------------------------------%%%-|||||--||||------------------|||||------||||----------%%%%%----------||||||----%%%%------%%%---||||||||||--------------------
XXXXXXXXXXXXXXXXXXXXXXXXXXXXXXXXXXXXXXXXXXXXXXXXXXXXXXXXXXXXXXXXXXXXXXX|||X|||||--||||XXXXXXXXXXXXXXXXXX|||||------||||XXXXXXXXXX|||||XXXXXXXXXXXXXXXXXXXX||||------|||XXX||||||||||XXXXXXXXXXXXXXXXXXXX
