--------------------------------------------------------------------------------------------------------------------------------------------------------------------------------------------------------
--------------------------------------------------------------------------------------------------------------------------------------------------------------------------------------------------------
--------------------------------------------------------------------------------------------------------------------------------------------------------------------------------------------------------
--------------------------------------------------------------------------------------------------------------------------------------------------------------------------------------------------------
--------------------------------------------------------------------------------------------------------------------------------------------------------------------------------------------------------
--------------------------------------------------------------------------------------------------------------------------------------------------------------------------------------------------------
--------------------------------------------------------------------------------------------------------------------------------------------------------------------------------------------------------
--------------------------------------------------------------------------------------------------------------------------------------------------------------------------------------------------------
---------------------------------------------------------------Tt----------Tt---------------------------------------------------------------------------------------------------------------------------
---------------------------------------------------------------tt----------tt---------------Tt----------------------------------------------------------------------------------------------------------
---------------------------------------------------------------tt----------tt---------------tt----------------------------------------------------------------------------G-------------------KGK-------
-------------------K---------------------G--------------------%tt%%%%%%%---tt---------------tt------------------------------------F--------------------------------------%%%%---------%%%%%%%%%%%------%
----------------%%%%--%%%---------------%%%----%%%---------%%%%%%%%%%%|%%%%%%%%%%%-------%%%%%%%%%---------------------------------%%%--%%%%%----------------------------||||---------|||||||||||%%%%%%%
----------------||||--|||---------------|||----|||---------|||||||||||||||||||||||-------|||||||||---------------------------------|||--|||||%%%----------------2--------||||---------||||||||||||||||||
----------------||||--|||---------------|||----|||---------|||||||||||||||||||||||-------|||||||||---------------------------------|||--||||||||----%%%%%---%%%%---------||||---------||||||||||||||||||
%%%%%%%%%%%%%%%%||||--|||%%%%%%%%%%%%%%%|||----|||%%%%%%%%%|||||||||||%|||||||||||%%%%%%%|||||||||%%%%%%%%%%%%%%%%%%%%%%%%%%%%%%%%%|||--||||||||%%%%|||||---||||%%%%%%%%%%%%%%%%%%%%%%%%%%%%%%%%%|||||||
