--------------------------------------------------------------------------------------------------------------------------------------------------------------------------------------------------------
--------------------------------------------------------------------------------------------------------------------------------------------------------------------------------------------------------
--------------------------------------------------------------------------------------------------------------------------------------------------------------------------------------------------------
--------------------------------------------------------------------------------------------------------------------------------------------------------------------------------------------------------
--------------------------------------------------------------------------------------------------------------------------------------------------------------------------------------------------------
--------------------------------------------------------------------------------------------------------------------------------------------------------------------------------------------------------
--------------------------------------------------------------------------------------------------------------------------------------------------------------------------------------------------------
---------------------------------------------------------------------------------------------------------Tt---------------------------------------------------------------------------------------------
---------------------------------------------------------------------------------------------------------tt---------------------------------------------------------------------------------------------
---------------------------------------------------------------------------------------------------------tt---------------------------------------------Tt----------------------------------------------
---------------------------------------------------------------------------------------------------------tt--------------G------------------------------tt----------------------------------------------
--------------------------------------------------------------------------------------------Tt%%------%%%%%%%%%--%%%%%%%%%%%------F---------------------tt------%%%%---------K-----------------------K--
----------------------------------------------------------%%%%%------%%%%%------------------tt||------|||||||||--|||||||||||-----------------------%%%%%%%%%%---||||-K-------%%%%%-----------------%%%--
-------%%%----------------------------------------K---K-G-|||||------|||||-------UUCCU-%%%%%%%%%%%----||||||-----|||---|||||---------K-------------||||||||||%%%%%%%%%-------|||||-----------------|||--
-------|||--------------------------------------%%%--%%%%-|||||------|||||-------------|||||||||||----||||||XXX--|||XXX|||||---------%%%%------%%%%|||||||||||||||||||-------|||||-----------------|||--
%%%%%%%%%%%%%%%%%%%%%%%%%%%%%%%%%%%%%%%%%%%%%%%%|||--||||%|||||------|||||%%%%%%%%%%%%%%%%%%%%%%%%%%%%%%%%%%%%%%%%%%%%%%%%%%%%%%%%%%%||||------||||||||||||||%%%%%%%%%%%%%%%%|||||%%%%%%%%%%%%%%%%%|||--
