--------------------------------------------------------------------------------------------------------------------------------------------------------------------------------------------------------
--------------------------------------------------------------------------------------------------------------------------------------------------------------------------------------------------------
--------------------------------------------------------------------------------------------------------------------------------------------------------------------------------------------------------
--------------------------------------------------------------------------------------------------------------------------------------------------------------------------------------------------------
--------------------------------------------------------------------------------------------------------------------------------------------------------------------------------------------------------
--------------------------------------------------------------------------------------------------------------------------------------------------------------------------------------------------------
--------------------------------------------------------------------------------------------------------------------------------------------------------------------------------------------------------
--------------------------------------------------------------------------------------------------------------------------------------------------------------------------------------------------------
----------------------------------------------------------------Tt--------------------------------------------------------------------------------------------------------------------------------------
----------------------------------------------------------------tt--------------------------------------------------------------------------------------------------------------------------------------
----------------------------------------------------------------tt-----Tt-----------------------------------------------------------------------------------Tt------------------------------------------
----------------------------------------------------------G--%%%%%%%%--tt-----------------%%%%%%----------------------K-----------F-------------------------tt--------K-----------------------Tt--------
-----------%%%%%%-----------22SSC22------------%%%%-----%%%--||||||||--tt-----------------||||||---------------------%%%%%--------%--------------%%%--%%%---tt------%%%%%%%%%-----------------tt--------
-----------||||||---------------%%%--%%%%%%%%--||||-----|||--|||||%%%%%%%%%%%%U-----------||||||---------------------|||||--------|--G-----------|||--|||---tt------|||||||||-----------------tt--------
-----------||||||---------------|||--||||||||--||||-----|||--|||||||||||||||||------------||||||---------------------|||||-------%%%%%---%%%%----|||--|||%%%%%%%%---|||||||||-------------%%%%%%%%%%%%%%
XXXXXXXXXXXXXXXXXXXXXXXXXXXXXXXXXXXXX||||||||XX||||-----|||XXXXXXXXXXXXXXXXXXXXXXXXXXXXXXXXXXXXXXXXXXXXXXXXXXXXXXXXXX|||||XXXXXXX|||||---||||XXXX|||--|||||||||||XXX|||||||||XXXXXXXXXXXXX||||||||||||||
