--------------------------------------------------------------------------------------------------------------------------------------------------------------------------------------------------------
--------------------------------------------------------------------------------------------------------------------------------------------------------------------------------------------------------
--------------------------------------------------------------------------------------------------------------------------------------------------------------------------------------------------------
--------------------------------------------------------------------------------------------------------------------------------------------------------------------------------------------------------
--------------------------------------------------------------------------------------------------------------------------------------------------------------------------------------------------------
--------------------------------------------------------------------------------------------------------------------------------------------------------------------------------------------------------
--------------------------------------------------------------------------------------------------------------------------------------------------------------------------------------------------------
--------------------------------------------------------------------------------------------------------------------------------------------------------------------------------------------------------
-------------------------------------------------------Tt--------------------Tt--------------------------------------------------------------------------------------Tt---------------------------------
-----------------------------------Tt------------------tt--------------------tt--------------------------------------------------------------------------------------tt---------------------------------
-------------Tt--------------------tt------------------tt--------------------tt--------------------------------------------------Tt----------------------------------tt---------------------------------
-------------tt--------------------tt------------------tt%%%%%%%%%-----------tt-----------------------K-K-----K----G-------------tF----------------------------------tt--K------------------------------
------------Gtt--------------------tt---------------%%%%%%%%||||||-------%%%%%%%%%%-----------------%%%%%---%%%----UUCC------KG--tt------------------------------%%%%%%%%%%-----------C2S2S2------------
----------%%%%%%%%%%-----------%%%%%%%%%%%%%%%%-----||||||||||||G|-------||||||||||-----------------|||||---|||-------------%%%%%%%%%%%--------------------------||||||||||-----------------------------
----------||||||||||-----------||||||||||||||||-----|||||||||%%%%%%%%%%%-||||||||||%%%----%%%%%-----|||||---|||-------------|||||||||||--------------------------||||||||||-----------------------------
XXXXXXXXXX||||||||||XXXXXXXXXXX|||||||||||XXXXXXXXXX||||||||X|||||||||||XXXXXXXXXXX|||----|||||XXXXX|||||---|||XXXXXXXXXXXXX|||||||||||XXXXXXXXXXXXXXXXXXXXXXXXXX||||||||||XXXXXXXXXXXXXXXXXXXXXXXXXXXXX
