--------------------------------------------------------------------------------------------------------------------------------------------------------------------------------------------------------
--------------------------------------------------------------------------------------------------------------------------------------------------------------------------------------------------------
--------------------------------------------------------------------------------------------------------------------------------------------------------------------------------------------------------
--------------------------------------------------------------------------------------------------------------------------------------------------------------------------------------------------------
--------------------------------------------------------------------------------------------------------------------------------------------------------------------------------------------------------
--------------------------------------------------------------------------------------------------------------------------------------------------------------------------------------------------------
--------------------------------------------------------------------------------------------------------------------------------------------------------------------------------------------------------
----------------------------------------------------------------------------------------------------------------------------------------------------------------------Tt--------------------------------
---------------------------------------Tt-----------------------------------------------------------------------------------------------------------------------------tt--------------------------------
---------------------------------------tt-----------------------------------------------------------------------------------------------------------------------------tt--------------------------------
---------------------------------------tt----------------------------------------------------------------------------Tt-----------------------------------------------tt--------------------------------
---------------------------------------tCC----------------------------------%%%%%%%%%--------------------------------tt-----------F-----G------------------------%-%%%%%%%%-----------------------------
-----------------------------------%%%%%%%%%----G---------------------------|||||||||---K-----G----------------------tt-----------2UUSC%%%%%--%%%%%------------%%%%%%%%%%%|------------%%%%--%%%%%-----K
------------%%%%%%%%%--------------|||||%%%%%%%%%%%-------------------------|||||||||--%%%%%%%%%----------------%%%%%%%%%%-------------|||||--|||||------------||||||||||||------------||||--|||||----%%
------------|||||||||%%%---%%%-----||||||||||||||||-------------------------|||||||||--|||||||||----------------||||||||||-------------|||||--|||||------------||||||||||||------------||||--|||||----||
XXXXXXXXXXXX||||||||||||---|||XXXXXXXXXXXXXXXXXXXXXXXXXXXXXXXXXXXXXXXXXXXXXXXXXXXXXXXXXXXXXXXXXXXXXXXXXXXXXXXXXX||||||||||XXXXXXXXXXXXX|||||--|||||XXXXXXXXXXXXXXXXXXXX|||XXXXXXXXXXXXX||||--|||||XXXX||
