--------------------------------------------------------------------------------------------------------------------------------------------------------------------------------------------------------
--------------------------------------------------------------------------------------------------------------------------------------------------------------------------------------------------------
--------------------------------------------------------------------------------------------------------------------------------------------------------------------------------------------------------
--------------------------------------------------------------------------------------------------------------------------------------------------------------------------------------------------------
--------------------------------------------------------------------------------------------------------------------------------------------------------------------------------------------------------
--------------------------------------------------------------------------------------------------------------------------------------------------------------------------------------------------------
--------------------------------------------------------------------------------------------------------------------------------------------------------------------------------------------------------
--------------------------------------------------------------------------------------------------------------------------------------------------------------------------------------------------------
----------------------------------------------------------------------------------Tt-----------------------------------------Tt-------------------------------------------------------------------------
----------------------------------------------------------------------------------tt-----------------------------------------tt-------------------------------------------------------------------------
-----------------------------------------------------------------------------------t-----------------Tt--------------K-------tt-------------------------------------------------------------------------
--------------------------------------------------------------------------------K--t--%%%%%%SSUS-----tt---------K----CSK-----tt---F------------------------------------------------K-------G-----------U
------------------------------------CS----------------------------------------%%%%-%%%%%%|||---------tt-------%%%%%%%%%%-%%%%%%%%%%-------------------------------------%%%%%------%%%%--%%%%%%%%%%-----
---------------------K-------------------G-----------------------------------%%%%%%%%%%%||||-----G---tt-------||||||||||-||||||||||--------K----------------------------|||||------||||--||||||||||-----
------------%%%------%%%%%------------%%%%%-----%%%--------------------------|||||||||||||||----%%%%%%%%%%%---||||||||||-||||||||||-----%%%%%---%%%---------------------|||||------||||--||||||||||-----
XXXXXXXXXXXX|||------|||||XXXXXXXXXXXX|||||-----|||XXXXXXXXXXXXXXXXXXXXXXXXXXXXXXXXXXXXXXXXXXXXX|||||||||||XXXXXXXXXXXXXX||||||||||XXXXX|||||---|||XXXXXXXXXXXXXXXXXXXXX|||||------||||XXXXXXXXXXXXXXXXX
