--------------------------------------------------------------------------------------------------------------------------------------------------------------------------------------------------------
--------------------------------------------------------------------------------------------------------------------------------------------------------------------------------------------------------
--------------------------------------------------------------------------------------------------------------------------------------------------------------------------------------------------------
--------------------------------------------------------------------------------------------------------------------------------------------------------------------------------------------------------
--------------------------------------------------------------------------------------------------------------------------------------------------------------------------------------------------------
--------------------------------------------------------------------------------------------------------------------------------------------------------------------------------------------------------
--------------------------------------------------------------------------------------------------------------------------------------------------------------------------------------------------------
--------------------------------------------------------------------------------------------------------------------------------------------------------------------------------------------------------
--------------------------------------------------------------------------------------------------------------------------------------------------------------------------------------------------------
--------------------------------------------------------------------------------------------------------------------------------------------------------------------------------------------------------
-------------Tt-----------------------------------------------------------------------------------------------------------------------------------------------------------------------------------------
-------------tt---------------------------------------------------------G----------------------%%%%%%-----------------------------F-----------------------------K-K----------------------G--------------
-------------tt------%%%%%---%%%%--------------------------------------%%%%--------------------||||||----------------------------------------------------%%%%%%%%%%---------------------%%%%------%%%--%
-------------tt------|||||---||||--------------------------------------||||--------------------||||||--------------------------------------------G-------||||||||||---------------------||||------|||--|
--------%%%%%%%%%%---|||||---||||----------------------%%%%%---%%%%----||||--------------------||||||------------------------------------------%%%%%%%%%%%|||||||||---------------------||||------|||--|
%%%%%%%%||||||||||%%%|||||---||||%%%%%%%%%%%%%%%%%%%%%%|||||---||||%%%%||||%%%%%%%%%%%%%%%%%%%%%%%%%%%%%%%%%%%%%%%%%%%%%%%%%%%%%%%%%%%%%%%%%%%%|||||||||||%%%%%%%%%%%%%%%%%%%%%%%%%%%%%%||||------|||%%|
