--------------------------------------------------------------------------------------------------------------------------------------------------------------------------------------------------------
--------------------------------------------------------------------------------------------------------------------------------------------------------------------------------------------------------
--------------------------------------------------------------------------------------------------------------------------------------------------------------------------------------------------------
--------------------------------------------------------------------------------------------------------------------------------------------------------------------------------------------------------
--------------------------------------------------------------------------------------------------------------------------------------------------------------------------------------------------------
--------------------------------------------------------------------------------------------------------------------------------------------------------------------------------------------------------
--------------------------------------------------------------------------------------------------------------------------------------------------------------------------------------------------------
----------------------------------------------------------------------------------------------------------Tt--------------------------------------------------------------------------------------------
----------------------------------------------------------------------------------------------------------tt----------------------------------Tt--------------------------------------------------------
---------------------------------------------------------------------Tt-----------------------------------tt----------------------------------tt--------------------------------------------------------
---------------------------------------------------------------------tt-----------------------------------tt-----------------Tt------K----K---tt-GG-----------------------------------------------------
---------------------------------------------------------------------tt--------------------------------%%%%%%%%%-------------tt%%%F%%%%%-%%%%%%%%%%-----------------------------------------------------
---------------------------------------------------------------------tt----K------------%%%%--%%%%%----|||||||||-------------tt|||X|||||-||||||||||-------------------------------------------G---------
-----------------------------K----------K--%%%------%%%----------%%%%%%%%%%%------------||||--|||||----|||||||||----UCBUBB---tt||KX|||G|-||||||||||-----------U----------------------%%%%%---%%%%%-%%%%%
--------------------------%%%%%------%%%%%-|||------|||----------|||||||||||------------||||--|||||----|||||||||----------%%%%%%%%%%|%%%%%%||||||||------------%%%%------%%%%%-------|||||---|||||-|||||
%%%%%%%%%%%%%%%%%%%%%%%%%%|||||------|||||%|||------|||%%%%%%%%%%%%%%%%%%%%%%%%%%%%%%%%%||||--|||||%%%%%%%%%%%%%%%%%%%%%%%||||||||||%||||||%%%%%%%%%%%%%%%%%%%%||||------|||||%%%%%%%|||||---|||||%|||||
