--------------------------------------------------------------------------------------------------------------------------------------------------------------------------------------------------------
--------------------------------------------------------------------------------------------------------------------------------------------------------------------------------------------------------
--------------------------------------------------------------------------------------------------------------------------------------------------------------------------------------------------------
--------------------------------------------------------------------------------------------------------------------------------------------------------------------------------------------------------
--------------------------------------------------------------------------------------------------------------------------------------------------------------------------------------------------------
--------------------------------------------------------------------------------------------------------------------------------------------------------------------------------------------------------
--------------------------------------------------------------------------------------------------------------------------------------------------------------------------------------------------------
--------------------------------------------------------------------------------------------------------------------------------------------------------------------------------------------------------
--------------------------------------------------------------------------------------------------------------------------------------------------------------------------------------------------------
---------------------------------------------------------Tt---------------------------------------------------------------------------------------------------------------------------------------------
---------------------------------------------------------tt---------------------------------------------------------------------------------------------------------------------------------------------
----------------------------------------------------G----tt----------------------------------------K-----------------------%%%%%--F---------Tt----------------------------------------------------------
------222SUC---%%%%---------------------%%%%------%%%-%%%%%%%%%%------------------------%%%------%%%%%---UU2C2-------%%%%%%|||||--%---------tt-------------------%%%%%%%%%%%%---------K-----------------
---------------||||------%%%----%%%%%---||||------|||-||||||||||------------K--------G--|||------|||||-----G---------||||||||%%%%%%-%%%%%%-Gtt-%%%%--------------||||||||||||%%%%---%%%%%---------------
----------%%%%%||||------|||----|||||---||||------|||-||||||||||------------%%%%----%%%-|||------|||||---%%%%--------||||||||||||||-||||%%%%%%%%%%|--%%%%%%------||||||||||||||||---|||||---------------
XXXXXXXXXX|||||||||XXXXXX|||----|||||XXX||||------|||X||||||||||XXXXXXXXXXXX||||----|||X|||------|||||XXX||||XXXXXXXX||||||XXXXXXXXXXXXX||||||||||XXX||||||XXXXXX||||||||||||||||---|||||XXXXXXXXXXXXXXX
