--------------------------------------------------------------------------------------------------------------------------------------------------------------------------------------------------------
--------------------------------------------------------------------------------------------------------------------------------------------------------------------------------------------------------
--------------------------------------------------------------------------------------------------------------------------------------------------------------------------------------------------------
--------------------------------------------------------------------------------------------------------------------------------------------------------------------------------------------------------
--------------------------------------------------------------------------------------------------------------------------------------------------------------------------------------------------------
--------------------------------------------------------------------------------------------------------------------------------------------------------------------------------------------------------
--------------------------------------------------------------------------------------------------------------------------------------------------------------------------------------------------------
--------------------------------------------------------------------------------------------------------------------------------------------------------------------------------------------------------
----------------------------------------Tt-----------------------------------------------------Tt-------------------------------------------------------------------------------------------------------
----------------------------Tt----------tt-----------------------------------------------------tt------------------------------------------------------------------------------------------------Tt-----
----------------------------tt----------tt------------------------------Tt-----------------G---tt-----------------------KG-----------------------------------------------------------------------tt-----
---------------------%%%%%--tt------%%%%%%%%%---------------------------tt----------------%%%%%%-%%%%%---%%%-----------BCUB22B----F---------------------------------------------G----------------tt-----
---------%%%%%%%%%%%%|||||--tt--GK--|||||||||-----%%%------------------%tt%%--------------||||||-|||||---|||-------------------%%%%%----%%%------%%%%------%%%------------%%%---%%%----------%%%-tt-----
---------||||||%%%%%||||%%%%%%%%%%%-|-----|||-----|||%%%%%%%%%%%%------|tt||---------------|||||-|||||---|||--G------------%%%-|||||----|||------||||------|||------------|||---|||----------|||%%%%%%%%
---------||||||||||||||||||||||||||-|XXXXX|||-----|||||||||||||||---%%%%%%%%%%%-----------X||%%%%%%%%%---|||%%%--%%%%------|||-|||||----|||------||||------|||------------|||---|||----------|||||||||||
%%%%%%%%%%%%%%%|||||%%%%|||||||||||%%%%%%%%%%%%%%%|||||||||||||||%%%|||||||||||%%%%%%%%%%%%%%|||||||||%%%%%%|||--||||%%%%%%%%%%|||||----|||%%%%%%||||------|||%%%%%%%%%%%%|||---|||%%%%%%%%%%|||%%%%%%%%
