--------------------------------------------------------------------------------------------------------------------------------------------------------------------------------------------------------
--------------------------------------------------------------------------------------------------------------------------------------------------------------------------------------------------------
--------------------------------------------------------------------------------------------------------------------------------------------------------------------------------------------------------
--------------------------------------------------------------------------------------------------------------------------------------------------------------------------------------------------------
--------------------------------------------------------------------------------------------------------------------------------------------------------------------------------------------------------
--------------------------------------------------------------------------------------------------------------------------------------------------------------------------------------------------------
--------------------------------------------------------------------------------------------------------------------------------------------------------------------------------------------------------
--------------------------------------------------------------------------------------------------------------------------------------------------------------------------------------------------------
--------------------------------------------------------------------------------------------------------------------------------------------------------------------------------------------------------
--------------------------------------------------------------------------------------------------------------------------------------------------------------------------------------------------------
--------------------------------------------------------------------------------------------------------------------------------------------------------------------------------------------------------
--------------G---------------------------------------------------------------------%%%%%%----------------------------------------F-------------------K-------------------------------------------------
-----------%%%%%--%%%-----------------%%%%--%%%%---------------------%%%%%%---------||||||--%%%---%%%%%------------G--------------%----------%%%-----%%%------------K-----------------------------------
-----------|||||--|||-----UU2UU-------||||--||||---------------------||||||G-----G--||||||--|||---|||||---%%%%%---%%%%------------|----------|||-----|||%%%%------%%%--G--------%%%---%%%%--------------
-----------|||||--|||-----------------||||--||||-------%%%%%%%%------||||||%%%--%%%%||||||--|||---|||||---|||||---||||------------|----------|||-----|||||||------|||-%%%-------|||---||||---------%%%%-
XXXXXXXXXXX|||||--|||XXXXXXXXXXXXXXXXX||||--||||XXXXXXX||||||||XXXXXXXXXXXX|||--||||XXXXXXXX|||---|||||XXX|||||---||||XXXXXXXXXXXXXXXXXXXXXXX|||-----|||||||------|||X|||XXXXXXX|||---||||XXXXXXXXX||||-
