--------------------------------------------------------------------------------------------------------------------------------------------------------------------------------------------------------
--------------------------------------------------------------------------------------------------------------------------------------------------------------------------------------------------------
--------------------------------------------------------------------------------------------------------------------------------------------------------------------------------------------------------
--------------------------------------------------------------------------------------------------------------------------------------------------------------------------------------------------------
--------------------------------------------------------------------------------------------------------------------------------------------------------------------------------------------------------
--------------------------------------------------------------------------------------------------------------------------------------------------------------------------------------------------------
--------------------------------------------------------------------------------------------------------------------------------------------------------------------------------------------------------
--------------------------------------------------------------------------------------------------------------------------------------------------------------------------------------------------------
--------------------------------------------------------------------------------------------------------------------------------------------------------------------------------------------------------
--------------------------------------------------------------------------------------------------------------------------------------------------------------------------------------------------------
-----------------------------------------------------------------------------------------------------------------------K--------Tt----------------------------------------------------------------------
-----------------------------------------------------------------------------------------------------------------UU222BC--------ttF------G---G--------------------------K--------------------2------%%%%
-----------------------------------------------------------------------------------%%%%%%%%%%---------------------------------G-tt-G---%%%%%%%%%-------------G-%%%%-----%%%%-----------------%%%%---||||
-------------------------------%%%%%%%%%%%%-------------------K-G------K-----------||||||||||-------------------------------%%%%%%%%%%-|||||||||-----------%%%-||||-----||||----%%%%----%%%%%||||------|
-------------------------------||||||||||||---%%%%%%%%%--%%%%-%%%%----%%%----------||||||||||-------------------------------||||||||||-|||||||||-----------|||-||||-----||||----||||----|||||||||---XXX|
%%%%%%%%%%%%%%%%%%%%%%%%%%%%%%%%%%%%%%%%%%%%%%|||||||||--||||%||||----|||%%%%%%%%%%%%%%%%%%%%%%%%%%%%%%%%%%%%%%%%%%%%%%%%%%%||||||||||%|||||||||%%%%%%%%%%%%%%%||||-----||||%%%%||||----|||||%%%%%%%%%%%
