--------------------------------------------------------------------------------------------------------------------------------------------------------------------------------------------------------
--------------------------------------------------------------------------------------------------------------------------------------------------------------------------------------------------------
--------------------------------------------------------------------------------------------------------------------------------------------------------------------------------------------------------
--------------------------------------------------------------------------------------------------------------------------------------------------------------------------------------------------------
--------------------------------------------------------------------------------------------------------------------------------------------------------------------------------------------------------
--------------------------------------------------------------------------------------------------------------------------------------------------------------------------------------------------------
--------------------------------------------------------------------------------------------------------------------------------------------------------------------------------------------------------
--------------------------------------------------------------------------------------------------------------------------------------------------------------------------------------------------------
---------------------------------------------------------------------------------------------------------------------------------Tt---------------------------------------------------------------------
-------------Tt------------------------------------------Tt----------------------------------------------------------------------tt---------------------------------------------------------------------
-------------tt------------------------------------------tt----------------------------------------------------------------------tt---------------------------------------------------------------------
---------K---tt-K----------------------------------------tt----------CCBB-------------2C2B-------------%%%%%%%%---------------%%%%F%%%%%----------------------------------------------------------------
-------%%%%%%%%%%-G---------------------------------%%%%%%%%%%-----------%%%----%%%%-------------------||||||||---------------||||X|||||---------%%%%%-------------------%%%%%%------------%%%%%%%%%----
-------|||%%%%%%%%%---------------------------------||||||||||-----------|||----||||-------------------|2C|||||------G--------||||XCBC2BB--------|||||-%%%%-----%%%------||||||------------|||||||||----
-------||||||||||||------%%%%%%%%--------%%%--%%%%%-||||||||||-----------|||----||||------%%%------%%%-|XX|||||----%%%--%%%%%-||||XXXXXX---------|||||-||||-----|||------||||||------------|||||||||----
%%%%%%%%%%%%%%%%%%%%%%%%%||||||||%%%%%%%%|||--|||||%%%%%%%%%%%%%%%%%%%%%%|||----||||%%%%%%|||------|||%%%%%%%%%%%%%|||--|||||%%%%%%%%%%%%%%%%%%%%|||||%||||-----|||%%%%%%%%%%%%%%%%%%%%%%%%|||||||||%%%%
