--------------------------------------------------------------------------------------------------------------------------------------------------------------------------------------------------------
--------------------------------------------------------------------------------------------------------------------------------------------------------------------------------------------------------
--------------------------------------------------------------------------------------------------------------------------------------------------------------------------------------------------------
--------------------------------------------------------------------------------------------------------------------------------------------------------------------------------------------------------
--------------------------------------------------------------------------------------------------------------------------------------------------------------------------------------------------------
--------------------------------------------------------------------------------------------------------------------------------------------------------------------------------------------------------
--------------------------------------------------------------------------------------------------------------------------------------------------------------------------------------------------------
--------------------------------------------------------------------------------------------------------------------------------------------------------------------------------------------------------
----------------------------------------------------------------------------------------------------------------------------------------------------Tt--------------------------------------------------
---------------------------------------------------------------------------Tt-----------------------------------------------------------------------tt--------------------------------------------------
---------------------------------------------------------------------------tt-----------------------------------------------------------------------tt---------------------------------------------Tt---
--------------------%%%%---------------------------------------------------tt--------------------K---------G----------------------F-----------------tt----------K----------------------------------tt---
--------------------||||--------------------G--------B2BCC-----------------tt--------------------22222BB--%%%----%%%%%%%%%-----%%%-------------%%%%%%%%%%------U2UU2U------------------------------tt---
--------------------||||---G---------------BBC22B------------G---------%%%%%%%%%%-------------------------|||----|||||||||-----|||-------------||||||||||--------------%%%%%%%%%%%---G---------%%%%%%%%%
--------------------||||---%%%%-----%%%%%-------------------%%%%%---%%%||||||||||-------------------------|||----|||||||||-----|||-------------||||||||||--------------|||||||||||-%%%%%%%%%%%-|||||||||
%%%%%%%%%%%%%%%%%%%%%%%%%%%||||-----|||||%%%%%%%%%%%%%%%%%%%|||||---|||||||||||||%%%%%%%%%%%%%%%%%%%%%%%%%|||----|||||||||-----|||%%%%%%%%%%%%%||||||||||%%%%%%%%%%%%%%%%%%%%%%%%%%|||||||||||%%%%%%%%%%
