--------------------------------------------------------------------------------------------------------------------------------------------------------------------------------------------------------
--------------------------------------------------------------------------------------------------------------------------------------------------------------------------------------------------------
--------------------------------------------------------------------------------------------------------------------------------------------------------------------------------------------------------
--------------------------------------------------------------------------------------------------------------------------------------------------------------------------------------------------------
--------------------------------------------------------------------------------------------------------------------------------------------------------------------------------------------------------
--------------------------------------------------------------------------------------------------------------------------------------------------------------------------------------------------------
--------------------------------------------------------------------------------------------------------------------------------------------------------------------------------------------------------
------------Tt------------------------------------------------------------------------------------------------------------------------------------------------------------------------------------------
------------tt------------------------------------------------------------------------------------Tt----------------------------------------------------------------------------------------------------
------------tt------------------------------------------------------------------------------------tt----------------------------------------------------------------------------------------------------
------------tt-G----------------------------------------------------Tt----------------------------tt---------------------------K------------------------------------------------------------------------
---------%%%%%%%%%%-------------------------------KK----------------tt-------------UU2C----------Gtt----------------K--------%%%%-F---------------------------------------------------------------------
---------||||||||||-----------------------%%%%%%%%%%%%%%------%%%%%%%%%-K--------------------%%%%%%%%%%----------%%%%%%%%%%%-||||---------------------------------------------------------------%%%%%---
---------||||||||||-----------------------||||||||||||||------||%%%%%%%%%%-------------------||||||||||----------|||||||||||-||||-----------------------------K------K----------------------%%%-|||||---
---------||||||%%%%%----------------------||||||||||||||------||||||||||||-------------------||||||||||----------|||||||||||-||||---------------------------%%%----%%%%%%-------------------|||-|||||---
%%%%%%%%%%%%%%%|||||%%%%%%%%%%%%%%%%%%%%%%||||||||||||||%%%%%%%%%%%%%%%%%%%%%%%%%%%%%%%%%%%%%||||||||||%%%%%%%%%%%%%%%%%%%%%%%%%%%%%%%%%%%%%%%%%%%%%%%%%%%%%|||%%%%||||||%%%%%%%%%%%%%%%%%%%%%%%|||||---
