--------------------------------------------------------------------------------------------------------------------------------------------------------------------------------------------------------
--------------------------------------------------------------------------------------------------------------------------------------------------------------------------------------------------------
--------------------------------------------------------------------------------------------------------------------------------------------------------------------------------------------------------
--------------------------------------------------------------------------------------------------------------------------------------------------------------------------------------------------------
--------------------------------------------------------------------------------------------------------------------------------------------------------------------------------------------------------
--------------------------------------------------------------------------------------------------------------------------------------------------------------------------------------------------------
--------------------------------------------------------------------------------------------------------------------------------------------------------------------------------------------------------
--------------------------------------------------------------------------------------------------------------------------------------------------------------------------------------------------------
--------------------------Tt----------------------------------------------------------------------------------------------------------------------------------------------------------------------------
--------------------------tt----------------------------------------------------------------------------------------------------------------------------------------------------Tt----------------------
--------------------------tt--------------------------------Tt------------------------------------------------------------------------------------------------------------------tt----------------------
--------------------------tt--------------------------------tt-------------------------G----------------------------------Tt------F---------------------------------------------tt-G-----G--------------
-----------------------%%%%%%%%%----------------------------tt--------------------SCU2U%%%%%%---%%%%----------------------tt------%----------------------------------------%%%%%%%%%%%%UU2CUS-----------
-----------------------|||||||||-------------%%%%%%%%%%--%%%%%%%%----------------------||||||---||||--------------------K-tt--K---|--G------K------------------------------||||||||||||-----------------
-----------------------|||||||||-------------||||||||||--||||||||----------------------||||||---||||-----------------%%%%%%%%%%---%%%%%----%%%-----------------------------||||||||||||----------------%
XXXXXXXXXXXXXXXXXXXXXXXXXXXXXXXXXXXXXXXXXXXXXXXXXXXXXXXXXXXXXXXXXXXXXXXXXXXXXXXXXXXXXXX||||||XXXXXXXXXXXXXXXXXXXXXXXX||||||||||XXX|||||----|||XXXXXXXXXXXXXXXXXXXXXXXXXXXXX||||||||||||XXXXXXXXXXXXXXXX|
