--------------------------------------------------------------------------------------------------------------------------------------------------------------------------------------------------------
--------------------------------------------------------------------------------------------------------------------------------------------------------------------------------------------------------
--------------------------------------------------------------------------------------------------------------------------------------------------------------------------------------------------------
--------------------------------------------------------------------------------------------------------------------------------------------------------------------------------------------------------
--------------------------------------------------------------------------------------------------------------------------------------------------------------------------------------------------------
--------------------------------------------------------------------------------------------------------------------------------------------------------------------------------------------------------
--------------------------------------------------------------------------------------------------------------------------------------------------------------------------------------------------------
--------------------------------------------------------------------------------------------------------------------------------------------------------------------------------------------------------
--------------------------------------------------------------------------------------------------------------------------------------------------------------------------------------------------------
---------------------------------------------------------------------------------------------------------------------Tt--------------------------------------------------------Tt-----------------------
---------------------------------------------------------------------------------------------------------------------tt--------------------------------------------------------tt-----------------------
------------CCCC2U%%%%%%%%--C22U22C---------------------------------------------------%%%%%%-------------------------tt-----------F--------------------------------------------tt-------------------%%%%
------------------||||||||------------------------------------------------------------||||||UUC-----------------%%%%%%%%%%--%%%%--%%%%%----------------CS-------------------%%%%%%%%%---------------||||
------------------||||||||------------%%%---%%%%--%%%%%------%%%%-2SSC2S%%%%-%%%%%%---||||||--------------------||||||||||--||||--|||||------%%%%%%%%%%%------------G-------|||||||||---------------||||
------------------||||||||------------|||---||||--|||||------||||-------||||-|||%%%---||||||--------------------||||||||||--||||--|||||------|||||||||||-%%%------%%%%------|||||||||---------------|%%%
XXXXXXXXXXXXXXXXXXXXXXXXXXXXXXXXXXXXXX|||---||||XX|||||------||||XXXXXXXXXXXXXXX|||XXXXXXXXXXXXXXXXXXXXXXXXXXXXX||||||||||XX||||--|||||XXXXXXXXXXXXXXXXXX|||------||||XXXXXX|||||||||XXXXXXXXXXXXXXXX|||
