--------------------------------------------------------------------------------------------------------------------------------------------------------------------------------------------------------
--------------------------------------------------------------------------------------------------------------------------------------------------------------------------------------------------------
--------------------------------------------------------------------------------------------------------------------------------------------------------------------------------------------------------
--------------------------------------------------------------------------------------------------------------------------------------------------------------------------------------------------------
--------------------------------------------------------------------------------------------------------------------------------------------------------------------------------------------------------
--------------------------------------------------------------------------------------------------------------------------------------------------------------------------------------------------------
--------------------------------------------------------------------------------------------------------------------------------------------------------------------------------------------------------
--------------------------------------------------------------------------------------------------------------------------------------------------------------------------------------------------------
--------------------------------------------------------------------------------------------------------------------------------------------------------------------------------------------------------
--------------------------------------------------------------------------------------------------------------------------------------------------------------------------------------------------------
----------------------------------------------------------------------G--------------------Tt-----------------------------------------------G-G---------------------------------------------------------
---------------------------------%%%%-----------------K--G-----------%%%%%%%%--------------tt-------------------------------------F-------U2CCU----------------------K----------------------------------
---------------------------------||||---------%%%%----%%%%%-----K----||||||||--------------tt-------------------------------------%-------------------------%%%------%%%%-------------------------------
---------------------------------||||---------||||----|||||--%%%%%%%%%%%%||||----------%%%%%%%%%----------------------K-------K---|-------------------------|||------||||-------------------------------
---------------------------------||||---------||||----|||||--||||||||||||||||----------|||||||||-------------------%%%%%------%%%%|-------------------------|||------||||-------------------------------
XXXXXXXXXXXXXXXXXXXXXXXXXXXXXXXXXXXXXXXXXXXXXX||||----|||||XX||||||||||||XXXXXXXXXXXXXXXXXXXXXXXXXXXXXXXXXXXXXXXXXX|||||------||||XXXXXXXXXXXXXXXXXXXXXXXXXX|||------||||XXXXXXXXXXXXXXXXXXXXXXXXXXXXXXX
