--------------------------------------------------------------------------------------------------------------------------------------------------------------------------------------------------------
--------------------------------------------------------------------------------------------------------------------------------------------------------------------------------------------------------
--------------------------------------------------------------------------------------------------------------------------------------------------------------------------------------------------------
--------------------------------------------------------------------------------------------------------------------------------------------------------------------------------------------------------
--------------------------------------------------------------------------------------------------------------------------------------------------------------------------------------------------------
--------------------------------------------------------------------------------------------------------------------------------------------------------------------------------------------------------
--------------------------------------------------------------------------------------------------------------------------------------------------------------------------------------------------------
--------------------------------------------------------------------------------------------------------------------------------------------------------------------------------------------------------
--------------------------------------------------------------------------------------------------------------------------------------------------------------------------------------------------------
------------------------------------Tt----------------------------------------Tt----------------------------------------------------------------Tt------------------------------------------------------
--------K---------------------------tt----------------------------------------tt------------------------------------------------G---------------tt------------------------------------------------------
------%%%%%%%%%%--------------------tt--------------------G------------------Ktt-----------------------------CUU2UU2------------CSFUU------SS--Gtt------------K-----G-----------------------------------
------||||||||||--------------------tt---------------G---%%%%%%%%%%------%%%%%%%%%%%--------------------------------%%%%%%%%%%%%--%----------%%%%%%%%-------%%%%--%%%%-----------------------------G-K--
------||||||||||----------------%%%%%%%%%-%%%%%------%%%-||||||||||%%%%%-|||||||||||-%%%%%%%%%%%--------------------||||||||||||--|----------||||||||-------||||--||||---------------------------%%%%%%-
------||||||||||----------------|||||||||-|||||------|||-|||||||||||||||-|||||||||||-|||||||||||--------------------||||||||||||--|----------||||||||-------||||--||||---------------------------||||||-
XXXXXXXXXXXXXXXXXXXXXXXXXXXXXXXX|||||||||X|||||------|||X||||||||||XXXXXX|||||||||||X|||||||||||XXXXXXXXXXXXXXXXXXXXXXXXXXXXXXXXXXXXXXXXXXXXXXXXXXXXXXXXXXXX||||--||||XXXXXXXXXXXXXXXXXXXXXXXXXXX||||||X
