--------------------------------------------------------------------------------------------------------------------------------------------------------------------------------------------------------
--------------------------------------------------------------------------------------------------------------------------------------------------------------------------------------------------------
--------------------------------------------------------------------------------------------------------------------------------------------------------------------------------------------------------
--------------------------------------------------------------------------------------------------------------------------------------------------------------------------------------------------------
--------------------------------------------------------------------------------------------------------------------------------------------------------------------------------------------------------
--------------------------------------------------------------------------------------------------------------------------------------------------------------------------------------------------------
--------------------------------------------------------------------------------------------------------------------------------------------------------------------------------------------------------
--------------------------------------------------------------------------------------------------------------------------------------------------------------------------------------------------------
--------------------------------------------------------------------------------------------------------------------------------------------------------------------------------------------------------
--------------------------------------------------------------------------------------------------------------------------------------------------------------------------------------------------------
-----------------------------G--------------------------------------------------------------------------------------------------------------------------------------------------------------------------
------2CS2SU------%%%%%%%%SSCS2U--------------------------------------------------------------------------------------------------F--------------------------------------------G------------------------
------------------||||||||-----------------------%%%---%%%--------------%%%%%-----%%%%----%%%---%%%%%-----------------%%%----%%%%%%%%%%%%%%----------------K-----------------SSCU2------%%%----%%%%-----
-------------%%%%%%|||||||-----------------------|||---|||--------------|||||-----||||----|||---|||||-----------------|||----||||||||||||||----------------SU----------G----------------|||----||||-----
-------------|||||||||||||-----------------------|||---|||--------------|||||-----||||----|||---|||||-----------------|||----||||||||||||||------------------%%%---%%%%%----------------|||----||||-----
XXXXXXXXXXXXX||||||XXXXXXXXXXXXXXXXXXXXXXXXXXXXXX|||---|||XXXXXXXXXXXXXX|||||-----||||XXXX|||---|||||XXXXXXXXXXXXXXXXX|||----||||||||||||||XXXXXXXXXXXXXXXXXX|||---|||||XXXXXXXXXXXXXXXX|||----||||XXXXX
