--------------------------------------------------------------------------------------------------------------------------------------------------------------------------------------------------------
--------------------------------------------------------------------------------------------------------------------------------------------------------------------------------------------------------
--------------------------------------------------------------------------------------------------------------------------------------------------------------------------------------------------------
--------------------------------------------------------------------------------------------------------------------------------------------------------------------------------------------------------
--------------------------------------------------------------------------------------------------------------------------------------------------------------------------------------------------------
--------------------------------------------------------------------------------------------------------------------------------------------------------------------------------------------------------
--------------------------------------------------------------------------------------------------------------------------------------------------------------------------------------------------------
--------------------------------------------------------------------------------------------------------------------------------------------------------------------------------------------------------
----------------------------------------------------------------------------------Tt--------------------------------------------------------------------------------------------------------------------
---------------------------------------------------------------------Tt-----------tt--------------------------------------------------------------------------------------------------------------------
---------------------------------------------------------------------tt-----------tt-----------------------------------------------------------------------------K--------------------------------------
------------------------------------------%%%%%%---------------------tt----------Gtt-G--------------------------------------------F----------------------------C22UBBU---------------------------G-----K
------------------------------------------|K||||-----------------%%%%%%%%%----%%%%%%%%%-------------------------------------------------------------------------G------------------%%%%%-----%%%%%%%%%%%
-----------------------------------%%%%%%%%%|||%%%---------------|||||||||----|------||------------2UCBCU------------------K-------K------------------%%%%%%%%%%%%%%---------------|||||-----|||||||||||
-----------------------------------|||||||||||||||---------------|||||||||----|XXXXXX||-----------------------------------%%%%%---%%%%----------------||||||||||||||---------------|||||-----|||||||||||
%%%%%%%%%%%%%%%%%%%%%%%%%%%%%%%%%%%|||||||||%%%|||%%%%%%%%%%%%%%%|||||||||%%%%%%%%%%%%%%%%%%%%%%%%%%%%%%%%%%%%%%%%%%%%%%%%|||||---||||%%%%%%%%%%%%%%%%%%%%%%%%%%%%%%%%%%%%%%%%%%%%%|||||-----|||%%%%%%%%
