--------------------------------------------------------------------------------------------------------------------------------------------------------------------------------------------------------
--------------------------------------------------------------------------------------------------------------------------------------------------------------------------------------------------------
--------------------------------------------------------------------------------------------------------------------------------------------------------------------------------------------------------
--------------------------------------------------------------------------------------------------------------------------------------------------------------------------------------------------------
--------------------------------------------------------------------------------------------------------------------------------------------------------------------------------------------------------
--------------------------------------------------------------------------------------------------------------------------------------------------------------------------------------------------------
--------------------------------------------------------------------------------------------------------------------------------------------------------------------------------------------------------
--------------------------------------------------------------------------------------------------------------------------------------------------------------------------------------------------------
--------------------------------------------------------------------------------------------------------------------------------------------------------------------------------------------------------
----------------------------------------------------------------------------------------------Tt--------------------------------------------------------------------------------------------------------
----------------------------------------------------------------------------------------------tt------------------------G------------------------------G---------G--------------------------------------
-------------------%%%%%---------------------------------K---G--------G-----------------------tt---------------%%%%%%%%%%---------F-----------------BBUU%%%%%%%%%%--------------------------------------
------%%%----------|||||----------%%%%---%%%%%-----------%%%%%------%%%-------------------%%%%%%%%%---------------|||||||---%%%%%%%%%-------------------||||||||||----------%%%-------------G-----K-----
------|||----------|||||-------K--||||---|||||-----------|||||------|||-------------------|||||||||------------XXX|||||||---|||||||||-------------------||||||||||----------|||------------%%%%%%%%%----
------|||----------|||||-%%%---%%%||||---|||||-----------|||||------|||%%%%%%%%%%---------|||||||||------------XXX|||||||---|||||||||-------------------||||||||||-%%%%%%%%%%||------------|||||||||----
%%%%%%|||%%%%%%%%%%%%%%%%|||---|||||||---|||||%%%%%%%%%%%|||||------|||||||||||||%%%%%%%%%|||||||||%%%%%%%%%%%%%%%%%%%%%%%%%|||||||||%%%%%%%%%%%%%%%%%%%%%%%%%%%%%%||||||||||%%%%%%%%%%%%%%|||||||||%%%%
