--------------------------------------------------------------------------------------------------------------------------------------------------------------------------------------------------------
--------------------------------------------------------------------------------------------------------------------------------------------------------------------------------------------------------
--------------------------------------------------------------------------------------------------------------------------------------------------------------------------------------------------------
--------------------------------------------------------------------------------------------------------------------------------------------------------------------------------------------------------
--------------------------------------------------------------------------------------------------------------------------------------------------------------------------------------------------------
--------------------------------------------------------------------------------------------------------------------------------------------------------------------------------------------------------
--------------------------------------------------------------------------------------------------------------------------------------------------------------------------------------------------------
--------------------------------------------------------------------------------------------------------------------------------------------------------------------------------------------------------
-----------------------------------------------------------------------------------------------------------------------------------------------------------------------------------Tt-------------------
-----------------------------------------------------------------------------------------------------------------------------------------------------------------------------------tt---------Tt--------
------------------------------------------------------------------------------Tt--------------------G------------------------------------------------------------------------------tt---------tt------K-
---------------------T-------------------K------------------------------------tt--------------------%%%%--------------------------F------------------------------------------------tt---------tt------%%
---------------------tt--------%%%%%---%%%%%-------------------%%%%%%---------tt--------------------||||-----------K--------------%--K-----------------------------------------%%%%%%%%%%%%%%%%%%%%%--||
------------------G--tt--------|||||---|||||-------------------||||||----%%%%%%%%%%%%--------------SSC22-%%%---%%%S2---------%%%--|--%%%%%----------------------------------G--|||||||||||||||||||||%%%%
------%%%%%--%%%-%%%%%%%%%-----|||||---|||||-------------------||||||----||||||||||||---%%%%%%%%----||||-|||---|||-----------|||--|--|||||------%%%%-----%%%%%---%%%%%----%%%%-|||||||||||||||||||||||||
XXXXXX|||||--|||X|||||||||XXXXX|||||---|||||XXXXXXXXXXXXXXXXXXX||||||XXXXXXXXXXXXXXXXXXX||||||||XXXXXXXXX|||---|||XXXXXXXXXXX|||--|--|||||XXXXXX||||-----|||||XXX|||||----||||XXXXXXXXXXX|||||||||||XXXX
