--------------------------------------------------------------------------------------------------------------------------------------------------------------------------------------------------------
--------------------------------------------------------------------------------------------------------------------------------------------------------------------------------------------------------
--------------------------------------------------------------------------------------------------------------------------------------------------------------------------------------------------------
--------------------------------------------------------------------------------------------------------------------------------------------------------------------------------------------------------
--------------------------------------------------------------------------------------------------------------------------------------------------------------------------------------------------------
--------------------------------------------------------------------------------------------------------------------------------------------------------------------------------------------------------
--------------------------------------------------------------------------------------------------------------------------------------------------------------------------------------------------------
--------------------------------------------------------------------------------------------------------------------------------------------------------------------------------------------------------
-------------------------------------------------------------Tt-----------------------------------------------------------------------------------------------------------------------------------------
-------------------------------------------------------------tt-----------------------------------------------------------------------------------------------------------------------------------------
-------------------------------------------------------------tt---------------------------------------------------------------------------------------------------------------G-------------------------
-------------------------------------------------------------tt-----------------------------------------------G--G%%%%%%%%-%%%----F----------------------------------%%%%%%%Tt%%---------%%%%%%%%%---%%-
----------------%%%--%%%%---------------------------------%%%%%%%%%------------------------------------------U2U22||||%%%%%%%%%%%-%K----------------------%%%%%%%%---|||||||tt||---------|||||||||---||-
----------------|||--||||----------------%%%%%------%%%---|||||||||------------%%%----%%%----------%%%%-----------|||||||||||||||%%%%%%%%%%%%-------------||||||||---||||%%%%%%%%%%------|||||||||---||-
----------------|||--||||----------------|||||------|||---|||||||||------------|||----|||----------||||-----------|||||||||||||||||||||||||||-------------||||||||---||||||||||||||------|%%%|||||%%%%%%
XXXXXXXXXXXXXXXX|||--||||XXXXXXXXXXXXXXXX|||||------|||XXXXXXXXXXXXXXXXXXXXXXXX|||----|||XXXXXXXXXXXXXXXXXXXXXXXXXXXXX|||||||||||||||||||||||XXXXXXXXXXXXX||||||||XXXXXXXXXXXXXXXXXXXXXXXX|||XXXXX||||||
