--------------------------------------------------------------------------------------------------------------------------------------------------------------------------------------------------------
--------------------------------------------------------------------------------------------------------------------------------------------------------------------------------------------------------
--------------------------------------------------------------------------------------------------------------------------------------------------------------------------------------------------------
--------------------------------------------------------------------------------------------------------------------------------------------------------------------------------------------------------
--------------------------------------------------------------------------------------------------------------------------------------------------------------------------------------------------------
--------------------------------------------------------------------------------------------------------------------------------------------------------------------------------------------------------
--------------------------------------------------------------------------------------------------------------------------------------------------------------------------------------------------------
----------------------------------------------------------------------------------------------------------------------------------------------------------------------Tt--------------------------------
---------------------------Tt-----------------------------------------------------------------------------------------------------------------------------------------tt--------------------------------
---------------------------tt-----------------------------------------------------------------------------------------------------------------------------------------tt--------------------Tt----------
------------Tt-------------tt-----------------------------------------------------------------------------------------------------------------------------------------tt--------------------tt----------
------------tt-------------tt----------------------------------------------------------------------%%%%%%%%-2CSSU-----------------F------------------------------%%%%%%%%%%-----------------tt--K-------
------------tt----------%%%%%%%%%%----K------------------------------------------------------------||||||||-----------------------%-------------SS---------------||||||||||-------------%%%%%%%%%%C2U---
---------%%%%%%%%%%-----||||||||||--%%%%------%%%------%%%%%----%%%%%--%%%%-----%%%%---------------|||||%%%%%%%%------------------|%%%------%%%%---------22SC2C--|||||||||K-------------||||||||||------
---------||||||||||-----||||||||||--||||------|||------|||||----|||||--||||-----||||---------------|||||||||||||------------------||||------||||-----------------||||||%%%%%%-----------||||||||||------
XXXXXXXXX||||||||||XXXXX||||||||||XX||||------|||XXXXXX|||||----|||||XX||||-----||||XXXXXXXXXXXXXXXXXXXXXXXXXXXXXXXXXXXXXXXXXXXXXXX|||------||||XXXXXXXXXXXXXXXXXXXXXXX||||||XXXXXXXXXXXXXXXXXXXXXXXXXXX
