--------------------------------------------------------------------------------------------------------------------------------------------------------------------------------------------------------
--------------------------------------------------------------------------------------------------------------------------------------------------------------------------------------------------------
--------------------------------------------------------------------------------------------------------------------------------------------------------------------------------------------------------
--------------------------------------------------------------------------------------------------------------------------------------------------------------------------------------------------------
--------------------------------------------------------------------------------------------------------------------------------------------------------------------------------------------------------
--------------------------------------------------------------------------------------------------------------------------------------------------------------------------------------------------------
--------------------------------------------------------------------------------------------------------------------------------------------------------------------------------------------------------
--------------------------------------------------------------------------------------------------------------------------------------------------------------------------------------------------------
--------------------------------------------------------------------------------------------------------------------------------------------------------------------------------------------------------
---------------------------------------------------------------------------------Tt------------------------------------------------------------------------------Tt-------------------------------------
--------------------------------Tt-----------------------------------------------tt------------------------------------------------------------------------------tt-------------------------------------
--------------------------------tt-----------------------------------------------tt-----------------------------%%%%%%%%%%%-------F------------------------%%%%%%tt%%-----------------------------------
----------%%%-------------------tt--G--------------------------------------------tt---UUUS2U2-----------------2S|||||||||||-------%------------------------|%%%%%%%%%%---------------------------------%
----------|||----------------%%%%%%%%%%-------------------------------------%%%%%%%%%%-------%%%----------------|||||||||||%%%%%--|---%%%------------------|||||||||||--------------------------C2CS2U-|
----------|||----------------||||||||||---------------%%%%%------%%%%%------||||||||||-------|||----------------||||||||||||||||--|---|||-----%%%%%%%%%%%--|||||||||||--------%%%----------------------|
XXXXXXXXXX|||XXXXXXXXXXXXXXXXXXXXXXXXXXXXXXXXXXXXXXXXX|||||------|||||XXXXXX||||||||||XXXXXXXXXXXXXXXXXXXXXXXXXXXXXXXXXXXXX|||||--|---|||XXXXX|||||||||||XXX||||||||||XXXXXXXX|||XXXXXXXXXXXXXXXXXXXXXX|
