--------------------------------------------------------------------------------------------------------------------------------------------------------------------------------------------------------
--------------------------------------------------------------------------------------------------------------------------------------------------------------------------------------------------------
--------------------------------------------------------------------------------------------------------------------------------------------------------------------------------------------------------
--------------------------------------------------------------------------------------------------------------------------------------------------------------------------------------------------------
--------------------------------------------------------------------------------------------------------------------------------------------------------------------------------------------------------
--------------------------------------------------------------------------------------------------------------------------------------------------------------------------------------------------------
--------------------------------------------------------------------------------------------------------------------------------------------------------------------------------------------------------
--------------------------------------------------------------------------------------------------------------------------------------------------------------------------------------------------------
--------------------------------------------------------------------------------------------------------------------------------------------------------------------------------------------------------
------------------------------------------------------------------------------------------------------------------------------------------------------------------------Tt------------------------------
---------------------------------------------------------------------------------------------------------------------------Tt-------------------------------------------tt------------------------------
------------------------------------------------------------------------%%%%-%%%%%%----------------------------------------tt-----F-------------------------------------tt----------------------G-------
-------------------------------------2BU22--%%%%-----------------------%%%%%%%%%%%%--------------------------------%%%%%---tt------------------------------------%%%-G--tt---------------%%%%---%%%%%---
--------------%%%%%%%%%%--%%%%%-------------||||-----------------------||||||||||||-------%%%%%%%%------%%%%%--%%%%|||%%%%%%%%%%--------UB-----------------------|||%%%%%%%%%------------||||---|||||%%%
--------------||||||||||--|||||-------------||||-----------------------||||||||||||-------||||||||------|||||--|||||||||||||||||----------%%%%%------%%%%%-------||||||||||||------------||||---||||||||
%%%%%%%%%%%%%%||||||||||--|||||%%%%%%%%%%%%%||||%%%%%%%%%%%%%%%%%%%%%%%||||||||||||%%%%%%%%%%%%%%%%%%%%%|||||--||||%%%||||||||||%%%%%%%%%%|||||------|||||%%%%%%%%%%%%%%%%%%%%%%%%%%%%%%%||||---|||||%%%
