--------------------------------------------------------------------------------------------------------------------------------------------------------------------------------------------------------
--------------------------------------------------------------------------------------------------------------------------------------------------------------------------------------------------------
--------------------------------------------------------------------------------------------------------------------------------------------------------------------------------------------------------
--------------------------------------------------------------------------------------------------------------------------------------------------------------------------------------------------------
--------------------------------------------------------------------------------------------------------------------------------------------------------------------------------------------------------
--------------------------------------------------------------------------------------------------------------------------------------------------------------------------------------------------------
--------------------------------------------------------------------------------------------------------------------------------------------------------------------------------------------------------
-----------------------------------------------------------------------------------------------------------------Tt-------------------------------------------------------------------------------------
------------------------------------------------------------------------------------------Tt-----------Tt--------tt-------------------------------------------------------------------------------------
-----------------------------------Tt-----------------------------------------------------tt-----------tt--------tt-------------------------------------------------------------------------------------
-------------Tt--------------------tt---------------------------------Tt------------------tt-----------tt--------tt--------------------------------------G----------------------------------------------
-------------tt--------------------tt---------------------------------tt--------------%%%%%%%%%%%------tt--G--%%%%%%%%%-----------F------Tt--------------%%%-------GK-----Tt----------------------------
-------------tt-----------------%%%%%%%%%%----------------------------tt--------------|||||||||||--%%-%%%%%%--|||||||||-----------%------tt--------------|||------%%%-----tt-----------%%%--%%%-------K-
----------%%%%%%%%%%-----U2UUSUC||||||||||%%%--%%%%%---------------%%%%%%%%%%---------|||||||||||-%||%||||||--|||||||||-----------|----K-tt---K----------|||------|||---G-tt-----------|||--|||------%%%
----------||||||||||------------|||||||||||||--|||||---------------||||||||||---------|||||||||||-||||||||||--|||||||||-----------|--%%%%%%%%%%%---------|||------|||-%%%%%%%%%%-------|||--|||------|||
XXXXXXXXXX||||||||||XXXXXXXXXXXXXXXXXXXXXX|||--|||||XXXXXXXXXXXXXXX||||||||||XXXXXXXXXXXXXXXXXXXXX||||||||||XXXXXXXXXXXXXXXXXXXXXXXXX|||||||||||XXXXXXXXXXXXXXXXXX|||X||||||||||XXXXXXX|||--|||XXXXXXXXX
