--------------------------------------------------------------------------------------------------------------------------------------------------------------------------------------------------------
--------------------------------------------------------------------------------------------------------------------------------------------------------------------------------------------------------
--------------------------------------------------------------------------------------------------------------------------------------------------------------------------------------------------------
--------------------------------------------------------------------------------------------------------------------------------------------------------------------------------------------------------
--------------------------------------------------------------------------------------------------------------------------------------------------------------------------------------------------------
--------------------------------------------------------------------------------------------------------------------------------------------------------------------------------------------------------
--------------------------------------------------------------------------------------------------------------------------------------------------------------------------------------------------------
--------------------------------------------------------------------------------------------------------------------------------------------------------------------------------------------------------
--------------------------------------------------------------------------------------------------------------------------------------------------------------------------------------------------------
------------------------------------------------------------------------------------Tt------------------------------------------------------------------------------------------------------------------
----------------------------------------------------------G-------------------------tt------------------------------------------------------------------------------------------------------------------
----------------------------------------------------------BB2-----------------------tt-K-------2UCB---------------------K---------F-------------UUCUG---------------------------------------------------
-------------------------G-------------------------------------------------------XK%%%%%%---------------------------%%%%%------%%%----------------%%%%%%----------UUBU----------------------------------
-------------------%%%%%%%%%-------------------------------------------------%%%%X%||||||---------------------------|||||------|||----------------||||||-----------------K------------------------------
-------------------|||||||||------------------------------------------%%%%%%%%%||X|||||||---------------------------|||||------|||----------------||||||-------------%%%%%%-------%%%---%%%%%-----------
%%%%%%%%%%%%%%%%%%%|||||||||%%%%%%%%%%%%%%%%%%%%%%%%%%%%%%%%%%%%%%%%%%|||||||||%%%%||||||%%%%%%%%%%%%%%%%%%%%%%%%%%%|||||------|||%%%%%%%%%%%%%%%%%%%%%%%%%%%%%%%%%%%||||||%%%%%%%|||---|||||%%%%%%%%%%%
