--------------------------------------------------------------------------------------------------------------------------------------------------------------------------------------------------------
--------------------------------------------------------------------------------------------------------------------------------------------------------------------------------------------------------
--------------------------------------------------------------------------------------------------------------------------------------------------------------------------------------------------------
--------------------------------------------------------------------------------------------------------------------------------------------------------------------------------------------------------
--------------------------------------------------------------------------------------------------------------------------------------------------------------------------------------------------------
--------------------------------------------------------------------------------------------------------------------------------------------------------------------------------------------------------
--------------------------------------------------------------------------------------------------------------------------------------------------------------------------------------------------------
--------------------------------------------------------------------------------------------------------------------------------------------------------------------------------------------------------
--------------------------------------------------------------------------------------------------------------------------------------------------------------------------------------------------------
--------------------------------------------------------------------------------------------------------------------------------------------------------------------------------------------------------
--------------------------------------------------------------------------------------------------------------------------------------------------------------------------------------------------------
-------------Tt-------------------------------------------------------K--------------------------------%%%------------------------F---------------------------------------------------------------------
-------------tt-----%%%%%%%%--------%%%%%----%%%%%----------------UU2US--------------------------------|||--------------------K---%---------------------------------------------------------------------
-------------tt-----||%%%%%%--------|||||----|||||-----------------------------------------------------|||----------------2US%%%%%|----%%%-----------------%%%%%----------------------------------%%%%--
----------%%%%%%%%%%||||||||--------|||||----|||||----------------------------------%%%%%------%%%%%---|||-------------------||||||----|||-----------------|||||----------------------------------||||--
XXXXXXXXXX||||||||||XXXXXXXXXXXXXXXX|||||----|||||XXXXXXXXXXXXXXXXXXXXXXXXXXXXXXXXXX|||||------|||||XXXXXXXXXXXXXXXXXXXXXXXXX||||||----|||XXXXXXXXXXXXXXXXXXXXXXXXXXXXXXXXXXXXXXXXXXXXXXXXXXXXXXXX||||XX
