--------------------------------------------------------------------------------------------------------------------------------------------------------------------------------------------------------
--------------------------------------------------------------------------------------------------------------------------------------------------------------------------------------------------------
--------------------------------------------------------------------------------------------------------------------------------------------------------------------------------------------------------
--------------------------------------------------------------------------------------------------------------------------------------------------------------------------------------------------------
--------------------------------------------------------------------------------------------------------------------------------------------------------------------------------------------------------
--------------------------------------------------------------------------------------------------------------------------------------------------------------------------------------------------------
--------------------------------------------------------------------------------------------------------------------------------------------------------------------------------------------------------
-----------------------Tt-------------------------------------------------------------------------------------------------------------------------------------------------------------------------------
-----------------------tt-------------------------------------------------------------------------------------------------------------------------------------------------------------------------------
-----------------------tt-------------------------------------------------------------------------------------------------------------------------------------------------------------------------------
-----------------------tt----K--------------------------------------------------------------------------------------------------------------------------------------------------K-----------------------
-------------------%%%%%%%%%%%----------2US---------------K-----------------SSCUU2S-----------------------------------------------F----%%-%%%--------------------%%%--------%%%%%-----------------------
------%%%%%%%%%%%--|||||||||||-------%%%--------------USCSSS----------------------------------------------------------------------%----||-|||--------------------|||--------|||||-----------------------
------|||||||||||--|||||||||||-------|||----%%%%%%%%%%----------------------------------------%%%%%%%%%%%-----%%%%%%%%%%----------|----||-|||--------------------|||--------|||||----%%%%%%%%%----%%%---
------|||||||||||--|||||||||||-------|||----||||||||||----------------------------------------|||||||||||-----|||||||||%%%--------|--%%%%%%%%%%%-----------------|||--------|||||----|||||||||----|||---
XXXXXX|||||||||||XXXXXXXXXXXXXXXXXXXXXXXXXXX||||||||||XXXXXXXXXXXXXXXXXXXXXXXXXXXXXXXXXXXXXXXXXXXXXXXXXXXXXXXXXXXXXXXXX|||XXXXXXXXXXX|||||||||||XXXXXXXXXXXXXXXXXXXXXXXXXXXXXXXXXXXXX|||||||||XXXX|||XXX
