--------------------------------------------------------------------------------------------------------------------------------------------------------------------------------------------------------
--------------------------------------------------------------------------------------------------------------------------------------------------------------------------------------------------------
--------------------------------------------------------------------------------------------------------------------------------------------------------------------------------------------------------
--------------------------------------------------------------------------------------------------------------------------------------------------------------------------------------------------------
--------------------------------------------------------------------------------------------------------------------------------------------------------------------------------------------------------
--------------------------------------------------------------------------------------------------------------------------------------------------------------------------------------------------------
--------------------------------------------------------------------------------------------------------------------------------------------------------------------------------------------------------
--------------------------------------------------------------------------------------------------------------------------------------------------------------------------------------------------------
--------------------------------------------------------------------------------------------------------------------------------------------------------------------------------------------------------
--------------------------------------------------------------------------------------------------------------------------------------------------------------------------------------------------------
------------------------------------------------------------------------------------------GG------Tt------------------------------------------------------------------------------------------K-------G-
-------------------------------------------------------G-------------------------------%%G%%%-----tt------------------UC2USS------F-----------------------------------------------------------%%%%%%-%%%
------------------------------------------------------%%%%%----%%%%----------------%%%%%%%%%|-----tt------------------------------%----------------G------------------------------------------||||||-|||
--------------------------------------KK--------------|||||----||||----------------||||||||||%%%%%%%%%%%--------------------------|------------%%%%%%%%%%----%%%%%%%%%%%----------------------||||||-|||
--------------------------------------%%%%------%%%---|||||----||||----------------|||||||||||||||||||||--------------------------|------------||||||||||----|||||||||||----------------------||||||-|||
XXXXXXXXXXXXXXXXXXXXXXXXXXXXXXXXXXXXXX||||------|||XXX|||||----||||XXXXXXXXXXXXXXXX|||||||||XXXXXXXXXXXXXXXXXXXXXXXXXXXXXXXXXXXXXXXXXXXXXXXXXXX||||||||||XXXX|||||||||||XXXXXXXXXXXXXXXXXXXXXXXXXXXXXXXX
