--------------------------------------------------------------------------------------------------------------------------------------------------------------------------------------------------------
--------------------------------------------------------------------------------------------------------------------------------------------------------------------------------------------------------
--------------------------------------------------------------------------------------------------------------------------------------------------------------------------------------------------------
--------------------------------------------------------------------------------------------------------------------------------------------------------------------------------------------------------
--------------------------------------------------------------------------------------------------------------------------------------------------------------------------------------------------------
--------------------------------------------------------------------------------------------------------------------------------------------------------------------------------------------------------
--------------------------------------------------------------------------------------------------------------------------------------------------------------------------------------------------------
--------------------------------------------------------------------------------------------------------------------------------------------------------------------------------------------------------
--------------------------------------------------------------------------------------------------------------------------------------------------------------------------------------------------------
--------------------------------------------------------------------------------------------------------------------------------------------------------------------------------------------------------
-------------G----------------------------------------------------------------------------------------------------------Tt------------------------------------------------------------------------------
------CCCU-%%%----------------------------------------------------------------------------------------2CBUC-------------tt--------F----------------%%%%%%----------------------------%%%%%--------------
-----------|||-----------%%%%%--%%%%---%%%%%--------------------------------------------%%%----%%%%%--------------------tt-------------------------||||||%%%-----%%%%----------------|||||--------%%%%%%
-----------||%%%---------|||||--||||---|||||----------%%%%%%2C-----%%%%%----%%%%--------|||----|||||----------------%%%%tt%%%%%%-------------------|||||||||-----||||%%%%-%%%%%------|||||--------||||||
-----------|||||---------|||||--||||---|||||----%%%%%-||||||-------|||||----||||--------|||----|||||----------------|%%%%%%%%%%|-------------------|||||||||-----||||||||-|||||------|||||--------||||||
%%%%%%%%%%%%%|||%%%%%%%%%|||||%%||||---|||||%%%%|||||%%%%%%%%%%%%%%|||||----||||%%%%%%%%|||----|||||%%%%%%%%%%%%%%%%%||||||||||%%%%%%%%%%%%%%%%%%%%%%%%%%|||-----||||||||%%%%%%%%%%%%%%%%%%%%%%%%%%%%%%%
