--------------------------------------------------------------------------------------------------------------------------------------------------------------------------------------------------------
--------------------------------------------------------------------------------------------------------------------------------------------------------------------------------------------------------
--------------------------------------------------------------------------------------------------------------------------------------------------------------------------------------------------------
--------------------------------------------------------------------------------------------------------------------------------------------------------------------------------------------------------
--------------------------------------------------------------------------------------------------------------------------------------------------------------------------------------------------------
--------------------------------------------------------------------------------------------------------------------------------------------------------------------------------------------------------
--------------------------------------------------------------------------------------------------------------------------------------------------------------------------------------------------------
--------------------------------------------------------------------------------------------------------------------------------------------------------------------------------------------------------
--------------------------------------------------------------------------------------------------------------------------------------------------------------------------------------------------------
-----------------------------------------------------------------------------------------------------------------------------Tt------------------Tt------Tt---------------------------------------------
-----------------------------------------------------------------------------GG-----------------------------------K----------tt------------------tt------tt---------------------------------------------
-----------------------------------------------K--------------------------%%%22US----U2U2CSS----------------------%%%%%------tt---F--------------tt-G----tt---G-----------------------K-----------------
----------------GG-----------------------------%%%------%%%---------------|||-------------------------------------|||||---%%%%%%%%%----------%%%%%%%%%%%%%%%%%%-----------%%%%%----%%%%-------------S2CU
------%%%%%-----%%%%%--------------------------|||------|||---------------|||----------------%%%%-----------------||||%---|||||||||----------||||||||||||||||||-----------|||||----||||-----------------
------|||||-----|||||--------------------------|||------|||---------------|||----------------||||-----------------|||||---|||||||||----------||||||||||||||||||-----------|||||----||||-----------------
XXXXXX|||||-----|||||XXXXXXXXXXXXXXXXXXXXXXXXXX|||------|||XXXXXXXXXXXXXXXXXXXXXXXXXXXXXXXXXX||||XXXXXXXXXXXXXXXXXXXXXXXXXXXXXXXXXXXXXXXXXXXXXXXXXXXXXXXXXXXXXXXXXXXXXXXXX|||||----||||XXXXXXXXXXXXXXXXX
