--------------------------------------------------------------------------------------------------------------------------------------------------------------------------------------------------------
--------------------------------------------------------------------------------------------------------------------------------------------------------------------------------------------------------
--------------------------------------------------------------------------------------------------------------------------------------------------------------------------------------------------------
--------------------------------------------------------------------------------------------------------------------------------------------------------------------------------------------------------
--------------------------------------------------------------------------------------------------------------------------------------------------------------------------------------------------------
--------------------------------------------------------------------------------------------------------------------------------------------------------------------------------------------------------
--------------------------------------------------------------------------------------------------------------------------------------------------------------------------------------------------------
--------------------------------------------------------------------------------------------------------------------------------------------------------------------------------------------------------
--------------------------------------------------------------------------------------------------------------------------------------------------------------------------------------------------------
--------------------------------------------------------------------------------------------------------------------------------------------------------------------------------------------------------
------------g--G----------------------------------------------------------------------------------------------------------------------------------------------------------------------------------------
-----------2CCUCCC-----------2UUCCCC2---C---------S----------S----------------S--------S--S---------S----------S---------------------------S--S-----------------------S--S------------------------------
--------------------%%%%%%%%----------------------------------------------------------------------------------------------------------------------------------------------------------------------------
%%%%%%%%%%----------||||||||------------------------------------------------------------------------------------------------------------------------------------------------------------------%%%%%F%%%%
||||||||||----------||||||||------------------------------------g--------------------r----------------------------------------g-------------------------------k---------------g---------------|||||%||||
||||||||||XXXXXXXXXX||||||||XXXXXXXXXXXXXXXXXXXXXXXXXXXXXXXXXXXXXXXXXXXXXXXXXXXXXXXXXXXXXXXXXXXXXXXXXXXXXXXXXXXXXXXXXXXXXXXXXXXXXXXXXXXXXXXXXXXXXXXXXXXXXXXXXXXXXXXXXXXXXXXXXXXXXXXXXXXXXXXXXX||||||||||
