--------------------------------------------------------------------------------------------------------------------------------------------------------------------------------------------------------
--------------------------------------------------------------------------------------------------------------------------------------------------------------------------------------------------------
--------------------------------------------------------------------------------------------------------------------------------------------------------------------------------------------------------
--------------------------------------------------------------------------------------------------------------------------------------------------------------------------------------------------------
--------------------------------------------------------------------------------------------------------------------------------------------------------------------------------------------------------
--------------------------------------------------------------------------------------------------------------------------------------------------------------------------------------------------------
--------------------------------------------------------------------------------------------------------------------------------------------------------------------------------------------------------
--------------------------------------------------------------------------------------------------------------------------------------------------------------------------------------------------------
--------------------------------------------------------------------------------------------------------------------------------------------------------------------------------------------------------
--------------------------------------------------------------------------------------------------------------------------------------------------------------------------------------------------------
-----------Tt-------------------------------------------------------------------------------------------------------------------------------------------------------------------------------------------
-----------tt-----UUUUUUUUU----UUUUU--------------------------------------------------------------------------------------------------------------------------------------------------------------------
----------%%%%%%----------------------------------------------------------------------------------------------------------------------------------------------------------------------------------------
----------||||||-------------------------------------------------%%%%-----%%%%--------------------------------------------------------------------------------------------------------------------------
----------||||||---gg------g---gr--------------------------------||||-----||||-----------------------------------------------%%%%-----%%%%----------------------------------------------------%%%%%F%%%%
XXXXXXXXXX||||||XXXXXXXXXXXXXXXXXXXXXXXXXXXXXXXXXXXXXXXXXXXXXXXXX||||-----||||XXXXXXXXXXXXXXXXXXXXXXXXXXXXXXXXXXXXXXXXXXXXXXX||||-----||||XXXXXXXXXXXXXXXXXXXXXXXXXXXXXXXXXXXXXXXXXXXXXXXXXXXX|||||X||||
