--------------------------------------------------------------------------------------------------------------------------------------------------------------------------------------------------------
--------------------------------------------------------------------------------------------------------------------------------------------------------------------------------------------------------
--------------------------------------------------------------------------------------------------------------------------------------------------------------------------------------------------------
--------------------------------------------------------------------------------------------------------------------------------------------------------------------------------------------------------
--------------------------------------------------------------------------------------------------------------------------------------------------------------------------------------------------------
--------------------------------------------------------------------------------------------------------------------------------------------------------------------------------------------------------
--------------------------------------------------------------------------------------------------------------------------------------------------------------------------------------------------------
--------------------------------------------------------------------------------------------------------------------------------------------------------------------------------------------------------
--------------------------------------------------------------------------------------------------------------------------------------------------------------------------------------------------------
--------------------------------------------------------------------------------------------------------------------------------------------------------------------------------------------------------
------------g-kG----------------------------------------------------------------------------------------------------------------------------------------------------------------------------------------
-----------SUCCCCCCS--SCCCCUU----UUUUUUUUU----UU--------S--S----------------------S------------------------S------S-------------S-------S-----------S---------------S----------S--S---------------------
--------------------------------------------------------------------------------------------------------------------------------------------------------------------------------------------------------
%%%%%%%%%%------------------------------------------------------------------------------------------------------------------------------------------------------------------------------------%%%%%F%%%%
||||||||||----------------k---------------------------------------g------k---------------------g---------------------------------------------------------------------gk-----------------------|||||%||||
||||||||||XXXXXXXXXXXXXXXXXXXXXXXXXXXXXXXXXXXXXXXXXXXXXXXXXXXXXXXXXXXXXXXXXXXXXXXXXXXXXXXXXXXXXXXXX---XXXXXXXXXXXXXXXXXXXXXXXXXXXXXXXXXXXXXXXXXXXXXXXXXXXXXXXXXXXXXXXXXXXXXXXXXXXXXXXXXXXXXXXX||||||||||
