--------------------------------------------------------------------------------------------------------------------------------------------------------------------------------------------------------
--------------------------------------------------------------------------------------------------------------------------------------------------------------------------------------------------------
--------------------------------------------------------------------------------------------------------------------------------------------------------------------------------------------------------
--------------------------------------------------------------------------------------------------------------------------------------------------------------------------------------------------------
--------------------------------------------------------------------------------------------------------------------------------------------------------------------------------------------------------
--------------------------------------------------------------------------------------------------------------------------------------------------------------------------------------------------------
--------------------------------------------------------------------------------------------------------------------------------------------------------------------------------------------------------
--------------------------------------------------------------------------------------------------------------------------------------------------------------------------------------------------------
--------------------------------------------------------------------------------------------------------------------------------------------------------------------------------------------------------
--------------------------------------------------------------------------------------------------------------------------------------------------------------------------------------------------------
-------------------------------------------------------------------------------------------------g---k--------------------------------------------------------------------------------------------------
----------------------------------------------CUCCCCCS----------------S------------------------S------------------------S------------------------S-------S----------------------------------------------
---------------------------------------------------------------------------------------------------------%%%%------%%%%-----------%%%%------%%%%--------------------------------------------------------
------------------------------%%%%------%%%%-----------r-------------------------------------------------||||------||||-----------||||------||||--------------------------------------------------------
------------------------------||||------||||--r-g-gG---%%%%------%%%%-gr--g------------------------------||||------||||-----------||||------||||----------------------------------------------%%%%%F%%%%
XXXXXXXXXXXXXXXXXXXXXXXXXXXXXX||||------||||XXXXXXXXXXX||||------||||XXXXXXXXXXXXXXX------XXXXXXXXXXXXXXX||||------||||XXXXXXXXXXX||||------||||XXXXXXXXXXXXXXX------XXXXXXXXXXXXXXXXXXXXXXXXX|||||X||||
