--------------------------------------------------------------------------------------------------------------------------------------------------------------------------------------------------------
--------------------------------------------------------------------------------------------------------------------------------------------------------------------------------------------------------
--------------------------------------------------------------------------------------------------------------------------------------------------------------------------------------------------------
--------------------------------------------------------------------------------------------------------------------------------------------------------------------------------------------------------
--------------------------------------------------------------------------------------------------------------------------------------------------------------------------------------------------------
--------------------------------------------------------------------------------------------------------------------------------------------------------------------------------------------------------
--------------------------------------------------------------------------------------------------------------------------------------------------------------------------------------------------------
--------------------------------------------------------------------------------------------------------------------------------------------------------------------------------------------------------
--------------------------------------------------------------------------------------------------------------------------------------------------------------------------------------------------------
--------------------------------------------------------------------------------------------------------------------------------------------------------------------------------------------------------
--------------------------------------------------------------------------------------------------------------------------------------------------------------------------------------------------------
-------------------UUUUU--------------------------------------------------------------------------------------------------------------------------------------------------------------------------------
------------------------------------------------------------------------------------------------------------------------------------------------------------g-------------------------------------------
-----------------------------------------------------------------%%%%---%%%%-------------------%%%%---%%%%-------------------------------------------------%%%%---%%%%------------------------%%%%%F%%%%
%%%%%%%%%%%%%%%%%---k----------k---r-----------------g-----------||||---||||-------------------||||---||||-------------------%%%%---%%%%-------------------||||---||||------------------------|||||%||||
|||||||||||||||||XXXXXXXXXXXXXXXXXXXXXX---XXXXXXXXXXXXXXXXXXXXXXX||||---||||XXXXXXXXXXXXXXXXXXX||||---||||XXXXXXXXXXXXXXXXXXX||||---||||XXXXXXXXXXXXXXXXXXX||||---||||XXXXXXXXXXXXXXXXXXXXXXXX||||||||||
