--------------------------------------------------------------------------------------------------------------------------------------------------------------------------------------------------------
--------------------------------------------------------------------------------------------------------------------------------------------------------------------------------------------------------
--------------------------------------------------------------------------------------------------------------------------------------------------------------------------------------------------------
--------------------------------------------------------------------------------------------------------------------------------------------------------------------------------------------------------
--------------------------------------------------------------------------------------------------------------------------------------------------------------------------------------------------------
--------------------------------------------------------------------------------------------------------------------------------------------------------------------------------------------------------
--------------------------------------------------------------------------------------------------------------------------------------------------------------------------------------------------------
--------------------------------------------------------------------------------------------------------------------------------------------------------------------------------------------------------
--------------------------------------------------------------------------------------------------------------------------------------------------------------------------------------------------------
--------------------------------------------------------------------------------------------------------------------------------------------------------------------------------------------------------
--------------------------------------------------------------------------------------------------------------------------------------------------------------------------------------------------------
------------UCCCCCCCCU---BUCUUUUCB-r-------g-----UUUUUU----------------------------------B------------------B---------B-------------------B-----------------------------B-------------------------------
-----------------------------------%%%%----%%%%------------------------------------------------k--------------------------------------------------------------------------------------------------------
-----------------------------------||||----||||------------------------------------------------%%%%----%%%%------------------%%%%----%%%%-----------------------------------------------------%%%%%F%%%%
%%%%%%%%%%--grG--------------------||||----||||------------------k-------r---------------------||||----||||------------------||||----||||-----------------------------------------------------|||||X||||
||||||||||%%%%%%%%%%%%%%%%%%%%%%%%%||||----||||%%%%%%%%%%%%%%%%%%%%%%----%%%%%%%%%%%%%%%%%%%%%%||||----||||%%%%%%%%%%%%%%%%%%||||----||||%%%%%%%%%%%%%%%%%%%%%%----%%%%%%%%%%%%%%%%%%%%%%%%%%%|||||X||||
