--------------------------------------------------------------------------------------------------------------------------------------------------------------------------------------------------------
--------------------------------------------------------------------------------------------------------------------------------------------------------------------------------------------------------
--------------------------------------------------------------------------------------------------------------------------------------------------------------------------------------------------------
--------------------------------------------------------------------------------------------------------------------------------------------------------------------------------------------------------
--------------------------------------------------------------------------------------------------------------------------------------------------------------------------------------------------------
--------------------------------------------------------------------------------------------------------------------------------------------------------------------------------------------------------
--------------------------------------------------------------------------------------------------------------------------------------------------------------------------------------------------------
--------------------------------------------------------------------------------------------------------------------------------------------------------------------------------------------------------
--------------------------------------------------------------------------------------------------------------------------------------------------------------------------------------------------------
--------------------------------------------------------------------------------------------------------------------------------------------------------------------------------------------------------
--------------------------------------------------------------------------------------------------------------------------------------------------------------------------------------------------------
-----------BCCUCCCCUC----UCUUUUUU-----------------BUUUUU----------------------------------B-------------------B-------B---------------------------------------------------B-------B--B------------------
-----------------------------------g--------------------------------------------------------------------------------------------------------------------------------------------------------------------
-----------------------------------%%%%------%%%%----------------------------g----------------------------------------------------------------------------------------------------------------%%%%%F%%%%
%%%%%%%%%%--kr---------------------||||------||||----------------%%%%------%%%%---g----------g-------------------------------%%%%------%%%%------------g------------------------------------r-|||||X||||
||||||||||%%%%%%%%%%%%%%%%%%%%%%%%%||||------||||%%%%%%%%%%%%%%%%||||------||||%%%%%%%%%%%%%%%%%%%%------%%%%%%%%%%%%%%%%%%%%||||------||||%%%%%%%%%%%%%%%%%%%%------%%%%%%%%%%%%%%%%%%%%%%%%%|||||X||||
