--------------------------------------------------------------------------------------------------------------------------------------------------------------------------------------------------------
--------------------------------------------------------------------------------------------------------------------------------------------------------------------------------------------------------
--------------------------------------------------------------------------------------------------------------------------------------------------------------------------------------------------------
--------------------------------------------------------------------------------------------------------------------------------------------------------------------------------------------------------
--------------------------------------------------------------------------------------------------------------------------------------------------------------------------------------------------------
--------------------------------------------------------------------------------------------------------------------------------------------------------------------------------------------------------
--------------------------------------------------------------------------------------------------------------------------------------------------------------------------------------------------------
--------------------------------------------------------------------------------------------------------------------------------------------------------------------------------------------------------
--------------------------------------------------------------------------------------------------------------------------------------------------------------------------------------------------------
--------------------------------------------------------------------------------------------------------------------------------------------------------------------------------------------------------
----------------------ggr------------------------rr-----------------------------------------------------------------------------------------------------------------------------------------------------
------------CUUCUC----CCCCUUCU-----g-------------2CCCCCU-------S---------------S--------S--------------------S--------S--------------------S-------------S---------------S---------S--------------------
-----------------------------------%%%%-----%%%%-----------------------------------------------%%%%-----%%%%-----------------------------------------------%%%%-----%%%%--------------------------------
-----------------------------------||||-----||||-----------------------------------------------||||-----||||-----------------------------------------------||||-----||||--------------------------------
%%%%%%%%%%-ggg---------------------||||-----||||-----------------------------------------------||||-----||||-----------------------------------------------||||-----||||--------------------------------
||||||||||XXXXXXXXXXXXXXXXXXXXXXXXX||||-----||||XXXXXXXXXXXXXXXXXXXXX-----XXXXXXXXXXXXXXXXXXXXX||||-----||||XXXXXXXXXXXXXXXXXXXXX-----XXXXXXXXXXXXXXXXXXXXX||||-----||||XXXXXXXXXXXXXXXXXXXXXXXXXXXFXXXX
