--------------------------------------------------------------------------------------------------------------------------------------------------------------------------------------------------------
--------------------------------------------------------------------------------------------------------------------------------------------------------------------------------------------------------
--------------------------------------------------------------------------------------------------------------------------------------------------------------------------------------------------------
--------------------------------------------------------------------------------------------------------------------------------------------------------------------------------------------------------
--------------------------------------------------------------------------------------------------------------------------------------------------------------------------------------------------------
--------------------------------------------------------------------------------------------------------------------------------------------------------------------------------------------------------
--------------------------------------------------------------------------------------------------------------------------------------------------------------------------------------------------------
--------------------------------------------------------------------------------------------------------------------------------------------------------------------------------------------------------
--------------------------------------------------------------------------------------------------------------------------------------------------------------------------------------------------------
--------------------------------------------------------------------------------------------------------------------------------------------------------------------------------------------------------
--------------------------------------------------------------------------------------------------------------------------------------------------------------------------------------------------------
-------------------------CCC---------------CCUUUUU---S-------------S------------------------S--------S-----------------------------------------------------------------S-------------S------------------
------------------------------g------k-----------------k------k-------------------------------------------------------------------%%%%---%%%%-----------------------------------------------------------
%%%%%%%%%%%%%%%%--------------%%%%---%%%%--------------%%%%---%%%%---------------------------------------%%%%---%%%%--------------||||---||||-----------------------------------------------------------
||||||||||||||||%%%%%%%--kG---||||---||||--------------||||---||||--------------%%%%---%%%%--------------||||---||||--------------||||---||||-------------------------------------------------%%%%%F%%%%
|||||||||||||||||||||||XXXXXXX||||---||||XXXXXXXXXXXXXX||||---||||XXXXXXXXXXXXXX||||---||||XXXXXXXXXXXXXX||||---||||XXXXXXXXXXXXXX||||---||||XXXXXXXXXXXXXXXXXX---XXXXXXXXXXXXXXXXXXXXXXXXXXXX|||||X||||
