--------------------------------------------------------------------------------------------------------------------------------------------------------------------------------------------------------
--------------------------------------------------------------------------------------------------------------------------------------------------------------------------------------------------------
--------------------------------------------------------------------------------------------------------------------------------------------------------------------------------------------------------
--------------------------------------------------------------------------------------------------------------------------------------------------------------------------------------------------------
--------------------------------------------------------------------------------------------------------------------------------------------------------------------------------------------------------
--------------------------------------------------------------------------------------------------------------------------------------------------------------------------------------------------------
--------------------------------------------------------------------------------------------------------------------------------------------------------------------------------------------------------
--------------------------------------------------------------------------------------------------------------------------------------------------------------------------------------------------------
--------------------------------------------------------------------------------------------------------------------------------------------------------------------------------------------------------
--------------------------------------------------------------------------------------------------------------------------------------------------------------------------------------------------------
--------------------------------gG----------------------------------------------------------------------------------------------------------------------------------------------------------------------
---------------------------------UCCCCC2--------------C--------B-------B-------------------------B--B-------------------------------B------------B--------------------------B---------------------------
-----------------------------------------r------r-------------------------------------------------------------------------------------------------------------------------------------------------------
----------------%%%%%%-------------------%%%%---%%%%----------------------------------------------------------------------------------------------------------------------------------------------------
%%%%%%%%%%------||||||%%%%%%%%%----------||||---||||-------------------------%%%%---%%%%----------------------------------------------------------------------------------------------------------------
||||||||||%%%%%%|||||||||||||||%%%%%%%%%%||||---||||%%%%%%%%%%%%%%%%%%%%%%%%%||||---||||%%%%%%%%%%%%%%%%%%%%%%%%%%%%%---%%%%%%%%%%%%%%%%%%%%%%%%%%%%%%%%%---%%%%%%%%%%%%%%%%%%%%%%%%%%%%%%%%%%%%%%%F%%%%
