--------------------------------------------------------------------------------------------------------------------------------------------------------------------------------------------------------
--------------------------------------------------------------------------------------------------------------------------------------------------------------------------------------------------------
--------------------------------------------------------------------------------------------------------------------------------------------------------------------------------------------------------
--------------------------------------------------------------------------------------------------------------------------------------------------------------------------------------------------------
--------------------------------------------------------------------------------------------------------------------------------------------------------------------------------------------------------
--------------------------------------------------------------------------------------------------------------------------------------------------------------------------------------------------------
--------------------------------------------------------------------------------------------------------------------------------------------------------------------------------------------------------
--------------------------------------------------------------------------------------------------------------------------------------------------------------------------------------------------------
--------------------------------------------------------------------------------------------------------------------------------------------------------------------------------------------------------
--------------------------------------------------------------------------------------------------------------------------------------------------------------------------------------------------------
-----------------------------------------r-g-r----------------------------------------------------------------------------------------------------------------------------------------------------------
------------------------------------------UUCCUS----------------UUUUU----------------SUUUUU-----------------UUUUUS--------------------------------------------------------------------------------------
----------------%%%%%%-----%%%%-----%%%%-------------------------------------------------------------------------------------------------%%%%-----%%%%---------%%%%-----%%%%----------------------------
%%%%%%%%%%------||||||-----||||-----||||-------------------------------%%%%-----%%%%-------------------------------%%%%-----%%%%---------||||-----||||---------||||-----||||------------------%%%%%F%%%%
||||||||||------||||||-----||||-----||||---------g-------------rkr-----||||-----||||--kkg----%%%%-----%%%%---------||||-----||||---------||||-----||||---------||||-----||||------------------|||||%||||
||||||||||XXXXXX||||||XXXXX||||-----||||XXXXXXXXXXXXX-----XXXXXXXXXXXXX||||-----||||XXXXXXXXX||||-----||||XXXXXXXXX||||-----||||XXXXXXXXX||||-----||||XXXXXXXXX||||-----||||XXXXXXXXXXXXXXXXXX||||||||||
