--------------------------------------------------------------------------------------------------------------------------------------------------------------------------------------------------------
--------------------------------------------------------------------------------------------------------------------------------------------------------------------------------------------------------
--------------------------------------------------------------------------------------------------------------------------------------------------------------------------------------------------------
--------------------------------------------------------------------------------------------------------------------------------------------------------------------------------------------------------
--------------------------------------------------------------------------------------------------------------------------------------------------------------------------------------------------------
--------------------------------------------------------------------------------------------------------------------------------------------------------------------------------------------------------
--------------------------------------------------------------------------------------------------------------------------------------------------------------------------------------------------------
--------------------------------------------------------------------------------------------------------------------------------------------------------------------------------------------------------
--------------------------------------------------------------------------------------------------------------------------------------------------------------------------------------------------------
--------------------------------------------------------------------------------------------------------------------------------------------------------------------------------------------------------
------------Tt-------------g----------------------------------------------------------------------------------------------------------------------------------------------------------------------------
------------tt-------------2CUCCCCCCC2---CCUUUU---SUUUUUUUUUU------------------UUU----S---------------------------------------------------S-------------S----------S-----------S--S---------------------
----------%%%%%%%---------------------------------------------------------------------------------------------------------------------------------------------------------------------------------------
----------|||||||------------------------------------------------g-----------------------------------------------------------%%%%----%%%%---------------------------------------------------------------
%%%%%%%%%%|||||||%%%%%%%%%---------------------------------------%%%%----%%%%------------------------------------------------||||----||||-----------------------------------------------------%%%%%F%%%%
||||||||||||||||||||||||||XXXXXXXXXXXXXXXXXXXXXXXXXXXXXXXXXXXXXXX||||----||||XXXXXXXXXXXXXXXXXXXXXXXXXXXXXXXXXXXXXXXXXXXXXXXX||||----||||XXXXXXXXXXXXXXXXXXXXXXXXXXXXXXXXXXXXXXXXXXXXXXXXXXXXX|||||X||||
