--------------------------------------------------------------------------------------------------------------------------------------------------------------------------------------------------------
--------------------------------------------------------------------------------------------------------------------------------------------------------------------------------------------------------
--------------------------------------------------------------------------------------------------------------------------------------------------------------------------------------------------------
--------------------------------------------------------------------------------------------------------------------------------------------------------------------------------------------------------
--------------------------------------------------------------------------------------------------------------------------------------------------------------------------------------------------------
--------------------------------------------------------------------------------------------------------------------------------------------------------------------------------------------------------
--------------------------------------------------------------------------------------------------------------------------------------------------------------------------------------------------------
--------------------------------------------------------------------------------------------------------------------------------------------------------------------------------------------------------
--------------------------------------------------------------------------------------------------------------------------------------------------------------------------------------------------------
--------------------------------------------------------------------------------------------------------------------------------------------------------------------------------------------------------
----------------------kg--------------------------------------------------------------------------------------------------------------------------------------------------------------------------------
---------------------2CCUUCUUUUUB---UUUUUUUU---------------------U------------B------------------------------B-------------B--------B-------------------------------------------------------------------
-----------------------------------------------------------------------------------------------%%%%-----%%%%--------------------------------%%%%-----%%%%-----------------------------------------------
--------------------------------------------------k--------------------------------------------||||-----||||--------------------------------||||-----||||-----------------------------------------------
%%%%%%%%%%%%%%%%%%%%------------------------------%%%%-----%%%%--------------------k-----------||||-----||||----g---------------------------||||-----||||----kgr----r-------------------------%%%%%F%%%%
||||||||||||||||||||%%%%%%%%%%%%%%%%%%%%%%%%%%%%%%||||-----||||%%%%%%%%%%%%%%%%%%%%%%%%%%%%%%%%||||-----||||%%%%%%%%%%%%%%%%%%%%%%%%%%%%%%%%||||-----||||%%%%%%%%%%%%%%%%%%%%%%%%%%%%%%%%%%%%%|||||X||||
