--------------------------------------------------------------------------------------------------------------------------------------------------------------------------------------------------------
--------------------------------------------------------------------------------------------------------------------------------------------------------------------------------------------------------
--------------------------------------------------------------------------------------------------------------------------------------------------------------------------------------------------------
--------------------------------------------------------------------------------------------------------------------------------------------------------------------------------------------------------
--------------------------------------------------------------------------------------------------------------------------------------------------------------------------------------------------------
--------------------------------------------------------------------------------------------------------------------------------------------------------------------------------------------------------
--------------------------------------------------------------------------------------------------------------------------------------------------------------------------------------------------------
--------------------------------------------------------------------------------------------------------------------------------------------------------------------------------------------------------
--------------------------------------------------------------------------------------------------------------------------------------------------------------------------------------------------------
--------------------------------------------------------------------------------------------------------------------------------------------------------------------------------------------------------
---------------------------------------------------rrr--------------------------------------------------------------------------------------------------------------------------------------------------
-----------------------------UCCU----------------SCUUUUU---SUUU-----------------UUUUUUUS---U-S---------------S------------------------------------------------------------------------------------------
------------------%%%%%%%%%--------------------------------------------------------------------%%%%-----%%%%--------------------------------------------------------------------------------------------
------------------|||||||||--------k-----------------------------------------------------------||||-----||||-----------------%%%%-----%%%%----------------------------------------------------%%%%%F%%%%
------------------|||||||||----k-r-%%%%-----%%%%-------------kgr-%%%%-----%%%%-----------------||||-----||||-----------------||||-----||||----------------------------------------------------|||||%||||
XXXXXXXXXXXXXXXXXX|||||||||XXXXXXXX||||-----||||XXXXXXXXXXXXXXXXX||||-----||||XXXXXXXXXXXXXXXXX||||-----||||XXXXXXXXXXXXXXXXX||||-----||||XXXXXXXXXXXXXXXXXXXXX-----XXXXXXXXXXXXXXXXXXXXXXXXXX||||||||||
