--------------------------------------------------------------------------------------------------------------------------------------------------------------------------------------------------------
--------------------------------------------------------------------------------------------------------------------------------------------------------------------------------------------------------
--------------------------------------------------------------------------------------------------------------------------------------------------------------------------------------------------------
--------------------------------------------------------------------------------------------------------------------------------------------------------------------------------------------------------
--------------------------------------------------------------------------------------------------------------------------------------------------------------------------------------------------------
--------------------------------------------------------------------------------------------------------------------------------------------------------------------------------------------------------
--------------------------------------------------------------------------------------------------------------------------------------------------------------------------------------------------------
--------------------------------------------------------------------------------------------------------------------------------------------------------------------------------------------------------
--------------------------------------------------------------------------------------------------------------------------------------------------------------------------------------------------------
--------------------------------------------------------------------------------------------------------------------------------------------------------------------------------------------------------
--------------------------------------------------------------------------------------------------------------------------------------------------------------------------------------------------------
-----------------------------------BCCUB----------------2UUUUUUUUUB--BUUUU----------------------------B--------B---------------------------B------------------------------------------------------------
-----------------------------------------------------------------------------%%%%------%%%%----------------------------------------------------------%%%%------%%%%-------------------------------------
%%%%%%%%%%---%%%%%%%%%%%%%%%%%%%%%-------------------------------------------||||------||||----------------------------------------------------------||||------||||-------------------------------------
||||||||||%%%|||||||||||||||||||||-------------------------------------------||||------||||----------------------------------------------------------||||------||||---------------------------%%%%%F%%%%
||||||||||||||||||||||||||||||||||%%%%%%%%%%%------%%%%%%%%%%%%%%%%%%%%%%%%%%||||------||||%%%%%%%%%%%%%%%%%%%%%%%%%%------%%%%%%%%%%%%%%%%%%%%%%%%%%||||------||||%%%%%%%%%%%%%%%%%%%%%%%%%%%|||||X||||
