--------------------------------------------------------------------------------------------------------------------------------------------------------------------------------------------------------
--------------------------------------------------------------------------------------------------------------------------------------------------------------------------------------------------------
--------------------------------------------------------------------------------------------------------------------------------------------------------------------------------------------------------
--------------------------------------------------------------------------------------------------------------------------------------------------------------------------------------------------------
--------------------------------------------------------------------------------------------------------------------------------------------------------------------------------------------------------
--------------------------------------------------------------------------------------------------------------------------------------------------------------------------------------------------------
--------------------------------------------------------------------------------------------------------------------------------------------------------------------------------------------------------
--------------------------------------------------------------------------------------------------------------------------------------------------------------------------------------------------------
--------------------------------------------------------------------------------------------------------------------------------------------------------------------------------------------------------
--------------------------------------------------------------------------------------------------------------------------------------------------------------------------------------------------------
-------------------------------------------ggG----------------------------------------------------------------------------------------------------------------------------------------------------------
---------------------UCCC------------------UCCC------------------UUUU-----------------BUU-------------------B--------------------------B--------------------------------------B-------------------------
---------------------------------------------------------------------------------------------------------------------------------------------------------------%%%%------%%%%---------------------------
%%%%%%%%%%%%%%%%%%%----------------------------------------------------%%%%------%%%%--------%%%%------%%%%------------------------------%%%%------%%%%--------||||------||||---------------------------
|||||||||||||||||||--g-gk--k-------------------------------------------||||------||||--------||||------||||------------------------------||||------||||--------||||------||||---------------------------
|||||||||||||||||||%%%%%%%%%%%%------%%%%%%%%%%%%%%%%------%%%%%%%%%%%%||||------||||%%%%%%%%||||------||||%%%%%%%%%%%%------%%%%%%%%%%%%||||------||||%%%%%%%%||||------||||%%%%%%%%%%%%%%%%%%%%%%F%%%%
