--------------------------------------------------------------------------------------------------------------------------------------------------------------------------------------------------------
--------------------------------------------------------------------------------------------------------------------------------------------------------------------------------------------------------
--------------------------------------------------------------------------------------------------------------------------------------------------------------------------------------------------------
--------------------------------------------------------------------------------------------------------------------------------------------------------------------------------------------------------
--------------------------------------------------------------------------------------------------------------------------------------------------------------------------------------------------------
--------------------------------------------------------------------------------------------------------------------------------------------------------------------------------------------------------
--------------------------------------------------------------------------------------------------------------------------------------------------------------------------------------------------------
--------------------------------------------------------------------------------------------------------------------------------------------------------------------------------------------------------
--------------------------------------------------------------------------------------------------------------------------------------------------------------------------------------------------------
--------------------------------------------------------------------------------------------------------------------------------------------------------------------------------------------------------
--------------------------------------------------------------------------------------------------------------------------------------------------------------------------------------------------------
------------UCUCCUCUCC-------------------------------------------C--------------------B-------------------------------B--B----------B-----B---------------B----------------------B----------------------
--------------------------Tt----------------------------------------------------------------------------------------------------------------%%%%-----%%%%-----------------------------------------------
%%%%%%%%%%----------------tt-%%%%%%%-----------------------------------------------------------%%%%-----%%%%--------------------------------||||-----||||-----------------------------------------------
||||||||||--k-------------tt-|||||||%%%%%%%%%-----g--------------------------------------------||||-----||||--------------------------------||||-----||||-----------------------------------------------
||||||||||%%%%%%%%%%%%%%%%%%%||||||||||||||||%%%%%%%%%-----%%%%%%%%%%%%%%%%%%%%%%%%%%%%%%%%%%%%||||-----||||%%%%%%%%%%%%%%%%%%%%%%%%%%%%%%%%||||-----||||%%%%%%%%%%%%%%%%%%%%%%%%%%%%%%%%%%%%%%%%%%F%%%%
