--------------------------------------------------------------------------------------------------------------------------------------------------------------------------------------------------------
--------------------------------------------------------------------------------------------------------------------------------------------------------------------------------------------------------
--------------------------------------------------------------------------------------------------------------------------------------------------------------------------------------------------------
--------------------------------------------------------------------------------------------------------------------------------------------------------------------------------------------------------
--------------------------------------------------------------------------------------------------------------------------------------------------------------------------------------------------------
--------------------------------------------------------------------------------------------------------------------------------------------------------------------------------------------------------
--------------------------------------------------------------------------------------------------------------------------------------------------------------------------------------------------------
--------------------------------------------------------------------------------------------------------------------------------------------------------------------------------------------------------
--------------------------------------------------------------------------------------------------------------------------------------------------------------------------------------------------------
--------------------------------------------------------------------------------------------------------------------------------------------------------------------------------------------------------
-----------------------g--------------------------------------------------------------------------------------------------------------------------------------------------------------------------------
--------------------g-2CUCCCUUS--------------------UUUUUUUS---------------------SUUUUUU-----------------------------------------------------S-----------------------------S-----------------------------
---------------%%%%%%--------------------------------------------%%%%------%%%%----------------%%%%------%%%%-------------------------------------------------------------------------------------------
---------------||||||--------------g-----------------------------||||------||||----------------||||------||||---------------------------------------------------------------------------------%%%%%F%%%%
----------%%%%%||||||------------r-%%%%------%%%%----------------||||------||||----------------||||------||||----------------%%%%------%%%%----------------%%%%------%%%%---------------------|||||%||||
XXXXXXXXXX|||||||||||XXXXXXXXXXXXXX||||------||||XXXXXXXXXXXXXXXX||||------||||XXXXXXXXXXXXXXXX||||------||||XXXXXXXXXXXXXXXX||||------||||XXXXXXXXXXXXXXXX||||------||||XXXXXXXXXXXXXXXXXXXXX||||||||||
