--------------------------------------------------------------------------------------------------------------------------------------------------------------------------------------------------------
--------------------------------------------------------------------------------------------------------------------------------------------------------------------------------------------------------
--------------------------------------------------------------------------------------------------------------------------------------------------------------------------------------------------------
--------------------------------------------------------------------------------------------------------------------------------------------------------------------------------------------------------
--------------------------------------------------------------------------------------------------------------------------------------------------------------------------------------------------------
--------------------------------------------------------------------------------------------------------------------------------------------------------------------------------------------------------
--------------------------------------------------------------------------------------------------------------------------------------------------------------------------------------------------------
--------------------------------------------------------------------------------------------------------------------------------------------------------------------------------------------------------
--------------------------------------------------------------------------------------------------------------------------------------------------------------------------------------------------------
--------------------------------------------------------------------------------------------------------------------------------------------------------------------------------------------------------
-----------------------------g--------------------------------------------------------------------------------------------------------------------------------------------------------------------------
----------------------------BCU--B----------------B----------B------------------------------------------------------------------------------------------------------------------------------------------
----------%%%%%%%%%-------------------------------------------------------------------------------------------------------------------------------------------------------------------------------------
----------|||||||||----------------g---------r-------------------%%%%------%%%%----------------%%%%------%%%%---------------------------------------------------------------------------------%%%%%F%%%%
%%%%%%%%%%|||||||||----------------%%%%------%%%%----------------||||------||||----------------||||------||||----------------------------------------------%%%%------%%%%---------------------|||||X||||
|||||||||||||||||||%%%%%%%%%%%%%%%%||||------||||%%%%%%%%%%%%%%%%||||------||||%%%%%%%%%%%%%%%%||||------||||%%%%%%%%%%%%%%%%%%%%------%%%%%%%%%%%%%%%%%%%%||||------||||%%%%%%%%%%%%%%%%%%%%%|||||X||||
