--------------------------------------------------------------------------------------------------------------------------------------------------------------------------------------------------------
--------------------------------------------------------------------------------------------------------------------------------------------------------------------------------------------------------
--------------------------------------------------------------------------------------------------------------------------------------------------------------------------------------------------------
--------------------------------------------------------------------------------------------------------------------------------------------------------------------------------------------------------
--------------------------------------------------------------------------------------------------------------------------------------------------------------------------------------------------------
--------------------------------------------------------------------------------------------------------------------------------------------------------------------------------------------------------
--------------------------------------------------------------------------------------------------------------------------------------------------------------------------------------------------------
--------------------------------------------------------------------------------------------------------------------------------------------------------------------------------------------------------
--------------------------------------------------------------------------------------------------------------------------------------------------------------------------------------------------------
--------------------------------------------------------------------------------------------------------------------------------------------------------------------------------------------------------
-----------------r--------------------------------------------------------------------------------------------------------------------------------------------------------------------------------------
------------------CCCCUCUS-------------------S------------------------S------------------------S-------S------------------------------------------------------------------------------------------------
---------------------------------------------------------------------------------------------------------%%%%------%%%%------------------------------------%%%%------%%%%-------------------------------
------------------------------%%%%------%%%%------------------------------------%%%%------%%%%-----------||||------||||------------------------------------||||------||||-------------------------------
%%%%%%%%%%--------------------||||------||||-----------%%%%------%%%%-----------||||------||||-----------||||------||||------------------------------------||||------||||-------------------------------
||||||||||XXXXXXXXXXXXXXXXXXXX||||------||||XXXXXXXXXXX||||------||||XXXXXXXXXXX||||------||||XXXXXXXXXXX||||------||||XXXXXXXXXXXXXXX------XXXXXXXXXXXXXXX||||------||||XXXXXXXXXXXXXXXXXXXXXXXXXXFXXXX
