--------------------------------------------------------------------------------------------------------------------------------------------------------------------------------------------------------
--------------------------------------------------------------------------------------------------------------------------------------------------------------------------------------------------------
--------------------------------------------------------------------------------------------------------------------------------------------------------------------------------------------------------
--------------------------------------------------------------------------------------------------------------------------------------------------------------------------------------------------------
--------------------------------------------------------------------------------------------------------------------------------------------------------------------------------------------------------
--------------------------------------------------------------------------------------------------------------------------------------------------------------------------------------------------------
--------------------------------------------------------------------------------------------------------------------------------------------------------------------------------------------------------
--------------------------------------------------------------------------------------------------------------------------------------------------------------------------------------------------------
--------------------------------------------------------------------------------------------------------------------------------------------------------------------------------------------------------
-----------Tt-------------------------------------------------------------------------------------------------------------------------------------------------------------------------------------------
-----------tt--------------------------------------------------kkg-G-----------------gg-----------------------------------------------------------------------------------------------------------------
-----------tt--------------------------------------------------SCCCCC----------------SUCUUU-----------------UUUU-----------------S---------------------S-----------------------------S--S---S-----------
----------%%%%%------------------------------------------------------------------------------%%%%-----%%%%---------%%%%-----%%%%---------%%%%-----%%%%--------------------------------------------------
%%%%%%%%%%|||||------------%%%%-----%%%%%%%--------------------------------------------------||||-----||||---------||||-----||||---------||||-----||||---------%%%%-----%%%%------------------%%%%%F%%%%
|||||||||||||||------------||||-----|||||||----------------------------k---------------------||||-----||||---------||||-----||||---------||||-----||||---------||||-----||||------------------|||||%||||
|||||||||||||||XXXXXXXXXXXX||||-----|||||||XXXXXXXXXX-----XXXXXXXXXXXXXXXXX-----XXXXXXXXXXXXX||||-----||||XXXXXXXXX||||-----||||XXXXXXXXX||||-----||||XXXXXXXXX||||-----||||XXXXXXXXXXXXXXXXXX||||||||||
