--------------------------------------------------------------------------------------------------------------------------------------------------------------------------------------------------------
--------------------------------------------------------------------------------------------------------------------------------------------------------------------------------------------------------
--------------------------------------------------------------------------------------------------------------------------------------------------------------------------------------------------------
--------------------------------------------------------------------------------------------------------------------------------------------------------------------------------------------------------
--------------------------------------------------------------------------------------------------------------------------------------------------------------------------------------------------------
--------------------------------------------------------------------------------------------------------------------------------------------------------------------------------------------------------
--------------------------------------------------------------------------------------------------------------------------------------------------------------------------------------------------------
--------------------------------------------------------------------------------------------------------------------------------------------------------------------------------------------------------
--------------------------------------------------------------------------------------------------------------------------------------------------------------------------------------------------------
--------------------------------------------------------------------------------------------------------------------------------------------------------------------------------------------------------
-------------------------------------------g------------------------------------------------------------------------------------------------------------------------------------------------------------
-------------------------------------------CCCCCUU-----------------SCCCCCCC---S------------------------S--------------------S-----------------S------------------------S------------S-------------------
----------%%%%%%---------------------------------------k-------------------------------------------------%%%%---%%%%------------------------------------------------------------------------------------
%%%%%%%%%%||||||---------------------------------------%%%%---%%%%--------------%%%%---%%%%--------------||||---||||--------------%%%%---%%%%-----------------------------------------------------------
||||||||||||||||---------------------------------------||||---||||--------------||||---||||--------------||||---||||--------------||||---||||-------------------------------------------------%%%%%F%%%%
||||||||||||||||XXXXXXXXXXXXXXXXXX---XXXXXXXXXXXXXXXXXX||||---||||XXXXXXXXXXXXXX||||---||||XXXXXXXXXXXXXX||||---||||XXXXXXXXXXXXXX||||---||||XXXXXXXXXXXXXXXXXX---XXXXXXXXXXXXXXXXXXXXXXXXXXXX|||||X||||
