--------------------------------------------------------------------------------------------------------------------------------------------------------------------------------------------------------
--------------------------------------------------------------------------------------------------------------------------------------------------------------------------------------------------------
--------------------------------------------------------------------------------------------------------------------------------------------------------------------------------------------------------
--------------------------------------------------------------------------------------------------------------------------------------------------------------------------------------------------------
--------------------------------------------------------------------------------------------------------------------------------------------------------------------------------------------------------
--------------------------------------------------------------------------------------------------------------------------------------------------------------------------------------------------------
--------------------------------------------------------------------------------------------------------------------------------------------------------------------------------------------------------
--------------------------------------------------------------------------------------------------------------------------------------------------------------------------------------------------------
--------------------------------------------------------------------------------------------------------------------------------------------------------------------------------------------------------
--------------------------------------------------------------------------------------------------------------------------------------------------------------------------------------------------------
--------------------------------------------------------------------------------------------------------------------------------------------------------------------------------------------------------
------------UU------------------------------------------------------------------------------------------------------------------------------------------------------------------------------------------
--------------------------------------------------------------------------------------------------------------------------------------------------------------------------------------------------------
------------------------------r---------g-----------------------------------------------------------------------------------------------------------------------------------------------------%%%%%F%%%%
%%%%%%%%%%-rg-G---------------%%%%------%%%%-----------g---------r--------------%%%%------%%%%-----------%%%%------%%%%-----------------------------------------------------------------------|||||X||||
||||||||||%%%%%%%%%%%%%%%%%%%%||||------||||%%%%%%%%%%%%%%%------%%%%%%%%%%%%%%%||||------||||%%%%%%%%%%%||||------||||%%%%%%%%%%%%%%%------%%%%%%%%%%%%%%%%%%%------%%%%%%%%%%%%%%%%%%%%%%%%%|||||X||||
