--------------------------------------------------------------------------------------------------------------------------------------------------------------------------------------------------------
--------------------------------------------------------------------------------------------------------------------------------------------------------------------------------------------------------
--------------------------------------------------------------------------------------------------------------------------------------------------------------------------------------------------------
--------------------------------------------------------------------------------------------------------------------------------------------------------------------------------------------------------
--------------------------------------------------------------------------------------------------------------------------------------------------------------------------------------------------------
--------------------------------------------------------------------------------------------------------------------------------------------------------------------------------------------------------
--------------------------------------------------------------------------------------------------------------------------------------------------------------------------------------------------------
--------------------------------------------------------------------------------------------------------------------------------------------------------------------------------------------------------
--------------------------------------------------------------------------------------------------------------------------------------------------------------------------------------------------------
--------------------------------------------------------------------------------------------------------------------------------------------------------------------------------------------------------
--------------------------------g-gG--------------------------------------------------------------------------------------------------------------------------------------------------------------------
--------------------------------SUUUUUUUUS---UUUUU-S----------------------------------------------------------------------------------------------------------------------------------------------------
----------------%%%%%%%---------------------------------------------------------------------------------------------------------------------------------------------------------------------------------
%%%%%%%%%%%%%%%%|||||||------------------------------------------k----------------------------------------------------------------------------------------------------------------------------%%%%%F%%%%
|||||||||||||||||||||||---------------k-----------------------g--%%%%------%%%%------------r----------g-----------------------------------------------g---------k-----------------------------|||||%||||
|||||||||||||||||||||||XXXXXXXXXXXXXXXXXXXXXXXXXXXXXXXXXXXXXXXXXX||||------||||XXXXXXXXXXXXXXXXXXXXXXXXXXXXXXXXXXXXXXXXXXXXXXXXXX------XXXXXXXXXXXXXXXXXXXXXXXXXXXXXXXXXXXXXXXXXXXXXXXXXXXXXXX||||||||||
