--------------------------------------------------------------------------------------------------------------------------------------------------------------------------------------------------------
--------------------------------------------------------------------------------------------------------------------------------------------------------------------------------------------------------
--------------------------------------------------------------------------------------------------------------------------------------------------------------------------------------------------------
--------------------------------------------------------------------------------------------------------------------------------------------------------------------------------------------------------
--------------------------------------------------------------------------------------------------------------------------------------------------------------------------------------------------------
--------------------------------------------------------------------------------------------------------------------------------------------------------------------------------------------------------
--------------------------------------------------------------------------------------------------------------------------------------------------------------------------------------------------------
--------------------------------------------------------------------------------------------------------------------------------------------------------------------------------------------------------
--------------------------------------------------------------------------------------------------------------------------------------------------------------------------------------------------------
--------------------------------------------------------------------------------------------------------------------------------------------------------------------------------------------------------
-------------------------------------g------------------------------------------------------------------------------------------------------------------------------------------------------------------
--------------------------------------CCC-------S-------------S------------------------------S-------------S--------------------------------------------------------------------------------------------
----------%%%%%-----------------------------------------------------------------------------------------------------------------------------------------------------------------------------------------
----------|||||------%%%%%%%%%--------------------------------------------------------------------------------------------------------------%%%%---%%%%-------------------------------------------------
%%%%%%%%%%|||||%%%%%%|||||||||--------------------%%%%---%%%%-------------------------------------------------------------------------------||||---||||---------------------------------------%%%%%F%%%%
||||||||||||||||||||||||||||||XXXXXXXXXXXXXXXXXXXX||||---||||XXXXXXXXXXXXXXXXXXXXXXXXXXXXXXXXXXXXXX---XXXXXXXXXXXXXXXXXXXXXXXXXXXXXXXXXXXXXX||||---||||XXXXXXXXXXXXXXXXXXXXXXXXXXXXXXXXXXXXXXX|||||X||||
