--------------------------------------------------------------------------------------------------------------------------------------------------------------------------------------------------------
--------------------------------------------------------------------------------------------------------------------------------------------------------------------------------------------------------
--------------------------------------------------------------------------------------------------------------------------------------------------------------------------------------------------------
--------------------------------------------------------------------------------------------------------------------------------------------------------------------------------------------------------
--------------------------------------------------------------------------------------------------------------------------------------------------------------------------------------------------------
--------------------------------------------------------------------------------------------------------------------------------------------------------------------------------------------------------
--------------------------------------------------------------------------------------------------------------------------------------------------------------------------------------------------------
--------------------------------------------------------------------------------------------------------------------------------------------------------------------------------------------------------
--------------------------------------------------------------------------------------------------------------------------------------------------------------------------------------------------------
--------------------------------------------------------------------------------------------------------------------------------------------------------------------------------------------------------
----------------------------Tt--Tt-----rkk--------------------------------------------------------------------------------------------------------------------------------------------------------------
----------------------------tt--tt------CCUUCCU----UCCUUUUU--S--S----------S----------------------------------------------------S--S------S--S----------------------------------------------------------
------------------Tt----Tt--tt-%%%%%%%------------------------------------------------------------------------------------------------------------------------------------------------------------------
------------------tt----tt-%%%%|||||||------------------------------------------------------------------------------------------------------------------------------------------------------------------
------------------tt----tt-|||||||||||---------------------------------------------------------%%%%---%%%%----------------------------------------------------------------------------------------------
XXXXXXXXXXXXXXXXXXXXXXXXXXX|||||||||||XXXXXXXXXXXXXXXXXXXXXXXXXXXXXXXXXXXXXXXXXXXXXXXXXXXXXXXXX||||---||||XXXXXXXXXXXXXXXXXXXXXXXXXXXXXXXXXXXXXXXXXXXXXXXXXXXXXXXXXXXXXXXXXXXXXXXXXXXXXXXXXXXXXXXXXFXXXX
