--------------------------------------------------------------------------------------------------------------------------------------------------------------------------------------------------------
--------------------------------------------------------------------------------------------------------------------------------------------------------------------------------------------------------
--------------------------------------------------------------------------------------------------------------------------------------------------------------------------------------------------------
--------------------------------------------------------------------------------------------------------------------------------------------------------------------------------------------------------
--------------------------------------------------------------------------------------------------------------------------------------------------------------------------------------------------------
--------------------------------------------------------------------------------------------------------------------------------------------------------------------------------------------------------
--------------------------------------------------------------------------------------------------------------------------------------------------------------------------------------------------------
--------------------------------------------------------------------------------------------------------------------------------------------------------------------------------------------------------
--------------------------------------------------------------------------------------------------------------------------------------------------------------------------------------------------------
--------------------------------------------------------------------------------------------------------------------------------------------------------------------------------------------------------
-----------k-g-g--G----------------------------rg-r-----------------------------------------------------------------------------------------------------------------------------------------------------
-----------2CUUCUUC---2CCCCCCUS----g------------UUUUUUUU----U--------------------------S--------------------------------S--S-------------------------------------------S--------------------S-----------
-----------------------------------%%%%---%%%%----------------------------------------------------------------------------------------------------------------------------------------------------------
%%%%%%%%%%-------------------------||||---||||-------------------------------------------------%%%%---%%%%----------------------------------------------------------------------------------------------
||||||||||------------gg---g-------||||---||||-------------------------------------------------||||---||||------------------------------------------------------------------------------------%%%%%F%%%%
||||||||||XXXXXXXXXXXXXXXXXXXXXXXXX||||---||||XXXXXXXXXXXXXXXXXXXXXXX---XXXXXXXXXXXXXXXXXXXXXXX||||---||||XXXXXXXXXXXXXXXXXXXXXXX---XXXXXXXXXXXXXXXXXXXXXXXXXXX---XXXXXXXXXXXXXXXXXXXXXXXXXXXX|||||X||||
