--------------------------------------------------------------------------------------------------------------------------------------------------------------------------------------------------------
--------------------------------------------------------------------------------------------------------------------------------------------------------------------------------------------------------
--------------------------------------------------------------------------------------------------------------------------------------------------------------------------------------------------------
--------------------------------------------------------------------------------------------------------------------------------------------------------------------------------------------------------
--------------------------------------------------------------------------------------------------------------------------------------------------------------------------------------------------------
--------------------------------------------------------------------------------------------------------------------------------------------------------------------------------------------------------
--------------------------------------------------------------------------------------------------------------------------------------------------------------------------------------------------------
--------------------------------------------------------------------------------------------------------------------------------------------------------------------------------------------------------
--------------------------------------------------------------------------------------------------------------------------------------------------------------------------------------------------------
--------------------------------------------------------------------------------------------------------------------------------------------------------------------------------------------------------
-------------------gG-----------------------------------------------------------------------------------------------------------------------------------------------------------------------------------
--------------------UCCCCCCCB----------------UUUUU---------------------------------------------------------------------B--------B----------------------B----------------------------B--B----B-----------
----------%%%%%%%%------------k-------------------------------------------------%%%%-----%%%%------------%%%%-----%%%%-------------------------------------%%%%-----%%%%--------------------------------
----------||||||||------------%%%%-----%%%%-------------------------------------||||-----||||------------||||-----||||-------------------------------------||||-----||||----------------------%%%%%F%%%%
%%%%%%%%%%||||||||------------||||-----||||------------%%%%-----%%%%------------||||-----||||------------||||-----||||------------%%%%-----%%%%------------||||-----||||----------------------|||||X||||
||||||||||||||||||%%%%%%%%%%%%||||-----||||%%%%%%%%%%%%||||-----||||%%%%%%%%%%%%||||-----||||%%%%%%%%%%%%||||-----||||%%%%%%%%%%%%||||-----||||%%%%%%%%%%%%||||-----||||%%%%%%%%%%%%%%%%%%%%%%|||||X||||
