--------------------------------------------------------------------------------------------------------------------------------------------------------------------------------------------------------
--------------------------------------------------------------------------------------------------------------------------------------------------------------------------------------------------------
--------------------------------------------------------------------------------------------------------------------------------------------------------------------------------------------------------
--------------------------------------------------------------------------------------------------------------------------------------------------------------------------------------------------------
--------------------------------------------------------------------------------------------------------------------------------------------------------------------------------------------------------
--------------------------------------------------------------------------------------------------------------------------------------------------------------------------------------------------------
--------------------------------------------------------------------------------------------------------------------------------------------------------------------------------------------------------
--------------------------------------------------------------------------------------------------------------------------------------------------------------------------------------------------------
--------------------------------------------------------------------------------------------------------------------------------------------------------------------------------------------------------
--------------------------------------------------------------------------------------------------------------------------------------------------------------------------------------------------------
--------------------------------------------------g-----------------------------------------------------------------------------------------------------------------------------------------------------
--------------------------------------------------CUCCCCCCCC2----r-------------BCCUUUUUU---------------------BUUUUUU-----------------------B--------B--------------------B------------------------------
----------%%%%---------------------------------------------------%%%%-----%%%%-----------------%%%%-----%%%%--------------------------------------------------------------------------------------------
%%%%%%%%%%||||------%%%%%%%%%%%%%%%%%%%-----%%%%-----------------||||-----||||-----------------||||-----||||--------------------------------------------------------------------------------------------
||||||||||||||%%%%%%|||||||||||||||||||-----||||----------------k||||-----||||-----------------||||-----||||-----------------%%%%-----%%%%-----------------%%%%-----%%%%----------------------%%%%%F%%%%
|||||||||||||||||||||||||||||||||||||||-----||||%%%%%%%%%%%%%%%%%||||-----||||%%%%%%%%%%%%%%%%%||||-----||||%%%%%%%%%%%%%%%%%||||-----||||%%%%%%%%%%%%%%%%%||||-----||||%%%%%%%%%%%%%%%%%%%%%%|||||X||||
