--------------------------------------------------------------------------------------------------------------------------------------------------------------------------------------------------------
--------------------------------------------------------------------------------------------------------------------------------------------------------------------------------------------------------
--------------------------------------------------------------------------------------------------------------------------------------------------------------------------------------------------------
--------------------------------------------------------------------------------------------------------------------------------------------------------------------------------------------------------
--------------------------------------------------------------------------------------------------------------------------------------------------------------------------------------------------------
--------------------------------------------------------------------------------------------------------------------------------------------------------------------------------------------------------
--------------------------------------------------------------------------------------------------------------------------------------------------------------------------------------------------------
--------------------------------------------------------------------------------------------------------------------------------------------------------------------------------------------------------
--------------------------------------------------------------------------------------------------------------------------------------------------------------------------------------------------------
--------------------------------------------------------------------------------------------------------------------------------------------------------------------------------------------------------
-----------------------------------------G--------------------------------------------------------------------------------------------------------------------------------------------------------------
-----------------------CCCUUS------------SUUU---------------------S-------------------------------S-----------------------------------------------------------------------------------------------------
------------------------------g---------------------------------------------------------------------------------------------------%%%%--%%%%------------------------------------------------------------
----------%%%-----------------%%%%--%%%%------------------------------------------------------------------------------------------||||--||||--------------------------------------------------%%%%%F%%%%
----------|||%%%%%%%%----k----||||--||||------------------------------------------------------------------------------------------||||--||||---------------%%%%--%%%%-------------------------|||||%||||
XXXXXXXXXX|||||||||||XXXXXXXXX||||--||||XXXXXXXXXXXXXXXXXXX--XXXXXXXXXXXXXXXXXXXXXXX--XXXXXXXXXXXXXXXXXXXXXXX--XXXXXXXXXXXXXXXXXXX||||--||||XXXXXXXXXXXXXXX||||--||||XXXXXXXXXXXXXXXXXXXXXXXXX||||||||||
