--------------------------------------------------------------------------------------------------------------------------------------------------------------------------------------------------------
--------------------------------------------------------------------------------------------------------------------------------------------------------------------------------------------------------
--------------------------------------------------------------------------------------------------------------------------------------------------------------------------------------------------------
--------------------------------------------------------------------------------------------------------------------------------------------------------------------------------------------------------
--------------------------------------------------------------------------------------------------------------------------------------------------------------------------------------------------------
--------------------------------------------------------------------------------------------------------------------------------------------------------------------------------------------------------
--------------------------------------------------------------------------------------------------------------------------------------------------------------------------------------------------------
--------------------------------------------------------------------------------------------------------------------------------------------------------------------------------------------------------
--------------------------------------------------------------------------------------------------------------------------------------------------------------------------------------------------------
--------------------------------------------------------------------------------------------------------------------------------------------------------------------------------------------------------
-----------Tt---gg--------------------------------------------------------------------------------------------------------------------------------------------------------------------------------------
-----------tt---2UUUUUUU----UUUUUUUUB---U--------B------------------------------------------------------------------------------------------------------------------------------------------------------
----------%%%%%--------------------------------------------------------------------------------%%%%-----%%%%--------------------------------------------------------------------------------------------
----------|||||--------------------------------------------------------------------------------||||-----||||----------------------------------------------------------------------------------%%%%%F%%%%
%%%%%%%%%%|||||--------------------------------------------------------------------------------||||-----||||----------------------------------------------------------------------------------|||||X||||
|||||||||||||||%%%%%%%%%%%%%%%%%%%%%%%%%%%%%%%%%%%%%%%%%%%%%%%%%%%%%%%%%%%%%%%%%%%%%%%%%%%%%%%%||||-----||||%%%%%%%%%%%%%%%%%%%%%%%%%%%%%%%%%%%%%%%%%%%%%%%%%%%%%%%%%%%%%%%%%%%%%%%%%%%%%%%%%%|||||X||||
