--------------------------------------------------------------------------------------------------------------------------------------------------------------------------------------------------------
--------------------------------------------------------------------------------------------------------------------------------------------------------------------------------------------------------
--------------------------------------------------------------------------------------------------------------------------------------------------------------------------------------------------------
--------------------------------------------------------------------------------------------------------------------------------------------------------------------------------------------------------
--------------------------------------------------------------------------------------------------------------------------------------------------------------------------------------------------------
--------------------------------------------------------------------------------------------------------------------------------------------------------------------------------------------------------
--------------------------------------------------------------------------------------------------------------------------------------------------------------------------------------------------------
--------------------------------------------------------------------------------------------------------------------------------------------------------------------------------------------------------
--------------------------------------------------------------------------------------------------------------------------------------------------------------------------------------------------------
--------------------------------------------------------------------------------------------------------------------------------------------------------------------------------------------------------
---------------------------gg---------------------------------------------------------------------------------------------------------------------------------------------------------------------------
----------------------------CCCCCUCU2--2CCCCUUUB---UUUUUUUUU-B----------------B---------B---------B-------------B--B-------B--------------B---------B--B----------B-------------------------------------
----------r-g-----Tt---------------------------------------------------------------------------------------------------------%%%%----%%%%---------------------------------------------------------------
----------%%%%%%--tt---r-----------------------------------------------------------------------------------------------------||||----||||---------------------------------------------------------------
----------||||||%%%%%%%%%%-------------g-------------------------g-----------------------------------------------------------||||----||||-----------g------g--gg----------------------------------------
%%%%%%%%%%||||||||||||||||%%%%%%%%%%%%%%%%%%%%%%%%%%%%%%%%%%%%%%%%%%%----%%%%%%%%%%%%%%%%%%%%%%%%%%%%%%%%%%%%%%%%%%%%%%%%%%%%||||----||||%%%%%%%%%%%%%%%%%%%%%%%%%%%%%%%%%%%%%%%%%%%%%%%%%%%%%%%%%%F%%%%
