--------------------------------------------------------------------------------------------------------------------------------------------------------------------------------------------------------
--------------------------------------------------------------------------------------------------------------------------------------------------------------------------------------------------------
--------------------------------------------------------------------------------------------------------------------------------------------------------------------------------------------------------
--------------------------------------------------------------------------------------------------------------------------------------------------------------------------------------------------------
--------------------------------------------------------------------------------------------------------------------------------------------------------------------------------------------------------
--------------------------------------------------------------------------------------------------------------------------------------------------------------------------------------------------------
--------------------------------------------------------------------------------------------------------------------------------------------------------------------------------------------------------
--------------------------------------------------------------------------------------------------------------------------------------------------------------------------------------------------------
--------------------------------------------------------------------------------------------------------------------------------------------------------------------------------------------------------
--------------------------------------------------------------------------------------------------------------------------------------------------------------------------------------------------------
--------------------------------------------------------------------------------------------------------------------------------------------------------------------------------------------------------
-------------------------------------------------SCCCCCC---2CCUS----------------CUUUUUUUU--------------------------------------------------------------------------------S-----------S------S-----------
----------%%%%%%-----------Tt-%%%%%---------------------------------------------------------------------------------------------------------------------------------------------------------------------
----------||||||-----------tt-|||||------------------------------%%%%-----%%%%-----------------------------------------------------------------------------%%%%-----%%%%----------------------%%%%%F%%%%
%%%%%%%%%%||||||-------%%%%%%%|||||--------------g---------------||||-----||||-----------------------------------------------%%%%-----%%%%-----------------||||-----||||----------------------|||||%||||
||||||||||||||||XXXXXXX||||||||||||XXXX-----XXXXXXXXXXXXXXXXXXXXX||||-----||||XXXXXXXXXXXXXXXXXXXXX-----XXXXXXXXXXXXXXXXXXXXX||||-----||||XXXXXXXXXXXXXXXXX||||-----||||XXXXXXXXXXXXXXXXXXXXXX||||||||||
