--------------------------------------------------------------------------------------------------------------------------------------------------------------------------------------------------------
--------------------------------------------------------------------------------------------------------------------------------------------------------------------------------------------------------
--------------------------------------------------------------------------------------------------------------------------------------------------------------------------------------------------------
--------------------------------------------------------------------------------------------------------------------------------------------------------------------------------------------------------
--------------------------------------------------------------------------------------------------------------------------------------------------------------------------------------------------------
--------------------------------------------------------------------------------------------------------------------------------------------------------------------------------------------------------
--------------------------------------------------------------------------------------------------------------------------------------------------------------------------------------------------------
--------------------------------------------------------------------------------------------------------------------------------------------------------------------------------------------------------
--------------------------------------------------------------------------------------------------------------------------------------------------------------------------------------------------------
--------------------------------------------------------------------------------------------------------------------------------------------------------------------------------------------------------
------------k-------------------------------------------------------------------------------------------------------------------------------------------------------------------------------------------
------------UUUUUUUU----UUU-----------------------------------------------------------------------------------------------------------------------------------------------------------------------------
--------------------------------------------------------------------------------%%%%--%%%%----------------------------------------%%%%--%%%%------------------------------------------------------------
------------------------------r-----g-------------------------------------------||||--||||---------------%%%%--%%%%---------------||||--||||---------------%%%%--%%%%-----------------------------------
------------------------------%%%%--%%%%---------------k------------------------||||--||||---------------||||--||||---------------||||--||||---------------||||--||||-----------------------------------
XXXXXXXXXXXXXXXXXXXXXXXXXXXXXX||||--||||XXXXXXXXXXXXXXXXXXX--XXXXXXXXXXXXXXXXXXX||||--||||XXXXXXXXXXXXXXX||||--||||XXXXXXXXXXXXXXX||||--||||XXXXXXXXXXXXXXX||||--||||XXXXXXXXXXXXXXXXXXXXXXXXXXXXXXFXXXX
