--------------------------------------------------------------------------------------------------------------------------------------------------------------------------------------------------------
--------------------------------------------------------------------------------------------------------------------------------------------------------------------------------------------------------
--------------------------------------------------------------------------------------------------------------------------------------------------------------------------------------------------------
--------------------------------------------------------------------------------------------------------------------------------------------------------------------------------------------------------
--------------------------------------------------------------------------------------------------------------------------------------------------------------------------------------------------------
--------------------------------------------------------------------------------------------------------------------------------------------------------------------------------------------------------
--------------------------------------------------------------------------------------------------------------------------------------------------------------------------------------------------------
--------------------------------------------------------------------------------------------------------------------------------------------------------------------------------------------------------
--------------------------------------------------------------------------------------------------------------------------------------------------------------------------------------------------------
--------------------------------------------------------------------------------------------------------------------------------------------------------------------------------------------------------
-----------k--------------------------------------------------------------------------------------------------------------------------------------------------------------------------------------------
------------UUUUUUU----UUUUU--g---------k---------------------------------------------------------------------------------------------------------------------------------------------------------------
------------------------------%%%%------%%%%---------------------------------------------------------------------------------------------------------------%%%%------%%%%-------------------------------
------------------------------||||------||||--------------------------------------------------------------------------------------%%%%------%%%%-----------||||------||||-------------------------------
------------------------------||||------||||-------------------------------------------------------------%%%%------%%%%-----------||||------||||-----------||||------||||---------------------%%%%%F%%%%
XXXXXXXXXXXXXXXXXXXXXXXXXXXXXX||||------||||XXXXXXXXXXXXXXX------XXXXXXXXXXXXXXXXXXX------XXXXXXXXXXXXXXX||||------||||XXXXXXXXXXX||||------||||XXXXXXXXXXX||||------||||XXXXXXXXXXXXXXXXXXXXX|||||X||||
