--------------------------------------------------------------------------------------------------------------------------------------------------------------------------------------------------------
--------------------------------------------------------------------------------------------------------------------------------------------------------------------------------------------------------
--------------------------------------------------------------------------------------------------------------------------------------------------------------------------------------------------------
--------------------------------------------------------------------------------------------------------------------------------------------------------------------------------------------------------
--------------------------------------------------------------------------------------------------------------------------------------------------------------------------------------------------------
--------------------------------------------------------------------------------------------------------------------------------------------------------------------------------------------------------
--------------------------------------------------------------------------------------------------------------------------------------------------------------------------------------------------------
--------------------------------------------------------------------------------------------------------------------------------------------------------------------------------------------------------
--------------------------------------------------------------------------------------------------------------------------------------------------------------------------------------------------------
--------------------------------------------------------------------------------------------------------------------------------------------------------------------------------------------------------
--------------------------------------------------------------------------------------------------------------------------------------------------------------------------------------------------------
-------------------------------------------CCUUCCUUUU---------------UUUUUUUUUUS--------g---------------S--------------------------------------S------------------------S--------------------S-----------
------------Tt--------%%%%%%%%--------------------------------------------------%%%%---%%%%----------------------------------------------------------------%%%%---%%%%----------------------------------
------------tt--------||||||||-------------------------g------------------------||||---||||---------------------------------------%%%%---%%%%--------------||||---||||------------------------%%%%%F%%%%
------------tt--------||||||||----------k-gg---G-------%%%%---%%%%--------------||||---||||g--g---------------------------g-------||||---||||---------g----||||---||||------------k-----------|||||%||||
XXXXXXXXXXXXXXXXXXXXXX||||||||XXXX---XXXXXXXXXXXXXXXXXX||||---||||XXXXXXXXXXXXXX||||---||||XXXXXXXXXXXXXXXXXX---XXXXXXXXXXXXXXXXXX||||---||||XXXXXXXXXXXXXX||||---||||XXXXXXXXXXXXXXXXXXXXXXXX||||||||||
