--------------------------------------------------------------------------------------------------------------------------------------------------------------------------------------------------------
--------------------------------------------------------------------------------------------------------------------------------------------------------------------------------------------------------
--------------------------------------------------------------------------------------------------------------------------------------------------------------------------------------------------------
--------------------------------------------------------------------------------------------------------------------------------------------------------------------------------------------------------
--------------------------------------------------------------------------------------------------------------------------------------------------------------------------------------------------------
--------------------------------------------------------------------------------------------------------------------------------------------------------------------------------------------------------
--------------------------------------------------------------------------------------------------------------------------------------------------------------------------------------------------------
--------------------------------------------------------------------------------------------------------------------------------------------------------------------------------------------------------
--------------------------------------------------------------------------------------------------------------------------------------------------------------------------------------------------------
--------------------------------------------------------------------------------------------------------------------------------------------------------------------------------------------------------
--------------gg----------------------------------------------------------------------------------------------------------------------------------------------------------------------------------------
-----------BUCCCUCCCCC-----------------CCUUUUUUB-------------UUUU--------------------------B------------B--------B-------------------------------------------B------------B-----------B-----------------
-----------------------------------------------------------------------%%%%--%%%%------------%%%%--%%%%-------------------------------------------------------------------------------------------------
---------------------------g--------k----------------------------------||||--||||------------||||--||||------------%%%%--%%%%----------------------------------%%%%--%%%%-------------------------------
%%%%%%%%%%------g------k---%%%%--%%%%----------------------------------||||--||||----r-------||||--||||------------||||--||||----------------------------------||||--||||------------r--------%%%%%F%%%%
||||||||||%%%%%%%%%%%%%%%%%||||--||||%%%%%%%%%%%%%%%%--%%%%%%%%%%%%%%%%||||--||||%%%%%%%%%%%%||||--||||%%%%%%%%%%%%||||--||||%%%%%%%%%%%%%%%%--%%%%%%%%%%%%%%%%||||--||||%%%%%%%%%%%%%%%%%%%%%|||||X||||
