--------------------------------------------------------------------------------------------------------------------------------------------------------------------------------------------------------
--------------------------------------------------------------------------------------------------------------------------------------------------------------------------------------------------------
--------------------------------------------------------------------------------------------------------------------------------------------------------------------------------------------------------
--------------------------------------------------------------------------------------------------------------------------------------------------------------------------------------------------------
--------------------------------------------------------------------------------------------------------------------------------------------------------------------------------------------------------
--------------------------------------------------------------------------------------------------------------------------------------------------------------------------------------------------------
--------------------------------------------------------------------------------------------------------------------------------------------------------------------------------------------------------
--------------------------------------------------------------------------------------------------------------------------------------------------------------------------------------------------------
--------------------------------------------------------------------------------------------------------------------------------------------------------------------------------------------------------
--------------------------------------------------------------------------------------------------------------------------------------------------------------------------------------------------------
--------------------------------------------------------------------------------------------------------------------------------------------------------------------------------------------------------
--------------Tt-------------------------------------------CCUCCC----UUUUUU--------------------------------B----------------------------B--B-------B-------------B--------------------------------------
--------------tt-%%%%%%%%%---------------------------------------------------------------------------------------------------------------------------%%%%---%%%%----------------------------------------
--------------tt-|||||||||%%%%%%%--------%%%%---%%%%-------------------------------------------------------------------------------------------------||||---||||----------------------------------------
----------%%%%%%%||||||||||||||||%%%%%%%%||||---||||%%%%%-g------------------r-----------------------------------------------------------------------||||---||||----------------------------------------
%%%%%%%%%%|||||||||||||||||||||||||||||||||||---|||||||||%%%%%%%%%%%%%%%%%%%%%%%%---%%%%%%%%%%%%%%%%%%%%%%%%%%%%%%%%%---%%%%%%%%%%%%%%%%%%%%%%%%%%%%%||||---||||%%%%%%%%%%%%%%%%%%%%%%%%%%%%%%%%%%%F%%%%
