--------------------------------------------------------------------------------------------------------------------------------------------------------------------------------------------------------
--------------------------------------------------------------------------------------------------------------------------------------------------------------------------------------------------------
--------------------------------------------------------------------------------------------------------------------------------------------------------------------------------------------------------
--------------------------------------------------------------------------------------------------------------------------------------------------------------------------------------------------------
--------------------------------------------------------------------------------------------------------------------------------------------------------------------------------------------------------
--------------------------------------------------------------------------------------------------------------------------------------------------------------------------------------------------------
--------------------------------------------------------------------------------------------------------------------------------------------------------------------------------------------------------
--------------------------------------------------------------------------------------------------------------------------------------------------------------------------------------------------------
--------------------------------------------------------------------------------------------------------------------------------------------------------------------------------------------------------
--------------------------------------------------------------------------------------------------------------------------------------------------------------------------------------------------------
---------------------------------------------g----------------------------------------------------------------------------------------------------------------------------------------------------------
---------------------------------------------2UCUUUUU-----------------SUUUUUUU-------------------------S------------------------------------------------------------------------------------------------
--------------Tt-%%%%%-------------------------------------------------------------------------------------------------------------------------------------%%%%------%%%%-------------------------------
%%%%%%%%%%----tt-|||||-----------------------------------------------------------------------------------%%%%------%%%%------------------------------------||||------||||-------------------------------
||||||||||----tt-|||||%%%%%%%%%%%%------%%%%-----------%%%%------%%%%-----------%%%%------%%%%-----------||||------||||-----------%%%%------%%%%-----------||||------||||-------------------------------
||||||||||XXXXXXX|||||||||||||||||------||||XXXXXXXXXXX||||------||||XXXXXXXXXXX||||------||||XXXXXXXXXXX||||------||||XXXXXXXXXXX||||------||||XXXXXXXXXXX||||------||||XXXXXXXXXXXXXXXXXXXXXXXXXXFXXXX
