--------------------------------------------------------------------------------------------------------------------------------------------------------------------------------------------------------
--------------------------------------------------------------------------------------------------------------------------------------------------------------------------------------------------------
--------------------------------------------------------------------------------------------------------------------------------------------------------------------------------------------------------
--------------------------------------------------------------------------------------------------------------------------------------------------------------------------------------------------------
--------------------------------------------------------------------------------------------------------------------------------------------------------------------------------------------------------
--------------------------------------------------------------------------------------------------------------------------------------------------------------------------------------------------------
--------------------------------------------------------------------------------------------------------------------------------------------------------------------------------------------------------
--------------------------------------------------------------------------------------------------------------------------------------------------------------------------------------------------------
--------------------------------------------------------------------------------------------------------------------------------------------------------------------------------------------------------
------------------Tt------------------------------------------------------------------------------------------------------------------------------------------------------------------------------------
------------------tt-------------------------k----------------------------------------------------------------------------------------------------------------------------------------------------------
------------------tt-------------------------2UUUUU--B--------------------------------------------------------------------------------------------------------------------------------------------------
-----------------%%%%%%%-------------------------------g---------g--------------------------------------------------------------------------------------------------------------------------------------
----------%%%%%%%|||||||------%%%%------%%%%-----------%%%%------%%%%-----------%%%%------%%%%-----------%%%%------%%%%---------------------------------------------------------------------------------
%%%%%%%%%%||||||||||||||------||||------||||-----------||||------||||-----------||||------||||-----------||||------||||------------------------------------%%%%------%%%%---------------------%%%%%F%%%%
||||||||||||||||||||||||%%%%%%||||------||||%%%%%%%%%%%||||------||||%%%%%%%%%%%||||------||||%%%%%%%%%%%||||------||||%%%%%%%%%%%%%%%------%%%%%%%%%%%%%%%||||------||||%%%%%%%%%%%%%%%%%%%%%|||||X||||
