--------------------------------------------------------------------------------------------------------------------------------------------------------------------------------------------------------
--------------------------------------------------------------------------------------------------------------------------------------------------------------------------------------------------------
--------------------------------------------------------------------------------------------------------------------------------------------------------------------------------------------------------
--------------------------------------------------------------------------------------------------------------------------------------------------------------------------------------------------------
--------------------------------------------------------------------------------------------------------------------------------------------------------------------------------------------------------
--------------------------------------------------------------------------------------------------------------------------------------------------------------------------------------------------------
--------------------------------------------------------------------------------------------------------------------------------------------------------------------------------------------------------
--------------------------------------------------------------------------------------------------------------------------------------------------------------------------------------------------------
--------------------------------------------------------------------------------------------------------------------------------------------------------------------------------------------------------
--------------------------------------------------------------------------------------------------------------------------------------------------------------------------------------------------------
------------Tt------------------------------------------------------------------------------------------------------------------------------------------------------------------------------------------
------------tt-----UCCUUC2---------------2UUUUUS---------------SUUUUUS---------------SUUU----------------------------------------S----------------------------------------------------------------------
----------%%%%%%%----------r--------r--------------------------------------------------------%%%%-----%%%%----------------------------------------------------------------------------------------------
----------|||||||----------%%%%-----%%%%-----------------------------------------------------||||-----||||---------%%%%-----%%%%---------%%%%-----%%%%---------%%%%-----%%%%----------------------------
%%%%%%%%%%|||||||--rG------||||-----||||-----------------------------------------------------||||-----||||---------||||-----||||---------||||-----||||---------||||-----||||------------------%%%%%F%%%%
|||||||||||||||||XXXXXXXXXX||||-----||||XXXXXXXXXXXXX-----XXXXXXXXXXXXXXXXX-----XXXXXXXXXXXXX||||-----||||XXXXXXXXX||||-----||||XXXXXXXXX||||-----||||XXXXXXXXX||||-----||||XXXXXXXXXXXXXXXXXX|||||X||||
