--------------------------------------------------------------------------------------------------------------------------------------------------------------------------------------------------------
--------------------------------------------------------------------------------------------------------------------------------------------------------------------------------------------------------
--------------------------------------------------------------------------------------------------------------------------------------------------------------------------------------------------------
--------------------------------------------------------------------------------------------------------------------------------------------------------------------------------------------------------
--------------------------------------------------------------------------------------------------------------------------------------------------------------------------------------------------------
--------------------------------------------------------------------------------------------------------------------------------------------------------------------------------------------------------
--------------------------------------------------------------------------------------------------------------------------------------------------------------------------------------------------------
--------------------------------------------------------------------------------------------------------------------------------------------------------------------------------------------------------
--------------------------------------------------------------------------------------------------------------------------------------------------------------------------------------------------------
--------------------------------------------------------------------------------------------------------------------------------------------------------------------------------------------------------
-------------------r-r----------------------------------------------------------------------------------------------------------------------------------------------------------------------------------
-------------------SUUUCUUCC--------------CCUCCCCCUCC2------------SUUUUUUU------------------UU-----S------------------------S-------------------------S--------------------------S----------S-----------
--------------------------------------------------------------------------------------------------------------------------------------------------------------------------------------------------------
------------------------------%%%%--%%%%-----------------------------------------------------------------%%%%--%%%%-------------------------------------------------------------------------------------
%%%%%%%%%%%%%%%%%%------------||||--||||-----------------------------------------------------------------||||--||||---------------%%%%--%%%%--------------------------------------------------%%%%%F%%%%
||||||||||||||||||XXXXXXXXXXXX||||--||||XXXXXXXXXXXXXXXXXXX--XXXXXXXXXXXXXXXXXXXXXXX--XXXXXXXXXXXXXXXXXXX||||--||||XXXXXXXXXXXXXXX||||--||||XXXXXXXXXXXXXXXXXXX--XXXXXXXXXXXXXXXXXXXXXXXXXXXXX|||||X||||
