--------------------------------------------------------------------------------------------------------------------------------------------------------------------------------------------------------
--------------------------------------------------------------------------------------------------------------------------------------------------------------------------------------------------------
--------------------------------------------------------------------------------------------------------------------------------------------------------------------------------------------------------
--------------------------------------------------------------------------------------------------------------------------------------------------------------------------------------------------------
--------------------------------------------------------------------------------------------------------------------------------------------------------------------------------------------------------
--------------------------------------------------------------------------------------------------------------------------------------------------------------------------------------------------------
--------------------------------------------------------------------------------------------------------------------------------------------------------------------------------------------------------
--------------------------------------------------------------------------------------------------------------------------------------------------------------------------------------------------------
--------------------------------------------------------------------------------------------------------------------------------------------------------------------------------------------------------
--------------------------------------------------------------------------------------------------------------------------------------------------------------------------------------------------------
--------------------------------------------------------------------------------------------------------------------------------------------------------------------------------------------------------
--------------------------------------------CUCCUCCCU----------------UUCCCCCCC---------------B---------B---------------------------------------B--------------------------------B--B--------------------
--------------------------------------------------------------------------------------------------------------------------------------------------------------------------------------------------------
----------%%%%%%------%%%%%---%%%%----%%%%--------------------------------------%%%%----%%%%--------------------------------------------------------------------------------------------------%%%%%F%%%%
%%%%%%%%%%||||||%%%%%%|||||--k||||----||||-r-----------g-----------------------r||||----||||-------------------------------------------------------------------------g------------------------|||||X||||
|||||||||||||||||||||||||||%%%||||----||||%%%%%%%%%%%%%%%%%----%%%%%%%%%%%%%%%%%||||----||||%%%%%%%%%%%%%%%%%----%%%%%%%%%%%%%%%%%%%%%----%%%%%%%%%%%%%%%%%%%%%----%%%%%%%%%%%%%%%%%%%%%%%%%%%|||||X||||
