--------------------------------------------------------------------------------------------------------------------------------------------------------------------------------------------------------
--------------------------------------------------------------------------------------------------------------------------------------------------------------------------------------------------------
--------------------------------------------------------------------------------------------------------------------------------------------------------------------------------------------------------
--------------------------------------------------------------------------------------------------------------------------------------------------------------------------------------------------------
--------------------------------------------------------------------------------------------------------------------------------------------------------------------------------------------------------
--------------------------------------------------------------------------------------------------------------------------------------------------------------------------------------------------------
--------------------------------------------------------------------------------------------------------------------------------------------------------------------------------------------------------
--------------------------------------------------------------------------------------------------------------------------------------------------------------------------------------------------------
--------------------------------------------------------------------------------------------------------------------------------------------------------------------------------------------------------
--------------------------------------------------------------------------------------------------------------------------------------------------------------------------------------------------------
-----------------------------------------------------------------------------------------------gr-------------------------------------------------------------------------------------------------------
------------------------------------r----2CCUCCUCUUU----UUUUU--S----------------------------------------S-------------S---------------------S--S------S-------------S-----------------------------------
-------------------Tt-----------%%%%%%%%----------------------------------------------------------------------------------------------------------------------------------------------------------------
%%%%%%%%%%---------tt--%%%%%%%%%||||||||----------------------------------------------------------------------------------------------------------------------------------------------------------------
||||||||||------%%%%%%%|||||||||||||||||--gr---r-------k-ggG----------------------------------------------------------------------------------------------------------------------------------%%%%%F%%%%
||||||||||XXXXXX||||||||||||||||||||||||XXXXXXXXXXXXXXXXXXXXXXXXXXXXXXXXXXXXXXXXXXXXXXXXXXXXXXXXXXXXXXXXXXXXXXXXXXXXXXXXXXXXXXXXXXXXXXXXXXXXXXXXXXXXXXXXXXXXXXXXXXXXXXXXXXXXXXXXXXXXXXXXXXXXXX|||||X||||
