--------------------------------------------------------------------------------------------------------------------------------------------------------------------------------------------------------
--------------------------------------------------------------------------------------------------------------------------------------------------------------------------------------------------------
--------------------------------------------------------------------------------------------------------------------------------------------------------------------------------------------------------
--------------------------------------------------------------------------------------------------------------------------------------------------------------------------------------------------------
--------------------------------------------------------------------------------------------------------------------------------------------------------------------------------------------------------
--------------------------------------------------------------------------------------------------------------------------------------------------------------------------------------------------------
--------------------------------------------------------------------------------------------------------------------------------------------------------------------------------------------------------
--------------------------------------------------------------------------------------------------------------------------------------------------------------------------------------------------------
--------------------------------------------------------------------------------------------------------------------------------------------------------------------------------------------------------
----------------------------------Tt--------------------------------------------------------------------------------------------------------------------------------------------------------------------
----------------------------------tt-------g------------------------------------------------------------------------------------------------------------------------------------------------------------
----------------------------------tt--------UCCCCCCUS--SUUUUUUS---UUU-----S----------S--S---------------------------------------------------------------------------------------------------------------
---------------%%%%%--Tt-------%%%%%%----------------------------------------------------------k--------------------------------------------------------------------------------------------------------
---------------|||||--tt-------||||||----------------------------------------------------------%%%%---%%%%----------------------------------------------------------------------------------------------
---------------|||||%%%%%%%----||||||%%%%%-----------------------------------------------------||||---||||------------------------------------------------------------------------------------%%%%%F%%%%
XXXXXXXXXXXXXXX||||||||||||XXXX|||||||||||XXXXXXXXXXXXXXXXXXXXXXXXXXXXXXXXXXXXXXXXXXXXXXXXXXXXX||||---||||XXXXXXXXXXXXXXXXXXXXXXXXXXXXXXXXXXXXXXXXXXXXXXXXXXXXXXXXXXXXXXXXXXXXXXXXXXXXXXXXXXXX|||||X||||
