--------------------------------------------------------------------------------------------------------------------------------------------------------------------------------------------------------
--------------------------------------------------------------------------------------------------------------------------------------------------------------------------------------------------------
--------------------------------------------------------------------------------------------------------------------------------------------------------------------------------------------------------
--------------------------------------------------------------------------------------------------------------------------------------------------------------------------------------------------------
--------------------------------------------------------------------------------------------------------------------------------------------------------------------------------------------------------
--------------------------------------------------------------------------------------------------------------------------------------------------------------------------------------------------------
--------------------------------------------------------------------------------------------------------------------------------------------------------------------------------------------------------
--------------------------------------------------------------------------------------------------------------------------------------------------------------------------------------------------------
--------------------------------------------------------------------------------------------------------------------------------------------------------------------------------------------------------
--------------------------------------------------------------------------------------------------------------------------------------------------------------------------------------------------------
------------------------r-G-----------------------------------------------------------------------------------------------------------------------------------------------------------------------------
-------------------------CCUUCUCUUU---BUU------------------B---------------------------B----------B-----------------------------------------------------------------------------------------------------
-----------------------------------------------------------------r--------------------------------------------------------------------------------------------------------------------------------------
-----------------------------------------------------------------%%%%---%%%%----------------------------------------------------------------------------------------------------------------------------
----------%%%%%%%%-----------------------------------------------||||---||||------------------------------------------------------------------------------------------------------------------%%%%%F%%%%
%%%%%%%%%%||||||||%%%%%%%%%%%%%%%%%%%%%%%%%%%%%%%%%%%%%%%%%%%%%%%||||---||||%%%%%%%%%%%%%%%%%%%%%%%%%%%%%%%%%%%%%%%%%%%%%%%%%%%%%---%%%%%%%%%%%%%%%%%%%%%%%%%%%%%%%%%%%%%%%%%%%%%%%%%%%%%%%%%%|||||X||||
