--------------------------------------------------------------------------------------------------------------------------------------------------------------------------------------------------------
--------------------------------------------------------------------------------------------------------------------------------------------------------------------------------------------------------
--------------------------------------------------------------------------------------------------------------------------------------------------------------------------------------------------------
--------------------------------------------------------------------------------------------------------------------------------------------------------------------------------------------------------
--------------------------------------------------------------------------------------------------------------------------------------------------------------------------------------------------------
--------------------------------------------------------------------------------------------------------------------------------------------------------------------------------------------------------
--------------------------------------------------------------------------------------------------------------------------------------------------------------------------------------------------------
--------------------------------------------------------------------------------------------------------------------------------------------------------------------------------------------------------
--------------------------------------------------------------------------------------------------------------------------------------------------------------------------------------------------------
--------------------------------------------------------------------------------------------------------------------------------------------------------------------------------------------------------
------------------------Tt------------------------------------------------------------------------------------------------------------------------------------------------------------------------------
------------------------tt------CCCCCCCCCB--BCUUUUUUU----U-----B--------------------B-----------B--B---------------------B--------------B-----------------B------------B----------B---------------------
-----------------------%%%%%%%-----------------------------------g-----g--------------------------------------------------------------------------------------------------------------------------------
%%%%%%%%%%%%%%%%%%-----|||||||-----------------------------------%%%%--%%%%-----------------------------------------------------------------------------------------------------------------------------
||||||||||||||||||%%%%%|||||||--r--------------------------------||||--||||--------------------------------------------------k-----r--------------------------------------------------------------------
||||||||||||||||||||||||||||||%%%%%%%%%%%%%%%%%%%%%%%%%%%%%%%%%%%||||--||||%%%%%%%%%%%%%%%%%%%%%%%%%%%%%%%%%%%%%%%%%%%%%%%%%%%%%%--%%%%%%%%%%%%%%%%%%%%%%%%%%%%%%%%%%%%%%%%%%%%%%%%%%%%%%%%%%%%%%%%F%%%%
