--------------------------------------------------------------------------------------------------------------------------------------------------------------------------------------------------------
--------------------------------------------------------------------------------------------------------------------------------------------------------------------------------------------------------
--------------------------------------------------------------------------------------------------------------------------------------------------------------------------------------------------------
--------------------------------------------------------------------------------------------------------------------------------------------------------------------------------------------------------
--------------------------------------------------------------------------------------------------------------------------------------------------------------------------------------------------------
--------------------------------------------------------------------------------------------------------------------------------------------------------------------------------------------------------
--------------------------------------------------------------------------------------------------------------------------------------------------------------------------------------------------------
--------------------------------------------------------------------------------------------------------------------------------------------------------------------------------------------------------
--------------------------------------------------------------------------------------------------------------------------------------------------------------------------------------------------------
-------------Tt-----------------------------------------------------------------------------------------------------------------------------------------------------------------------------------------
-------------tt-----------------------------------------------------------------------------------------------------------------------------------------------------------------------------------------
-------------tt------------Tt----------CCCCCU2---CCUCUUUUU----UUUU-----B-----------B------B----------------------------------------B--B---------B-----------------------B-------------------B-----------
----------%%%%%%%----------tt---------------------------------------------------------------------------------------------------------------------------------------------------------------------------
----------|||||||%%%%%%%%%%%%%-----------------------------------------------------------------r--------------------------------------------------------------------------------------------------------
----------||||||||||||||||||||---------r-----------------------------g-------------------------%%%%-----%%%%--------------------------------------------------------------------------------------------
%%%%%%%%%%||||||||||||||||||||%%%%%%%%%%%%%%%%%%%%%%%%%%%%%%%%%%%%%%%%%%%%%%%%%%%%%%%%%%%%%%%%%||||-----||||%%%%%%%%%%%%%%%%%%%%%%%%%%%%%%%%%%%%%%%%%%%%%%%%%%%%%%%%%%%%%%%%%%%%%%%%%%%%%%%%%%%%%%%F%%%%
