--------------------------------------------------------------------------------------------------------------------------------------------------------------------------------------------------------
--------------------------------------------------------------------------------------------------------------------------------------------------------------------------------------------------------
--------------------------------------------------------------------------------------------------------------------------------------------------------------------------------------------------------
--------------------------------------------------------------------------------------------------------------------------------------------------------------------------------------------------------
--------------------------------------------------------------------------------------------------------------------------------------------------------------------------------------------------------
--------------------------------------------------------------------------------------------------------------------------------------------------------------------------------------------------------
--------------------------------------------------------------------------------------------------------------------------------------------------------------------------------------------------------
--------------------------------------------------------------------------------------------------------------------------------------------------------------------------------------------------------
--------------------------------------------------------------------------------------------------------------------------------------------------------------------------------------------------------
--------------------------------------------------------------------------------------------------------------------------------------------------------------------------------------------------------
--------------------------------------------------------------------------------------------------------------------------------------------------------------------------------------------------------
------------------------------------------------------------------------------------------------UU-----B------------------------------------------------------------------------------------------------
------------------------------%%%%------%%%%%%%%%%%%%%%--------------%%%%%%%-----------------------------r----------------------------------------------------------------------------------------------
%%%%%%%%%%---------%%%%%------||||------|||||||||||||||--------------|||||||----%%%%------%%%%-----------%%%%------%%%%------------------------------------%%%%------%%%%-------------------------------
||||||||||%%%------|||||%%%%%%||||------|||||||||||||||%%%%------%%%%|||||||----||||------||||-rG--------||||------||||-----------%%%%------%%%%-----------||||------||||---------------------%%%%%F%%%%
|||||||||||||%%%%%%|||||||||||||||------|||||||||||||||||||------|||||||||||%%%%||||------||||%%%%%%%%%%%||||------||||%%%%%%%%%%%||||------||||%%%%%%%%%%%||||------||||%%%%%%%%%%%%%%%%%%%%%|||||X||||
