--------------------------------------------------------------------------------------------------------------------------------------------------------------------------------------------------------
--------------------------------------------------------------------------------------------------------------------------------------------------------------------------------------------------------
--------------------------------------------------------------------------------------------------------------------------------------------------------------------------------------------------------
--------------------------------------------------------------------------------------------------------------------------------------------------------------------------------------------------------
--------------------------------------------------------------------------------------------------------------------------------------------------------------------------------------------------------
--------------------------------------------------------------------------------------------------------------------------------------------------------------------------------------------------------
--------------------------------------------------------------------------------------------------------------------------------------------------------------------------------------------------------
--------------------------------------------------------------------------------------------------------------------------------------------------------------------------------------------------------
--------------------------------------------------------------------------------------------------------------------------------------------------------------------------------------------------------
--------------------------------------------------------------------------------------------------------------------------------------------------------------------------------------------------------
--------------------------------------------------------------------------------------------------------------------------------------------------------------------------------------------------------
-------------------------------------------SCCCCCUUUUS-g-------r-----UUU----S---k----------------------S--------------S---------S-----------------------------------------------S--S--------------------
----------%%%%%%%-----%%%%%%%%-------------------------%%%%----%%%%-------------%%%%----%%%%------------------------------------------------------------------------------------------------------------
%%%%%%%%%%|||||||-----||||||||%%%%----%%%%-------------||||----||||-------------||||----||||--------------------------------------%%%%----%%%%-------------%%%%----%%%%-----------------------%%%%%F%%%%
|||||||||||||||||-----||||||||||||----||||-rG----------||||----||||-------------||||----||||-------------%%%%----%%%%-------------||||----||||-------------||||----||||-----------------------|||||%||||
|||||||||||||||||XXXXX||||||||||||----||||XXXXXXXXXXXXX||||----||||XXXXXXXXXXXXX||||----||||XXXXXXXXXXXXX||||----||||XXXXXXXXXXXXX||||----||||XXXXXXXXXXXXX||||----||||XXXXXXXXXXXXXXXXXXXXXXX||||||||||
