--------------------------------------------------------------------------------------------------------------------------------------------------------------------------------------------------------
--------------------------------------------------------------------------------------------------------------------------------------------------------------------------------------------------------
--------------------------------------------------------------------------------------------------------------------------------------------------------------------------------------------------------
--------------------------------------------------------------------------------------------------------------------------------------------------------------------------------------------------------
--------------------------------------------------------------------------------------------------------------------------------------------------------------------------------------------------------
--------------------------------------------------------------------------------------------------------------------------------------------------------------------------------------------------------
--------------------------------------------------------------------------------------------------------------------------------------------------------------------------------------------------------
--------------------------------------------------------------------------------------------------------------------------------------------------------------------------------------------------------
--------------------------------------------------------------------------------------------------------------------------------------------------------------------------------------------------------
--------------------------------------------------------------------------------------------------------------------------------------------------------------------------------------------------------
-----------rg-G-----------------------------------------------------------------------------------------------------------------------------------------------------------------------------------------
-----------2CCCCCCS---UUCCUC---2UUUUUUS---------S-g--------------S-------S-----------S--S---------------------------------S------------------------------------------S----------------------------------
--------------------------------------------------%%%%------%%%%----------------------------------------------------------------------------------------------------------------------------------------
--------------------------------------------------||||------||||-------------------------------%%%%------%%%%---------------------------------------------------------------------------------%%%%%F%%%%
%%%%%%%%%%----------------------------------------||||------||||-----------------------------r-||||------||||g-------------------g--------------------------------------------------------r--k|||||%||||
||||||||||XXXXXXXXXXXXXXXXXXXXXXXXXXXXXXXXXXXXXXXX||||------||||XXXXXXXXXXXXXXXXXXXXXXXXXXXXXXX||||------||||XXXXXXXXXXXXXXXXXXXXXXXXXXXXXXXXXXX------XXXXXXXXXXXXXXXXXXXXXXXXXXXXXXXXXXXXXXXX||||||||||
