--------------------------------------------------------------------------------------------------------------------------------------------------------------------------------------------------------
--------------------------------------------------------------------------------------------------------------------------------------------------------------------------------------------------------
--------------------------------------------------------------------------------------------------------------------------------------------------------------------------------------------------------
--------------------------------------------------------------------------------------------------------------------------------------------------------------------------------------------------------
--------------------------------------------------------------------------------------------------------------------------------------------------------------------------------------------------------
--------------------------------------------------------------------------------------------------------------------------------------------------------------------------------------------------------
--------------------------------------------------------------------------------------------------------------------------------------------------------------------------------------------------------
--------------------------------------------------------------------------------------------------------------------------------------------------------------------------------------------------------
--------------------------------------------------------------------------------------------------------------------------------------------------------------------------------------------------------
--------------------------------------------------------------------------------------------------------------------------------------------------------------------------------------------------------
--------------------------------------------------------------------------------------------------------------------------------------------------------------------------------------------------------
-----------------------------------CCCCCU----UCCUCUCCU----UUUUUU-S--------------------S--S---S---------------S--------S--S---------S---------S-------------------S--------------------------------------
-----------------------------------------------------------------------------------------------%%%%-----%%%%--------------------------------------------------------------------------------------------
-----------Tt----%%%%%%%%%---------------------------------------------------------------------||||-----||||----------------------------------------------------------------------------------%%%%%F%%%%
%%%%%%%%%%-tt----|||||||||%%%%%%%---g----------------------------------------------------------||||-----||||----------------------------------------------------------------------------------|||||%||||
||||||||||XXXXXXX||||||||||||||||XXXXXXXXXXXXXXXXXXXXXXXXXXXXXXXXXXXXXXXXXXXXXXXXXXXXXXXXXXXXXX||||-----||||XXXXXXXXXXXXXXXXXXXXXXXXXXXXXXXXXXXXXXXXXXXXXXXXXXXXXXXXXXXXXXXXXXXXXXXXXXXXXXXXXX||||||||||
