--------------------------------------------------------------------------------------------------------------------------------------------------------------------------------------------------------
--------------------------------------------------------------------------------------------------------------------------------------------------------------------------------------------------------
--------------------------------------------------------------------------------------------------------------------------------------------------------------------------------------------------------
--------------------------------------------------------------------------------------------------------------------------------------------------------------------------------------------------------
--------------------------------------------------------------------------------------------------------------------------------------------------------------------------------------------------------
--------------------------------------------------------------------------------------------------------------------------------------------------------------------------------------------------------
--------------------------------------------------------------------------------------------------------------------------------------------------------------------------------------------------------
--------------------------------------------------------------------------------------------------------------------------------------------------------------------------------------------------------
--------------------------------------------------------------------------------------------------------------------------------------------------------------------------------------------------------
--------------------------------------------------------------------------------------------------------------------------------------------------------------------------------------------------------
--------------------g-----------------------------------------------------------------------------------------------------------------------------------------------------------------------------------
-------------------2CUCCUCCCC----CUCCUUUC2---C--------------------------------S------------------------------------------S--------S--S--------------------S--S----------S-------------------S-----------
--------------------------------------------------------------------------------------------------------------------------------------------------------------------------------------------------------
----------%%%%%%%%----------------------------------------------------------------------------------------------------------------------------------------------------------------------------%%%%%F%%%%
%%%%%%%%%%||||||||-----------------------------------------------------------------------------k----------------------------------------------------------------------------------------------|||||%||||
||||||||||||||||||XXXXXXXXXXXXXXXXXXXXXXXXXXXXXXXXXXXXXXXXXXXXXXXXXXXXXXXXXXXXXXXXXXXXXXXXXXXXXXXXX-----XXXXXXXXXXXXXXXXXXXXXXXXXXXXXXXXXXXXXXXXXXXXXXXXXXXXXXXXXXXXXXXXXXXXXXXXXXXXXXXXXXXXXX||||||||||
