--------------------------------------------------------------------------------------------------------------------------------------------------------------------------------------------------------
--------------------------------------------------------------------------------------------------------------------------------------------------------------------------------------------------------
--------------------------------------------------------------------------------------------------------------------------------------------------------------------------------------------------------
--------------------------------------------------------------------------------------------------------------------------------------------------------------------------------------------------------
--------------------------------------------------------------------------------------------------------------------------------------------------------------------------------------------------------
--------------------------------------------------------------------------------------------------------------------------------------------------------------------------------------------------------
--------------------------------------------------------------------------------------------------------------------------------------------------------------------------------------------------------
--------------------------------------------------------------------------------------------------------------------------------------------------------------------------------------------------------
--------------------------------------------------------------------------------------------------------------------------------------------------------------------------------------------------------
--------------------------------------------------------------------------------------------------------------------------------------------------------------------------------------------------------
----------------------------------------k---------------------------------------------------------------------------------------------------------------------------------------------------------------
----------------------------CCCCUCUCC---BUUUUUUUB-------------UUUUUUUU----U---------------------------------------------B-----------------B-------------------B-----------------------------------------
----------%%%%%%%---------------------------------------------------------------------------------------------------------------------------------------------------------------------------------------
----------|||||||---------------------------------%%%%--%%%%--------------------------------------------------------------------------------------------------------------------------------------------
%%%%%%%%%%|||||||%%%%%%%%%--g-g--g-G--------------||||--||||-----------------------------------%%%%--%%%%-------------------------------------------------------------------------------------%%%%%F%%%%
||||||||||||||||||||||||||%%%%%%%%%%%%%%%%%%%%%%%%||||--||||%%%%%%%%%%%%%%%%%%%%%%%%%%%%%%%%%%%||||--||||%%%%%%%%%%%%%%%%%%%%%%%%%%%%%%%%%%%%%%%--%%%%%%%%%%%%%%%%%%%%%%%%%%%%%%%%%%%%%%%%%%%%|||||X||||
