--------------------------------------------------------------------------------------------------------------------------------------------------------------------------------------------------------
--------------------------------------------------------------------------------------------------------------------------------------------------------------------------------------------------------
--------------------------------------------------------------------------------------------------------------------------------------------------------------------------------------------------------
--------------------------------------------------------------------------------------------------------------------------------------------------------------------------------------------------------
--------------------------------------------------------------------------------------------------------------------------------------------------------------------------------------------------------
--------------------------------------------------------------------------------------------------------------------------------------------------------------------------------------------------------
--------------------------------------------------------------------------------------------------------------------------------------------------------------------------------------------------------
--------------------------------------------------------------------------------------------------------------------------------------------------------------------------------------------------------
--------------------------------------------------------------------------------------------------------------------------------------------------------------------------------------------------------
--------------------------------------------------------------------------------------------------------------------------------------------------------------------------------------------------------
--------------------------------------------------------------------------------------------------------------------------------------------------------------------------------------------------------
------------------------------------------------UU-----------------------------------------B---------------r--------------------------------------------------------------------------------------------
------------------------------%%%%--%%%%---------------g-------------------------------------------------%%%%--%%%%-------------------------------------------------------------------------------------
%%%%%%%%%%--------------------||||--||||---------------%%%%--%%%%----------------------------------------||||--||||---------------%%%%--%%%%---------------%%%%--%%%%-----------------------------------
||||||||||%%%%%%%%--------g---||||--||||%%%%%%k--gr--G-||||--||||---------------%%%%--%%%%------g--------||||--||||---------------||||--||||-----------g---||||--||||-----------------------------------
||||||||||||||||||%%%%%%%%%%%%||||--||||||||||%%%%%%%%%||||--||||%%%%%%%%%%%%%%%||||--||||%%%%%%%%%%%%%%%||||--||||%%%%%%%%%%%%%%%||||--||||%%%%%%%%%%%%%%%||||--||||%%%%%%%%%%%%%%%%%%%%%%%%%%%%%%F%%%%
