--------------------------------------------------------------------------------------------------------------------------------------------------------------------------------------------------------
--------------------------------------------------------------------------------------------------------------------------------------------------------------------------------------------------------
--------------------------------------------------------------------------------------------------------------------------------------------------------------------------------------------------------
--------------------------------------------------------------------------------------------------------------------------------------------------------------------------------------------------------
--------------------------------------------------------------------------------------------------------------------------------------------------------------------------------------------------------
--------------------------------------------------------------------------------------------------------------------------------------------------------------------------------------------------------
--------------------------------------------------------------------------------------------------------------------------------------------------------------------------------------------------------
--------------------------------------------------------------------------------------------------------------------------------------------------------------------------------------------------------
--------------------------------------------------------------------------------------------------------------------------------------------------------------------------------------------------------
--------------------------------------------------------------------------------------------------------------------------------------------------------------------------------------------------------
-----------Tt----------gG-------------------------------------------------------------------------------------------------------------------------------------------------------------------------------
-----------tt----------2CCCCCCCC----CCC--g------g-----CCUU-----B-------B-----g------r-------------B------------B----------------------B---------B----------------B---------B--B-------------B-----------
-----------tt-%%%%%%%%-------------------%%%%---%%%%-------------------------%%%%---%%%%----------------------------------------------------------------------------------------------------------------
%%%%%%%%%%%%%%||||||||-------------------||||---||||-------------------------||||---||||-------------------------%%%%---%%%%----------------------------------------------------------------------------
||||||||||||||||||||||-------------------||||---||||-------------------------||||---||||-------------------------||||---||||----------------------------------------------------------------------------
||||||||||||||||||||||%%%%%%%%%%%%%%%%%%%||||---||||%%%%%%%%%%%%%%%%%%%%%%%%%||||---||||%%%%%%%%%%%%%%%%%%%%%%%%%||||---||||%%%%%%%%%%%%%%%%%%%%%%%%%%%%%---%%%%%%%%%%%%%%%%%%%%%%%%%%%%%%%%%%%%%%%F%%%%
