--------------------------------------------------------------------------------------------------------------------------------------------------------------------------------------------------------
--------------------------------------------------------------------------------------------------------------------------------------------------------------------------------------------------------
--------------------------------------------------------------------------------------------------------------------------------------------------------------------------------------------------------
--------------------------------------------------------------------------------------------------------------------------------------------------------------------------------------------------------
--------------------------------------------------------------------------------------------------------------------------------------------------------------------------------------------------------
--------------------------------------------------------------------------------------------------------------------------------------------------------------------------------------------------------
--------------------------------------------------------------------------------------------------------------------------------------------------------------------------------------------------------
--------------------------------------------------------------------------------------------------------------------------------------------------------------------------------------------------------
--------------------------------------------------------------------------------------------------------------------------------------------------------------------------------------------------------
--------------------------------------------------------------------------------------------------------------------------------------------------------------------------------------------------------
--------------------------------------------------------------------------------------------------------------------------------------------------------------------------------------------------------
----------------------------BCUCCUCCC----CCCCUCC----UU----B-------------------------------B-----------------------------------------------------------B-------B-----------B----------B------------------
----------%%%%%%%%%%------------------------------------------------------------------------------------------------------------------------------------------------------------------------------------
%%%%%%%%%%||||||||||---------------------------------------------%%%%---%%%%----------------------------------------------------------------------------------------------------------------------------
||||||||||||||||||||%%%%%%%-rgr----------------------------------||||---||||------------------------------------------------------------------------------------------------------------------%%%%%F%%%%
|||||||||||||||||||||||||||%%%%%%%%%%%%%%%%%%%%%%%%%%%%%%%%%%%%%%||||---||||%%%%%%%%%%%%%%%%%%%%%%%%%%%%%%%%%%%%%%%%%%%%%%%%%%%%%---%%%%%%%%%%%%%%%%%%%%%%%%%%%%%%%%%%%%%%%%%%%%%%%%%%%%%%%%%%|||||X||||
