--------------------------------------------------------------------------------------------------------------------------------------------------------------------------------------------------------
--------------------------------------------------------------------------------------------------------------------------------------------------------------------------------------------------------
--------------------------------------------------------------------------------------------------------------------------------------------------------------------------------------------------------
--------------------------------------------------------------------------------------------------------------------------------------------------------------------------------------------------------
--------------------------------------------------------------------------------------------------------------------------------------------------------------------------------------------------------
--------------------------------------------------------------------------------------------------------------------------------------------------------------------------------------------------------
--------------------------------------------------------------------------------------------------------------------------------------------------------------------------------------------------------
--------------------------------------------------------------------------------------------------------------------------------------------------------------------------------------------------------
--------------------------------------------------------------------------------------------------------------------------------------------------------------------------------------------------------
--------------------------------------------------------------------------------------------------------------------------------------------------------------------------------------------------------
---------------------------rg--g------------------------------------------------------------------------------------------------------------------------------------------------------------------------
---------------------------CCCCUCUB--------------------BCCCC---------B-----B--------------------------B--B---------------------B------B----------------------------B---------B--B------B----------------
----------------%%%%%%%%%----------------r--------------------------------------------------------------------------------------------------------------------------------------------------------------
----------%%%%%%|||||||||----------------%%%%-----%%%%-----------------------------------------------------------------------------------------------%%%%-----%%%%--------------------------------------
%%%%%%%%%%|||||||||||||||----------------||||-----||||-----------------------%%%%-----%%%%-----------------------------------------------------------||||-----||||----------------------------%%%%%F%%%%
|||||||||||||||||||||||||%%%%%%%%%%%%%%%%||||-----||||%%%%%%%%%%%%%%%%%%%%%%%||||-----||||%%%%%%%%%%%%%%%%%%%%%%%%%%%-----%%%%%%%%%%%%%%%%%%%%%%%%%%%||||-----||||%%%%%%%%%%%%%%%%%%%%%%%%%%%%|||||X||||
