--------------------------------------------------------------------------------------------------------------------------------------------------------------------------------------------------------
--------------------------------------------------------------------------------------------------------------------------------------------------------------------------------------------------------
--------------------------------------------------------------------------------------------------------------------------------------------------------------------------------------------------------
--------------------------------------------------------------------------------------------------------------------------------------------------------------------------------------------------------
--------------------------------------------------------------------------------------------------------------------------------------------------------------------------------------------------------
--------------------------------------------------------------------------------------------------------------------------------------------------------------------------------------------------------
--------------------------------------------------------------------------------------------------------------------------------------------------------------------------------------------------------
--------------------------------------------------------------------------------------------------------------------------------------------------------------------------------------------------------
--------------------------------------------------------------------------------------------------------------------------------------------------------------------------------------------------------
--------------------------------------------------------------------------------------------------------------------------------------------------------------------------------------------------------
-------------------------rgG----------------------------------------------------------------------------------------------------------------------------------------------------------------------------
--------------Tt----------UCCCCCC----CCUUCUCUCCC2-----------------UUUUUUUUUUB---UUUU-----B--------------------B----------------------B---------------------B----------B--B----------B-------------------
--------------tt-------------------------------------------------------------------------------%%%%------%%%%-------------------------------%%%%------%%%%----------------------------------------------
%%%%%%%%%%----tt----------------------------------g--------------------------------------------||||------||||-------------------------------||||------||||------------------------------------%%%%%F%%%%
||||||||||%%%%%%%%%%%%%%------r-------------------%%%%------%%%%-g---------------------------r-||||------||||-------------------------------||||------||||---------------k---------k----------|||||X||||
||||||||||||||||||||||||%%%%%%%%%%%%%%%%%%%%%%%%%%||||------||||%%%%%%%%%%%%%%%%%%%%%%%%%%%%%%%||||------||||%%%%%%%%%%%%%%%%%%%%%%%%%%%%%%%||||------||||%%%%%%%%%%%%%%%%%%%%%%%%%%%%%%%%%%%%|||||X||||
