--------------------------------------------------------------------------------------------------------------------------------------------------------------------------------------------------------
--------------------------------------------------------------------------------------------------------------------------------------------------------------------------------------------------------
--------------------------------------------------------------------------------------------------------------------------------------------------------------------------------------------------------
--------------------------------------------------------------------------------------------------------------------------------------------------------------------------------------------------------
--------------------------------------------------------------------------------------------------------------------------------------------------------------------------------------------------------
--------------------------------------------------------------------------------------------------------------------------------------------------------------------------------------------------------
--------------------------------------------------------------------------------------------------------------------------------------------------------------------------------------------------------
--------------------------------------------------------------------------------------------------------------------------------------------------------------------------------------------------------
--------------------------------------------------------------------------------------------------------------------------------------------------------------------------------------------------------
--------------------------------------------------------------------------------------------------------------------------------------------------------------------------------------------------------
-------------------r---k--------------------------------------------------------------------------------------------------------------------------------------------------------------------------------
--------------------CCU------S--------S-------------------------S---------------------------------------------------------------------------------------------------------------------------------------
-----------------------------------------------------------------------------------------------r-------g------------------------------------------------------------------------------------------------
-----------------------------------------------------------------------------------------------%%%%----%%%%-----------------------------------------------------------------------------------%%%%%F%%%%
%%%%%%%%%%%%%%%%%%-------------------------g-----r--------------------------g------------------||||----||||------------g---------k------------------------------------------------------------|||||%||||
||||||||||||||||||XXXXXXXXXXXXXXXXXXXXXXXXXXXXXXXXXXXXXXXXXXXXXXXXXXXXXXXXXXXXXXXXXXXXXXXXXXXXX||||----||||XXXXXXXXXXXXXXXXXXXXXXXXXXXXXXXXXXXXXXXXXXXXXXXXXXXXXXXXXXXXXXXXXXXXXXXXXXXXXXXXXXX||||||||||
