--------------------------------------------------------------------------------------------------------------------------------------------------------------------------------------------------------
--------------------------------------------------------------------------------------------------------------------------------------------------------------------------------------------------------
--------------------------------------------------------------------------------------------------------------------------------------------------------------------------------------------------------
--------------------------------------------------------------------------------------------------------------------------------------------------------------------------------------------------------
--------------------------------------------------------------------------------------------------------------------------------------------------------------------------------------------------------
--------------------------------------------------------------------------------------------------------------------------------------------------------------------------------------------------------
--------------------------------------------------------------------------------------------------------------------------------------------------------------------------------------------------------
--------------------------------------------------------------------------------------------------------------------------------------------------------------------------------------------------------
--------------------------------------------------------------------------------------------------------------------------------------------------------------------------------------------------------
--------------------------------------------------------------------------------------------------------------------------------------------------------------------------------------------------------
-------------------------------------------gkrG-----------------g--r------------------------------------------------------------------------------------------------------------------------------------
-------------------------------------------CCCC-----------------SCCCUS----------------SUUUUS-----------------UUUUS-----------------UU--S---------------------S----------------S-------S-----------------
-----------------------------------------------------------------------%%%%------%%%%--------%%%%------%%%%--------%%%%------%%%%--------%%%%------%%%%--------%%%%------%%%%---------------------------
-------------%%%%%%%---------------------------------------------------||||------||||--------||||------||||--------||||------||||--------||||------||||--------||||------||||-----------------%%%%%F%%%%
-------------|||||||-----------------------------g---------------------||||------||||--------||||------||||--------||||------||||--------||||------||||--------||||------||||-----------------|||||%||||
XXXXXXXXXXXXX|||||||XXXXXXXXXXX------XXXXXXXXXXXXXXXX------XXXXXXXXXXXX||||------||||XXXXXXXX||||------||||XXXXXXXX||||------||||XXXXXXXX||||------||||XXXXXXXX||||------||||XXXXXXXXXXXXXXXXX||||||||||
