--------------------------------------------------------------------------------------------------------------------------------------------------------------------------------------------------------
--------------------------------------------------------------------------------------------------------------------------------------------------------------------------------------------------------
--------------------------------------------------------------------------------------------------------------------------------------------------------------------------------------------------------
--------------------------------------------------------------------------------------------------------------------------------------------------------------------------------------------------------
--------------------------------------------------------------------------------------------------------------------------------------------------------------------------------------------------------
--------------------------------------------------------------------------------------------------------------------------------------------------------------------------------------------------------
--------------------------------------------------------------------------------------------------------------------------------------------------------------------------------------------------------
--------------------------------------------------------------------------------------------------------------------------------------------------------------------------------------------------------
--------------------------------------------------------------------------------------------------------------------------------------------------------------------------------------------------------
--------------------------------------------------------------------------------------------------------------------------------------------------------------------------------------------------------
----------------------g---------------------------------------------------------------------------------------------------------------------------------------------------------------------------------
----------------------2CC-----S--S------S---------r-----------------------------------------------------------------------------------------------------------------------------------------------------
----------%%%-------------------------------------%%%%--%%%%-----------------------------------%%%%--%%%%-----------------------------------------------------------------------------------------------
----------|||-------------------------------------||||--||||-----------------------------------||||--||||-----------------------------------%%%%--%%%%--------------------------------------------------
----------|||%%%%%%%%-----------------------------||||--||||-----------------------------------||||--||||-----------------------------------||||--||||----------------------------------------%%%%%F%%%%
XXXXXXXXXX|||||||||||XXXXXXXXXXXXXXXXXXXXXXXXXXXXX||||--||||XXXXXXXXXXXXXXXXXXXXXXXXXXXXXXXXXXX||||--||||XXXXXXXXXXXXXXXXXXXXXXXXXXXXXXXXXXX||||--||||XXXXXXXXXXXXXXXXXXXXXXXXXXXXXXXXXXXXXXXX|||||X||||
