--------------------------------------------------------------------------------------------------------------------------------------------------------------------------------------------------------
--------------------------------------------------------------------------------------------------------------------------------------------------------------------------------------------------------
--------------------------------------------------------------------------------------------------------------------------------------------------------------------------------------------------------
--------------------------------------------------------------------------------------------------------------------------------------------------------------------------------------------------------
--------------------------------------------------------------------------------------------------------------------------------------------------------------------------------------------------------
--------------------------------------------------------------------------------------------------------------------------------------------------------------------------------------------------------
--------------------------------------------------------------------------------------------------------------------------------------------------------------------------------------------------------
--------------------------------------------------------------------------------------------------------------------------------------------------------------------------------------------------------
--------------------------------------------------------------------------------------------------------------------------------------------------------------------------------------------------------
--------------------------------------------------------------------------------------------------------------------------------------------------------------------------------------------------------
--------------------------------------------------------------------------------------------------------------------------------------------------------------------------------------------------------
-----------------------------------------------2CCCCCUCCUU--------------------UUUUUU-----B---B-------------B-------B-------------------------------------------------------------B----------------------
----------%%%%%%%------------------------------------------------g------k----------------------------------------------------%%%%---%%%%----------------------------------------------------------------
%%%%%%%%%%|||||||%%%%%-------------%%%%---%%%%-------------------%%%%---%%%%-------------------g------g----------------------||||---||||------------------------------------------------------%%%%%F%%%%
||||||||||||||||||||||-------------||||---||||----r--g-----------||||---||||-------------------%%%%---%%%%-------------------||||---||||------------------------------------------------------|||||X||||
||||||||||||||||||||||%%%%%%%%%%%%%||||---||||%%%%%%%%%%%%%%%%%%%||||---||||%%%%%%%%%%%%%%%%%%%||||---||||%%%%%%%%%%%%%%%%%%%||||---||||%%%%%%%%%%%%%%%%%%%%%%%---%%%%%%%%%%%%%%%%%%%%%%%%%%%%|||||X||||
