--------------------------------------------------------------------------------------------------------------------------------------------------------------------------------------------------------
--------------------------------------------------------------------------------------------------------------------------------------------------------------------------------------------------------
--------------------------------------------------------------------------------------------------------------------------------------------------------------------------------------------------------
--------------------------------------------------------------------------------------------------------------------------------------------------------------------------------------------------------
--------------------------------------------------------------------------------------------------------------------------------------------------------------------------------------------------------
--------------------------------------------------------------------------------------------------------------------------------------------------------------------------------------------------------
--------------------------------------------------------------------------------------------------------------------------------------------------------------------------------------------------------
--------------------------------------------------------------------------------------------------------------------------------------------------------------------------------------------------------
--------------------------------------------------------------------------------------------------------------------------------------------------------------------------------------------------------
--------------------------------------------------------------------------------------------------------------------------------------------------------------------------------------------------------
--------------------rG----------------------------------------------------------------------------------------------------------------------------------------------------------------------------------
---------------------CCUCUUCCUUB--BUUUUU----------g-----g----B------B-----------B--B--------------------------------------------------------------------------------------------------------------------
--------------------------------------------------%%%%--%%%%-----------------------------------%%%%--%%%%-----------------------------------------------------------------------------------------------
----------%%%%%%%%%-------------------------------||||--||||-----------------------------------||||--||||-----------------------------------%%%%--%%%%--------------------------------------------------
----------|||||||||-------------------------------||||--||||-----------------------------------||||--||||-----------------------------------||||--||||----------------------------------------%%%%%F%%%%
%%%%%%%%%%|||||||||%%%%%%%%%%%%%%%%%%%%%%%%%%%%%%%||||--||||%%%%%%%%%%%%%%%%%%%%%%%%%%%%%%%%%%%||||--||||%%%%%%%%%%%%%%%%%%%%%%%%%%%%%%%%%%%||||--||||%%%%%%%%%%%%%%%%%%%%%%%%%%%%%%%%%%%%%%%%|||||X||||
