--------------------------------------------------------------------------------------------------------------------------------------------------------------------------------------------------------
--------------------------------------------------------------------------------------------------------------------------------------------------------------------------------------------------------
--------------------------------------------------------------------------------------------------------------------------------------------------------------------------------------------------------
--------------------------------------------------------------------------------------------------------------------------------------------------------------------------------------------------------
--------------------------------------------------------------------------------------------------------------------------------------------------------------------------------------------------------
--------------------------------------------------------------------------------------------------------------------------------------------------------------------------------------------------------
--------------------------------------------------------------------------------------------------------------------------------------------------------------------------------------------------------
--------------------------------------------------------------------------------------------------------------------------------------------------------------------------------------------------------
--------------------------------------------------------------------------------------------------------------------------------------------------------------------------------------------------------
--------------------------------------------------------------------------------------------------------------------------------------------------------------------------------------------------------
---------------------------------g----------------------------------------------------------------------------------------------------------------------------------------------------------------------
-------------------SCUCCCCUCC----CCCCUCUCUU---------------------UUUUUUUUU----U-----S--S------S--------------------------------------S-----S-------------------------S--S----------S--S------S-----------
--------------------------------------------------------------------------------------------------------------------------------------------%%%%----%%%%------------------------------------------------
--------------------------------------------------%%%%----%%%%------------------------------------------------------------------------------||||----||||------------------------------------------------
%%%%%%%%%%---------r---rg-------------------------||||----||||---------------------------------%%%%----%%%%---------------------------------||||----||||------------------------------------------------
||||||||||XXXXXXXXXXXXXXXXXXXXXXXXXXXXXXXXXXXXXXXX||||----||||XXXXXXXXXXXXXXXXXXXXXXXXXXXXXXXXX||||----||||XXXXXXXXXXXXXXXXXXXXXXXXXXXXXXXXX||||----||||XXXXXXXXXXXXXXXXXXXXXXXXXXXXXXXXXXXXXXXXXXXFXXXX
