--------------------------------------------------------------------------------------------------------------------------------------------------------------------------------------------------------
--------------------------------------------------------------------------------------------------------------------------------------------------------------------------------------------------------
--------------------------------------------------------------------------------------------------------------------------------------------------------------------------------------------------------
--------------------------------------------------------------------------------------------------------------------------------------------------------------------------------------------------------
--------------------------------------------------------------------------------------------------------------------------------------------------------------------------------------------------------
--------------------------------------------------------------------------------------------------------------------------------------------------------------------------------------------------------
--------------------------------------------------------------------------------------------------------------------------------------------------------------------------------------------------------
--------------------------------------------------------------------------------------------------------------------------------------------------------------------------------------------------------
--------------------------------------------------------------------------------------------------------------------------------------------------------------------------------------------------------
--------------------------------------------------------------------------------------------------------------------------------------------------------------------------------------------------------
--------------------------------------------------------------------------------------------------------------------------------------------------------------------------------------------------------
-----------------SCC----S----------------------------------------------------------------------------------------------S------------------------S-------------------------------------------------------
------------------------------k----------------------------------r--------------%%%%-----%%%%--------------------------------------------------------------k--------------------------------------------
%%%%%%%%%%%%%%%%--------------%%%%-----%%%%------------%%%%-----%%%%------------||||-----||||-------------------------------------%%%%-----%%%%------------%%%%-----%%%%--------------------------------
||||||||||||||||-gG-----------||||-----||||----g-------||||-----||||------------||||-----||||-------------------------------------||||-----||||------------||||-----||||----------------------%%%%%F%%%%
||||||||||||||||XXXXXXXXXXXXXX||||-----||||XXXXXXXXXXXX||||-----||||XXXXXXXXXXXX||||-----||||XXXXXXXXXXXXXXXX-----XXXXXXXXXXXXXXXX||||-----||||XXXXXXXXXXXX||||-----||||XXXXXXXXXXXXXXXXXXXXXX|||||X||||
