--------------------------------------------------------------------------------------------------------------------------------------------------------------------------------------------------------
--------------------------------------------------------------------------------------------------------------------------------------------------------------------------------------------------------
--------------------------------------------------------------------------------------------------------------------------------------------------------------------------------------------------------
--------------------------------------------------------------------------------------------------------------------------------------------------------------------------------------------------------
--------------------------------------------------------------------------------------------------------------------------------------------------------------------------------------------------------
--------------------------------------------------------------------------------------------------------------------------------------------------------------------------------------------------------
--------------------------------------------------------------------------------------------------------------------------------------------------------------------------------------------------------
--------------------------------------------------------------------------------------------------------------------------------------------------------------------------------------------------------
--------------------------------------------------------------------------------------------------------------------------------------------------------------------------------------------------------
--------------------------------------------------------------------------------------------------------------------------------------------------------------------------------------------------------
-----------Tt---k---------------------------------------------------------------------------------------------------------------------------------------------------------------------------------------
-----------tt---UUUUUUU---------------------------------------------------------------------------------------------------------------------------------------------------------------------------------
----------%%%%------------------------------------------------------------------------------------------------------------------------------------------------------------------------------------------
----------||||------------------------------------------------------------------%%%%---%%%%---------------------------------------%%%%---%%%%--------------%%%%---%%%%----------------------------------
%%%%%%%%%%||||----------------r-------------------------------------------------||||---||||---------------------------------------||||---||||--------------||||---||||------------------------%%%%%F%%%%
||||||||||||||%%%%%%%%%%%%%%%%%%%%---%%%%%%%%%%%%%%%%%%%%%%---%%%%%%%%%%%%%%%%%%||||---||||%%%%%%%%%%%%%%%%%%---%%%%%%%%%%%%%%%%%%||||---||||%%%%%%%%%%%%%%||||---||||%%%%%%%%%%%%%%%%%%%%%%%%|||||X||||
