--------------------------------------------------------------------------------------------------------------------------------------------------------------------------------------------------------
--------------------------------------------------------------------------------------------------------------------------------------------------------------------------------------------------------
--------------------------------------------------------------------------------------------------------------------------------------------------------------------------------------------------------
--------------------------------------------------------------------------------------------------------------------------------------------------------------------------------------------------------
--------------------------------------------------------------------------------------------------------------------------------------------------------------------------------------------------------
--------------------------------------------------------------------------------------------------------------------------------------------------------------------------------------------------------
--------------------------------------------------------------------------------------------------------------------------------------------------------------------------------------------------------
--------------------------------------------------------------------------------------------------------------------------------------------------------------------------------------------------------
--------------------------------------------------------------------------------------------------------------------------------------------------------------------------------------------------------
--------------------------------------------------------------------------------------------------------------------------------------------------------------------------------------------------------
------------------rG------------------------------------------------------------------------------------------------------------------------------------------------------------------------------------
-----------------SCCCCCUUS----------------UUUU-----------------------S---------------S-----S---------------S-----S---------------S----------------------------------------------------------------------
---------------------------------------------------------------------------------------------%%%%-----%%%%---------%%%%-----%%%%------------------------------------------------------------------------
---------------------------r--------g----------------------------------%%%%-----%%%%---------||||-----||||---------||||-----||||------------------------------------------------------------------------
----------%%%%%%-----------%%%%-----%%%%---------%%%%-----%%%%---------||||-----||||---------||||-----||||---------||||-----||||---------%%%%-----%%%%---------%%%%-----%%%%------------------%%%%%F%%%%
XXXXXXXXXX||||||XXXXXXXXXXX||||-----||||XXXXXXXXX||||-----||||XXXXXXXXX||||-----||||XXXXXXXXX||||-----||||XXXXXXXXX||||-----||||XXXXXXXXX||||-----||||XXXXXXXXX||||-----||||XXXXXXXXXXXXXXXXXX|||||X||||
