--------------------------------------------------------------------------------------------------------------------------------------------------------------------------------------------------------
--------------------------------------------------------------------------------------------------------------------------------------------------------------------------------------------------------
--------------------------------------------------------------------------------------------------------------------------------------------------------------------------------------------------------
--------------------------------------------------------------------------------------------------------------------------------------------------------------------------------------------------------
--------------------------------------------------------------------------------------------------------------------------------------------------------------------------------------------------------
--------------------------------------------------------------------------------------------------------------------------------------------------------------------------------------------------------
--------------------------------------------------------------------------------------------------------------------------------------------------------------------------------------------------------
--------------------------------------------------------------------------------------------------------------------------------------------------------------------------------------------------------
--------------------------------------------------------------------------------------------------------------------------------------------------------------------------------------------------------
--------------------------------------------------------------------------------------------------------------------------------------------------------------------------------------------------------
--------------------------------------------------------------------------------------------------------------------------------------------------------------------------------------------------------
---------------------------2CCCUCCUCCC----UUUUUUUUU---BUUUUUUB---------------B----------B---------B------B--B---------------------------------------B-------------B-------------------------------------
-----------------%%%%%%%%%---------------------------------------------------------------------------------------------------%%%%---%%%%----------------------------------------------------------------
----------%%%%%%%|||||||||---------------------------------------r-----------------------------------------------------------||||---||||------------------------------------------------------%%%%%F%%%%
----------||||||||||||||||---rg--g-G-----k-gr----------rgg-------%%%%---%%%%-------------------------------------------------||||---||||------------------------------------------------------|||||X||||
%%%%%%%%%%||||||||||||||||%%%%%%%%%%%%%%%%%%%%%%%%%%%%%%%%%%%%%%%||||---||||%%%%%%%%%%%%%%%%%%%%%%%%%%%%%%%%%%%%%%%%%%%%%%%%%||||---||||%%%%%%%%%%%%%%%%%%%%%%%%%%%%%%%%%%%%%%%%%%%%%%%%%%%%%%|||||X||||
