--------------------------------------------------------------------------------------------------------------------------------------------------------------------------------------------------------
--------------------------------------------------------------------------------------------------------------------------------------------------------------------------------------------------------
--------------------------------------------------------------------------------------------------------------------------------------------------------------------------------------------------------
--------------------------------------------------------------------------------------------------------------------------------------------------------------------------------------------------------
--------------------------------------------------------------------------------------------------------------------------------------------------------------------------------------------------------
--------------------------------------------------------------------------------------------------------------------------------------------------------------------------------------------------------
--------------------------------------------------------------------------------------------------------------------------------------------------------------------------------------------------------
--------------------------------------------------------------------------------------------------------------------------------------------------------------------------------------------------------
--------------------------------------------------------------------------------------------------------------------------------------------------------------------------------------------------------
--------------------------------------------------------------------------------------------------------------------------------------------------------------------------------------------------------
-----------------------------------------------rG-------------------------------------------------------------------------------------------------------------------------------------------------------
-----------------------------------------------BUUUCC2-------------UCCUCC-------------------CUUUUUUUUUU--------------------------------------B-------------------------------B-----------B--------------
--------------------------%%%%%%%%--%%%%----------------------------------------------------------------------------------------------------------------------------------------------------------------
----------%%%%%%%%%%%%%%%%||||||||--||||---------------k---------------------------------------------------------------------------------------------------%%%%--%%%%-----------------------------------
----------||||||||||||||||||||||||--||||%%%%%%---------%%%%--%%%%-------g-------%%%%--%%%%----------------------------------------%%%%--%%%%---------------||||--||||-------------------------%%%%%F%%%%
%%%%%%%%%%||||||||||||||||||||||||--||||||||||%%%%%%%%%||||--||||%%%%%%%%%%%%%%%||||--||||%%%%%%%%%%%%%%%%%%%--%%%%%%%%%%%%%%%%%%%||||--||||%%%%%%%%%%%%%%%||||--||||%%%%%%%%%%%%%%%%%%%%%%%%%|||||X||||
