--------------------------------------------------------------------------------------------------------------------------------------------------------------------------------------------------------
--------------------------------------------------------------------------------------------------------------------------------------------------------------------------------------------------------
--------------------------------------------------------------------------------------------------------------------------------------------------------------------------------------------------------
--------------------------------------------------------------------------------------------------------------------------------------------------------------------------------------------------------
--------------------------------------------------------------------------------------------------------------------------------------------------------------------------------------------------------
--------------------------------------------------------------------------------------------------------------------------------------------------------------------------------------------------------
--------------------------------------------------------------------------------------------------------------------------------------------------------------------------------------------------------
--------------------------------------------------------------------------------------------------------------------------------------------------------------------------------------------------------
--------------------------------------------------------------------------------------------------------------------------------------------------------------------------------------------------------
--------------------------------------------------------------------------------------------------------------------------------------------------------------------------------------------------------
--------------------------------------------------g-----------------------------------------------------------------------------------------------------------------------------------------------------
-----------------------CCUCCUC-----------CCCUUUS---UUUUUU----UUUUUUUS--------------S------------S------S-----------------------S-----------S------------------------------------------S-----------------
---------------%%%%%%-----------------------------------------------------------------------------------------------------------------------------------------------------------------------------------
%%%%%%%%%%-----||||||-----------%%%%%%%-----------------------------------------------------------------------------------------------------------------------------------------------------------------
||||||||||-----||||||-g-k-g-G---|||||||-r-gr---------g----------------------------------------------------------------------------------------------------------------------------------------%%%%%F%%%%
||||||||||XXXXX||||||XXXXXXXXXXX|||||||XXXXXXXXXXXXXXXXXXXXXXXXXXXXXXXXXXXXXXXXXXXXXXXXXXXXXXXXXXXXXXXXXXXXXXXXXXXXXXXXXXXXXXXXXXXXXXXXXXXXXXXXXXXXXXXXXXXXXXXXXXXXXXXXXXXXXXXXXXXXXXXXXXXXXXX|||||X||||
