--------------------------------------------------------------------------------------------------------------------------------------------------------------------------------------------------------
--------------------------------------------------------------------------------------------------------------------------------------------------------------------------------------------------------
--------------------------------------------------------------------------------------------------------------------------------------------------------------------------------------------------------
--------------------------------------------------------------------------------------------------------------------------------------------------------------------------------------------------------
--------------------------------------------------------------------------------------------------------------------------------------------------------------------------------------------------------
--------------------------------------------------------------------------------------------------------------------------------------------------------------------------------------------------------
--------------------------------------------------------------------------------------------------------------------------------------------------------------------------------------------------------
--------------------------------------------------------------------------------------------------------------------------------------------------------------------------------------------------------
--------------------------------------------------------------------------------------------------------------------------------------------------------------------------------------------------------
--------------------------------------------------------------------------------------------------------------------------------------------------------------------------------------------------------
--------------------------------------------------------------------------------------------------------------------------------------------------------------------------------------------------------
----------------------2UCUCCCB---CUUUUU----------------B---------B---------B---------------B----------B--B-----------------------------------------------------------------------B----------B-----------
-----------------------------------------------------------------------------%%%%-----%%%%--------------------------------------------------------------------------------------------------------------
---------------%%%%%%--------------------%%%%-----%%%%-----------------------||||-----||||-----------------------%%%%-----%%%%--------------------------------------------------------------------------
%%%%%%%%%%%%%%%||||||--------------------||||-----||||-----------------------||||-----||||-----------------------||||-----||||-----------------------%%%%-----%%%%----------------------------%%%%%F%%%%
|||||||||||||||||||||%%%%%%%%%%%%%%%%%%%%||||-----||||%%%%%%%%%%%%%%%%%%%%%%%||||-----||||%%%%%%%%%%%%%%%%%%%%%%%||||-----||||%%%%%%%%%%%%%%%%%%%%%%%||||-----||||%%%%%%%%%%%%%%%%%%%%%%%%%%%%|||||X||||
