--------------------------------------------------------------------------------------------------------------------------------------------------------------------------------------------------------
--------------------------------------------------------------------------------------------------------------------------------------------------------------------------------------------------------
--------------------------------------------------------------------------------------------------------------------------------------------------------------------------------------------------------
--------------------------------------------------------------------------------------------------------------------------------------------------------------------------------------------------------
--------------------------------------------------------------------------------------------------------------------------------------------------------------------------------------------------------
--------------------------------------------------------------------------------------------------------------------------------------------------------------------------------------------------------
--------------------------------------------------------------------------------------------------------------------------------------------------------------------------------------------------------
--------------------------------------------------------------------------------------------------------------------------------------------------------------------------------------------------------
--------------------------------------------------------------------------------------------------------------------------------------------------------------------------------------------------------
--------------------------------------------------------------------------------------------------------------------------------------------------------------------------------------------------------
----------------rgrG----------------------gg-g----------------------------------------------------------------------------------------------------------------------------------------------------------
-----------------CUUCCCUC------------------CUCU2-----------------CCCU-----------------2CUCU------------------UUUUB----------------BUU-------------------B----B--------------------------B---------------
---------------------------------------------------------------------------------------------%%%%------%%%%--------%%%%------%%%%-----------------------------------------------------------------------
---------------------------r-----------------------------------------------------------------||||------||||--------||||------||||------------------------------%%%%------%%%%---------------------------
----------%%%%%------------%%%%------%%%%-----------------------g-g----%%%%------%%%%--------||||------||||--------||||------||||------------------------------||||------||||---------------------------
%%%%%%%%%%|||||%%%%%%%%%%%%||||------||||%%%%%%%%%%%%------%%%%%%%%%%%%||||------||||%%%%%%%%||||------||||%%%%%%%%||||------||||%%%%%%%%%%%%------%%%%%%%%%%%%||||------||||%%%%%%%%%%%%%%%%%%%%%%F%%%%
