--------------------------------------------------------------------------------------------------------------------------------------------------------------------------------------------------------
--------------------------------------------------------------------------------------------------------------------------------------------------------------------------------------------------------
--------------------------------------------------------------------------------------------------------------------------------------------------------------------------------------------------------
--------------------------------------------------------------------------------------------------------------------------------------------------------------------------------------------------------
--------------------------------------------------------------------------------------------------------------------------------------------------------------------------------------------------------
--------------------------------------------------------------------------------------------------------------------------------------------------------------------------------------------------------
--------------------------------------------------------------------------------------------------------------------------------------------------------------------------------------------------------
--------------------------------------------------------------------------------------------------------------------------------------------------------------------------------------------------------
--------------------------------------------------------------------------------------------------------------------------------------------------------------------------------------------------------
--------------------------------------------------------------------------------------------------------------------------------------------------------------------------------------------------------
--------------------------------------------------------------------------------------------------------------------------------------------------------------------------------------------------------
----------------------------------------CUCCCUC--------------2UUUUUUU--------------BUUUUU----------------B-----------------------------B-------------B-------B------------------------B--B--------------
-------------------------------------------------%%%%---%%%%-----------%%%%---%%%%-----------%%%%---%%%%-----------%%%%---%%%%---------------------------------%%%%---%%%%------------------------------
----------%%%%%%%%-------------------------------||||---||||-----------||||---||||-----------||||---||||-----------||||---||||-----------%%%%---%%%%-----------||||---||||------------------------------
----------||||||||-------------------------------||||---||||-----------||||---||||-----------||||---||||-----------||||---||||-----------||||---||||-----------||||---||||------------------------------
%%%%%%%%%%||||||||%%%%%%%%%%%%%---%%%%%%%%%%%%%%%||||---||||%%%%%%%%%%%||||---||||%%%%%%%%%%%||||---||||%%%%%%%%%%%||||---||||%%%%%%%%%%%||||---||||%%%%%%%%%%%||||---||||%%%%%%%%%%%%%%%%%%%%%%%%%F%%%%
