--------------------------------------------------------------------------------------------------------------------------------------------------------------------------------------------------------
--------------------------------------------------------------------------------------------------------------------------------------------------------------------------------------------------------
--------------------------------------------------------------------------------------------------------------------------------------------------------------------------------------------------------
--------------------------------------------------------------------------------------------------------------------------------------------------------------------------------------------------------
--------------------------------------------------------------------------------------------------------------------------------------------------------------------------------------------------------
--------------------------------------------------------------------------------------------------------------------------------------------------------------------------------------------------------
--------------------------------------------------------------------------------------------------------------------------------------------------------------------------------------------------------
--------------------------------------------------------------------------------------------------------------------------------------------------------------------------------------------------------
--------------------------------------------------------------------------------------------------------------------------------------------------------------------------------------------------------
--------------------------------------------------------------------------------------------------------------------------------------------------------------------------------------------------------
-------------------r------------------------------------------------------------------------------------------------------------------------------------------------------------------------------------
--------------------UCUCCU2-------------------UCCCCCCB-----------------UUUUUUU------------------UUUUUUU-----------------BU------B----------------B------------------------B----------B------B-----------
------------------------------%%%%------%%%%-----------%%%%------%%%%------------------------------------%%%%------%%%%---------------------------------------------------------------------------------
------------------------------||||------||||-----------||||------||||------------------------------------||||------||||-----------%%%%------%%%%----------------------------------------------%%%%%F%%%%
------------------------------||||------||||-----------||||------||||------------------------------------||||------||||-----------||||------||||-----------%%%%------%%%%---------------------|||||X||||
%%%%%%%%%%%%%%%%%%%%%%%%%%%%%%||||------||||%%%%%%%%%%%||||------||||%%%%%%%%%%%%%%%------%%%%%%%%%%%%%%%||||------||||%%%%%%%%%%%||||------||||%%%%%%%%%%%||||------||||%%%%%%%%%%%%%%%%%%%%%|||||X||||
