--------------------------------------------------------------------------------------------------------------------------------------------------------------------------------------------------------
--------------------------------------------------------------------------------------------------------------------------------------------------------------------------------------------------------
--------------------------------------------------------------------------------------------------------------------------------------------------------------------------------------------------------
--------------------------------------------------------------------------------------------------------------------------------------------------------------------------------------------------------
--------------------------------------------------------------------------------------------------------------------------------------------------------------------------------------------------------
-----------------U----------------B--B-------B------BB----U---UB-------U---B-------B-B------B-----B--U-----B----UBB-BU-U--U-----B---------------------B-------------B-B---------B-----------------------
--------------C----------------------------------------------------------C----------------------C--------------------------------C----------C-----------------------------------------------------------
--------------------------------------------------------------------------------------------------------------------------------------------------------------------------------------------------------
--------------------------------------------------------------------------------------------------------------------------------------------------------------------------------------------------------
--------------------------------------------------------------------------------------------------------------------------------------------------------------------------------------------------------
-#tt--------#-BC-C-CBB-U-#--B------C-----------tt--B---tt-C---C---B----C-BU-tt---BC--------#----BC-C-C-C----C---C----C-C#-CB-B---B--------#UBC-C----tt----B-----UC---U----------------------------------
-#tt--##---##------------#----#------------#---tt-----#tt-------------------tt------------##----------------------------#-----tt---------##---------tt--#--tt-----tt---tt-------------------------------
##tt#-###-###------------#----##------tt---#---tttt---#tt--tt---------------tt----------#-##------------tt--------------#-----tt---tt-tt###-------tttt--#--tt--#--tt---tt--------------------tt---------
##tt#-#######k-----------#----###-g--gtt---#k-gtttt---#ttk-tt-------#g--k--gtt-gg--g---g#-##---g--------tt-----#-ggg----##----tt--kttktt###-------tttt-##--tt#-#--tt---tt-------g-------g----tt--------F
XXXXX-XXXXXXXXXXXXXXXXXX-XXXXXXXXXXXXXXXXXXXXXXXXXXXXXXXXXXXXXXXX-XXXXXXXXXXXXXXXXXXX-XXX-XXXXXXXX-XXXXXXXX-XXXXXXXXXXXXXXXX-XXXXXXXXXXXXXXXXXXXXXXXXXXXXXXXXX-XXXXXXXXXXXXXXXXXXXXXXXXXXXXXXXXXXXXXXXXX
XXXXX-XXXXXXXXXXXXXXXXXX-XXXXXXXXXXXXXXXXXXXXXXXXXXXXXXXXXXXXXXXX-XXXXXXXXXXXXXXXXXXX-XXX-XXXXXXXX-XXXXXXXX-XXXXXXXXXXXXXXXX-XXXXXXXXXXXXXXXXXXXXXXXXXXXXXXXXX-XXXXXXXXXXXXXXXXXXXXXXXXXXXXXXXXXXXXXXXXX
