--------------------------------------------------------------------------------------------------------------------------------------------------------------------------------------------------------
--------------------------------------------------------------------------------------------------------------------------------------------------------------------------------------------------------
--------------------------------------------------------------------------------------------------------------------------------------------------------------------------------------------------------
--------------------------------------------------------------------------------------------------------------------------------------------------------------------------------------------------------
--------------------------------------------------------------------------------------------------------------------------------------------------------------------------------------------------------
-----------------------------------B---------------------B----B------U------------------BB----------U----U-------BB---BB-----B-B-U----------------B---BB--U-----B---------------------B-----------------
--------------------------------------C---------------------------C------------C----------------------------------------C--------------C----C----------------------C------------------------------------
--------------------------------------------------------------------------------------------------------------------------------------------------------------------------------------------------------
--------------------------------------------------------------------------------------------------------------------------------------------------------------------------------------------------------
--------------------------------------------------------------------------------------------------------------------------------------------------------------------------------------------------------
C------------tt----------UttB-#-B-B---B----tt--#--------B--tt-----BCBCBC-tt----B--tt-----------#--C-C-C--C--UU--C-------Btt-----CCC#---B----Btt-U----B----C----#--UB--Ctt----U-C---U--------------------
---------tttttt-----------tt--#---------#tttt--#-----------tt------------tt-------tt------#tt-##-------------------------tt-#------#-#--tt---tt----------------#-------tt-------------------------------
-----#---tttttt##-#-----#-tt--#---------#tttt-###-tt#------tt-----------#tt-tt--#-tt-#----#tt###--------#--#--------tt---tt-#------#-#--tt---tt-------------#--#-------tt-------------------------------
-gk#-#g--tttttt##g#---#-#-tt--##----g--g#tttt-###-tt#--g---ttg--gk------#tt-tt--#ktt-#--gg#tt###gk-----k#-k#--gg-g-#tt-g-tt-#gg----#-##-ttg--tt---g-----g---#g-#g---g--tt-###-#-###-##g################F
XXXX-XXX-XXXXXXXXXXXXXX-XXXXX-XXXXXXX-XXXXXXXXXXXXXXXXXXXXXXXX-XXXXXXXXXXXXXXXXXXXXX-XXXXXXXXXXXXXXXXXXXXXXXXXXXXX-XXX-XXXX-XXX-XXXXXXXXXXXXXXXXXXXX-XXXXXXXXXXXX-XXXXXXXXXXXXXXXXXXXXXXXXXXXXXXXXXXXXXX
XXXX-XXX-XXXXXXXXXXXXXX-XXXXX-XXXXXXX-XXXXXXXXXXXXXXXXXXXXXXXX-XXXXXXXXXXXXXXXXXXXXX-XXXXXXXXXXXXXXXXXXXXXXXXXXXXX-XXX-XXXX-XXX-XXXXXXXXXXXXXXXXXXXX-XXXXXXXXXXXX-XXXXXXXXXXXXXXXXXXXXXXXXXXXXXXXXXXXXXX
