--------------------------------------------------------------------------------------------------------------------------------------------------------------------------------------------------------
--------------------------------------------------------------------------------------------------------------------------------------------------------------------------------------------------------
--------------------------------------------------------------------------------------------------------------------------------------------------------------------------------------------------------
--------------------------------------------------------------------------------------------------------------------------------------------------------------------------------------------------------
--------------------------------------------------------------------------------------------------------------------------------------------------------------------------------------------------------
------------------S--------SS-S---S----S---------------------------S-S----U----U------------------------U----------SSS--S---S-S----SS------S--------S-----U----------------UUUUUU-UU-UUSUUUUUUUUUUUUUUUU
CC------------------------------C-----------------C-C-C-C-C---------C-----------------------------------------------------------------------------------------C-----------------------------------------
--------------------------------------------------------------------------------------------------------------------------------------------------------------------------------------------------------
--------------------------------------------------------------------------------------------------------------------------------------------------------------------------------------------------------
--------------------------------------------------------------------------------------------------------------------------------------------------------------------------------------------------------
SS-ttSU-ttS#------------Ctt-----S----------U-----SSSSSSSSSSStt---U--S----#C----C---#-#tt--U-ttC#S-tt----C---C--tt-----tt-----C----#---#U-------#S-U--C--C-C---S#--tt------CCCCCCC-CC-CC-CCCCCCCCCCCCCCCC
---tt---tt-#--#----tt----tt---------tt----------#-----------tt----#------#-tt------#-#tt----tt-#--tt---#-#-----tt-----tt----------#---#--------#-------#----tt-#--tt------------------------------------
---tt---tt-##-#tt--tt----tt---------tt---#--##-##-----------tt-tt-#---#tt#-tt------#-#tt----tt-#--tt-tt#-###--#tt-----tt-------tt##---#--tt----#-#-#---#----tt-#--tt----tt------------------------------
---tt---tt-##-#ttg-tt----tt---g--k-#tt--k#--#####-----------tt-tt-#g--#tt#-tt-#-kgg#-#tt#g--tt-#-gtt-tt#-###-k#ttg---gttg-kg---tt##---#--ttgggg#-#-#---#-k-gtt-#-kttk#-gtt-----------------------------F
%%%||%%%||%||-||||%||%%%%||-%%|%%|-|||--||%%|||||%%%%%%%%%%%||%||%||%-||||%||%|%||||-|||||%%||%|%|||%|||%|||%|||||%%-||||%||-%-||||%-%|%%|||||||%|%|-%%|%|%|||%|%|||||%|||%%%%%%%%%%%%%-%%%%%%%%%%%%%%%%
|||||||||||||-|||||||||||||-||||||-|||--|||||||||||||||||||||||||||||-||||||||||||||-|||||||||||||||||||||||||||||||-|||||||-|-|||||-|||||||||||||||-||||||||||||||||||||||||||||||||||-||||||||||||||||
