--------------------------------------------------------------------------------------------------------------------------------------------------------------------------------------------------------
--------------------------------------------------------------------------------------------------------------------------------------------------------------------------------------------------------
--------------------------------------------------------------------------------------------------------------------------------------------------------------------------------------------------------
--------------------------------------------------------------------------------------------------------------------------------------------------------------------------------------------------------
--------------------------------------------------------------------------------------------------------------------------------------------------------------------------------------------------------
------S---------S-------------S--S--SS-----U---------U---------------S-S----S----------SSS----------------------------SS-S-----U----------U-------S-----------------------------------------------------
------------------------C------------------------------------------------C-C-----------------------------------------------------------------C-C--------------------------------------------------------
--------------------------------------------------------------------------------------------------------------------------------------------------------------------------------------------------------
--------------------------------------------------------------------------------------------------------------------------------------------------------------------------------------------------------
--------------------------------------------------------------------------------------------------------------------------------------------------------------------------------------------------------
----S---#-tt-------U---#S-ttC#--C--S------#C-------CCC---tt-----#tt------S#S-tt-----ttS---C-#----U--#--#----SS------#S------U--C-----ttCU-C--SSSSC-tt-------tt------------------------------------------
--------#-tt-----tt---##--tt-#-#---------##------------tttt----##tt#------#--tt-----tt------#------##--##-----------#--------#-------tt----tt------tt---#--#tt------------------------------------------
--#-----#-tt-tt#-tt--###--tt-#-#--#-----###-tt----#----tttt-tt###tt#------#--tt---#-tt------#--tt--##--###---------##-----tt-#-------tt----tt------tt-tt##-#tt------------------------------------------
-g#g--g-#gttgtt#-tt-####-ktt-#g#--#----####-tt#g#-#---ktttt-tt###tt##---g-#--tt--g#gtt-----g##gtt-###--####----gggk##----gtt-#----g-gtt--g-tt------tt-tt####tt-----------------------------------------F
%|||%%|%||||||||%||%||||%|||%|||%%|%--%||||%|||||-|%%%|||||%|||||||||%%%|%|%-||%%|||||%%%%%||||||%|||%%||||%%%-||||||%---|||%|%%%%|-|||%%|%||%%%%%-||%||||||||%%%%%%%%%%%%%%%%%%%%%%%-%%%%%%%%%%%%%%%%%%
||||||||||||||||||||||||||||||||||||--|||||||||||-||||||||||||||||||||||||||-|||||||||||||||||||||||||||||||||-|||||||---||||||||||-||||||||||||||-||||||||||||||||||||||||||||||||||-||||||||||||||||||
