--------------------------------------------------------------------------------------------------------------------------------------------------------------------------------------------------------
--------------------------------------------------------------------------------------------------------------------------------------------------------------------------------------------------------
--------------------------------------------------------------------------------------------------------------------------------------------------------------------------------------------------------
--------------------------------------------------------------------------------------------------------------------------------------------------------------------------------------------------------
--------------------------------------------------------------------------------------------------------------------------------------------------------------------------------------------------------
----------SS---SS------U------SS----U---U---U---U---U---U------S---SS--------------S----S-------------------------------U---------S---------------------------------S-----------------------------------
--------------------------------------------------------------C----------------------------------C-------------------C----------------------------------------------------------------------------------
--------------------------------------------------------------------------------------------------------------------------------------------------------------------------------------------------------
--------------------------------------------------------------------------------------------------------------------------------------------------------------------------------------------------------
--------------------------------------------------------------------------------------------------------------------------------------------------------------------------------------------------------
S--U--#--S----S--ttCC-#CC----S--U-CSCSCSCSCSCSCSCSCSCSCSCSC-U#S-S-S------S----tt-----tt----------S-------#U----------S--C-------#----------------------------------------#------------------------------
------#----------tt---#----tt--------------------------------#---#-----tt-tt--tt--#--tt-----------tt-----#------tt--------------#----------------------------------------#------------------------------
-tt---#-----tt---tt---#----tt--------------------------------#---#-----tt-tt--tt#-#--tt--------tt-tt-tt--#------tt--------#-----#------------#---------------------------#------------#-----------------
-tt-k-###---tt---tt---#--k#tt------------------------------g-#---#---#gtt-tt--tt#-#ggtt--k-----tt-tt-tt-##------tt-----g-g#-----#--k---------#-g----------------g---g----#-------g----#----------------F
%||%|%|||%%%||%--||%%%|%%||||%--%%%%%%%%%%%%%%%%%%%%%%%%%%%|%|%%%|%%%||||%||%%|||-|||||%-|%-%%%||%||%||%||%%%%%%||%%%%%|%||%%%%%|%-|%%%%%%%%%|%|%%%%%%%%%%%%%%%%|%%%|%%%%|%%%%%%%|%%%%|%%%%%%%%%%%%%%%%%
|||||||||||||||--|||||||||||||--|||||||||||||||||||||||||||||||||||||||||||||||||-||||||-||-||||||||||||||||||||||||||||||||||||||-|||||||||||||||||||||||||||||||||||||||||||||||||||||||||||||||||||||
