--------------------------------------------------------------------------------------------------------------------------------------------------------------------------------------------------------
--------------------------------------------------------------------------------------------------------------------------------------------------------------------------------------------------------
--------------------------------------------------------------------------------------------------------------------------------------------------------------------------------------------------------
--------------------------------------------------------------------------------------------------------------------------------------------------------------------------------------------------------
--------------------------------------------------------------------------------------------------------------------------------------------------------------------------------------------------------
--------B---BBU--------B----U---------------B-B--------------------B------U---U---B-------B-B-------------B-U--U---BU-----B----------------------------B------------------------------------------------
----C-------------------C-----------------C--C-------------------------C--------------------------------------------------------------------------------------------------------------------------------
--------------------------------------------------------------------------------------------------------------------------------------------------------------------------------------------------------
--------------------------------------------------------------------------------------------------------------------------------------------------------------------------------------------------------
--------------------------------------------------------------------------------------------------------------------------------------------------------------------------------------------------------
----BC--------C-ttCU----B-C-C-C-----------B--B--tt-CC--U--------------UBC-C-C-C-C----C#------#---#C----#----CCBCBC--C----#-U--C-----------------------------------------------------U-U-----------------
-#--------------tt--#-------------------tt------tt---tt------#------------------------#------#-tt#-#-#-#----------------##-----------------------------------------#------------------------------------
-#tt------------tt--##------------------tt------tt---tt-tt#--##-----------------------#------#-tt#-#-#-#---------------###--tt---------------------------------tt--#------------------------------------
-#tt--k-g-#--g--tt--###--k-------------gtt-----ktt---tt-tt#--###-----g----------------##-gggg#-tt#-#k#-#-kgg-------g--####--tt-------------k---------#---------tt--#-----------------------------------F
XXXXXXXXXXXX-XXXXXXXXXX-XXXXXXXXX-XXX--XXXXX-XXXXXXXXXXXXXXXXXXXXXXXXXXXXXXXXXXXXX-XXXXXXXXXXX-XXXXXXXXXXXXXXXXXXXXXXXXXXXXXXXXXXXXXXXXXXXXXXXXXXXXXXXXXXXXXXXXXXXXXXXXXXXXXXXXXXXXXXXXXXXXXXXXXXXXXXXXX
XXXXXXXXXXXX-XXXXXXXXXX-XXXXXXXXX-XXX--XXXXX-XXXXXXXXXXXXXXXXXXXXXXXXXXXXXXXXXXXXX-XXXXXXXXXXX-XXXXXXXXXXXXXXXXXXXXXXXXXXXXXXXXXXXXXXXXXXXXXXXXXXXXXXXXXXXXXXXXXXXXXXXXXXXXXXXXXXXXXXXXXXXXXXXXXXXXXXXXX
