--------------------------------------------------------------------------------------------------------------------------------------------------------------------------------------------------------
--------------------------------------------------------------------------------------------------------------------------------------------------------------------------------------------------------
--------------------------------------------------------------------------------------------------------------------------------------------------------------------------------------------------------
--------------------------------------------------------------------------------------------------------------------------------------------------------------------------------------------------------
--------------------------------------------------------------------------------------------------------------------------------------------------------------------------------------------------------
-S--------S-----------S-----S-----SU---S----------SU-S--------S---SS-------SS-----S-------------------S----------S---------S-----------------S----U-----------S---------SU-U--S-------------------------
----------------CC------------CC----C-C---------------------------------------------------------------------C---------------------------C---------------C--------C--------------------------------------
--------------------------------------------------------------------------------------------------------------------------------------------------------------------------------------------------------
--------------------------------------------------------------------------------------------------------------------------------------------------------------------------------------------------------
--------------------------------------------------------------------------------------------------------------------------------------------------------------------------------------------------------
-------tt-----ttSSC------S----SS---CS-S-tt---------C---##-------#------ttCS--C---U-----#U----#Stt-------CSS-S#------------C----U--S-----S--tt-----C-----S---C----S-------C#C-S--------------------------
-------tt--#--tt---#------tt-----#------tttt--tt----#--##tt-----#---#--tt--------------#-tt-##-tt------------#-------tt-----tt--#---------#tt--------#-------#------------#-#---------------------------
-------tt--##-tt---##-----tt-----#------tttt--tt----#--##tt-----#---#--tt----------#tt-#-tt###-tttt-tt-------#-------tt-----tt--#---------#tt---tt-#-#----tt-#--------tt--#-#--------#------------------
#---gg#ttgg###tt---###g---ttgg--g#---#--tttt-#tt-k--#g-##tt--g--#k-g#g-tt------k---#tt-#-tt###-tttt-tt-g-----#-g#g-k-tt-#--gttg-#-----g---#ttgggtt-#-##---tt-#gg#--gggtt--#-#--#####-##################F
|%-%||||||||||||%%%||||%%%||||%%||-%%|%-||||-|||%|%%||-||||%%|%%||%|||-||%%%%%-|%%%|||-|%|||||%||||%||%|%%%%%|%|||%|-||%|%%||||%|%%-%%|%%%||||||||%|-||%%-||%||||%-|||||%%|%|%%|||||-||||||||||||||||||%
||-|||||||||||||||||||||||||||||||-||||-||||-|||||||||-|||||||||||||||-|||||||-|||||||-|||||||||||||||||||||||||||||-||||||||||||||-||||||||||||||||-||||-||||||||-|||||||||||||||||-|||||||||||||||||||
