--------------------------------------------------------------------------------------------------------------------------------------------------------------------------------------------------------
--------------------------------------------------------------------------------------------------------------------------------------------------------------------------------------------------------
--------------------------------------------------------------------------------------------------------------------------------------------------------------------------------------------------------
--------------------------------------------------------------------------------------------------------------------------------------------------------------------------------------------------------
--------------------------------------------------------------------------------------------------------------------------------------------------------------------------------------------------------
-U-----B-------U--B-------U------------------U---U-----------------------B-----------------------------BB---B----UBU------------------------------------------------------B-----------------------------
--------------------------------------------------------------------------C-----------------------------------------------------------------------------------------------------------------------------
--------------------------------------------------------------------------------------------------------------------------------------------------------------------------------------------------------
--------------------------------------------------------------------------------------------------------------------------------------------------------------------------------------------------------
--------------------------------------------------------------------------------------------------------------------------------------------------------------------------------------------------------
BC----#-ttttttBCBC--------C----BUB-----C---C-C-C-C-C--U----#-UUUUB--------B--C---------#-tt-----#-ttU------------C-C--------------------tt---C-----------#----------------------------------------------
-----##-tttttt-------#---#---tt----tt----tt---------tt----##---------------#--#-----#--#-tt----##-tt------------------------------------tt---------------#----------#-----------------------------------
----###-tttttt-------#tt-#---tt----tt----tt---------tt---###-------#-tt----#--##--#-#--#-tt-tt###-tt---------tt-#-----------------------tt-------tt------#----------#-----------------------------------
---####-tttttt------##tt-#-g-tt---gtt----tt---------tt--####g-----k#-ttgk--#g-###-#-#--#gtt-tt###-tt--ggg----tt-#-----------##----------tt-gg----tt------#----------#-----g----------------------------F
XXXXXXX-XXXXXXXXXX-XXXXX-XXXXXXXXXXXXXXXXXXXXXXXXXXXXXXXXXXXXXXXXXXXXXXXX-XXXXXXX-X-X-XXXXXXXXXXXXXXXXXXXXXXXXXXXXXXXXXX-XXXXXXXXXXXXXXXXXXXXXXXXXXXXXXXXXXXXXXXXXXXXXXXXXXXXXXXXXXXXXXXXXXXXXXXXXXXXXXX
XXXXXXX-XXXXXXXXXX-XXXXX-XXXXXXXXXXXXXXXXXXXXXXXXXXXXXXXXXXXXXXXXXXXXXXXX-XXXXXXX-X-X-XXXXXXXXXXXXXXXXXXXXXXXXXXXXXXXXXX-XXXXXXXXXXXXXXXXXXXXXXXXXXXXXXXXXXXXXXXXXXXXXXXXXXXXXXXXXXXXXXXXXXXXXXXXXXXXXXX
