--------------------------------------------------------------------------------------------------------------------------------------------------------------------------------------------------------
--------------------------------------------------------------------------------------------------------------------------------------------------------------------------------------------------------
--------------------------------------------------------------------------------------------------------------------------------------------------------------------------------------------------------
--------------------------------------------------------------------------------------------------------------------------------------------------------------------------------------------------------
--------------------------------------------------------------------------------------------------------------------------------------------------------------------------------------------------------
-S--SS-------U---------S------SU---------------S-----------------S--S-----S---S-------S-------S-------S---------S-S-S-SS-SS-S-------------------------------------------------------------------SSSSSSSS
----------------------------------------------C-------------------C---------C---------------------------------------------------------------------------------------------------------------------------
--------------------------------------------------------------------------------------------------------------------------------------------------------------------------------------------------------
--------------------------------------------------------------------------------------------------------------------------------------------------------------------------------------------------------
--------------------------------------------------------------------------------------------------------------------------------------------------------------------------------------------------------
U--S---------Ctt--------#U-UU--CS-----#-----#-S-#----#--#-#tt-----S--tt----USC-tt---S--#tttt---CttCSS---tt-----C-----S--S------------------------#--------------------------------------SSCSS-SS--------
------------#-tt-----#--#---------#--##----##---#---##--#-#tt------#-tt--------tttt----#tttt-#--tt------tt----------------------#-tt---#---------#----#------#-------------------------#----------------
--#-------#-#-tt-tt#-#--#---------#-###--####---#--###--#-#tt-tt---#-tt-tt-----tttt----#tttt-#--tt------tt-tt----------------##-##tt#####--#######--#-#########--#####################-#----------------
--#-----#-#-#-tt-tt#-#k-#-----g--g######-####---#k####--###tt-tt#g-#gtt-tt-----tttt--kg#tttt-#--tt-----ktt-tt---gg-g-------g-##g##tt######-#######-k#-##########-#####################-#---------------F
%%|%%%--|%|-|%||%|||-||-|%%%%%|%%|||||||-||||%%%||||||%%|||||%||||%||||%||-%%%-||||-%|||||||-|-%||%%%%-|||%||%%%||-|%%%%%%%|%|||||||||||||-|||||||%||-||||||||||-|||||||||||||||||||||-|%%%%%%%%-------%
||||||--|||-||||||||-||-||||||||||||||||-|||||||||||||||||||||||||||||||||-|||-||||-||||||||-|-|||||||-|||||||||||-|||||||||||||||||||||||-||||||||||-||||||||||-|||||||||||||||||||||-|||||||||-------|
