--------------------------------------------------------------------------------------------------------------------------------------------------------------------------------------------------------
--------------------------------------------------------------------------------------------------------------------------------------------------------------------------------------------------------
--------------------------------------------------------------------------------------------------------------------------------------------------------------------------------------------------------
--------------------------------------------------------------------------------------------------------------------------------------------------------------------------------------------------------
--------------------------------------------------------------------------------------------------------------------------------------------------------------------------------------------------------
---BU--U------------BB-----B---------U---B---U--B---B---BB--------BB-----------U------BBU-------------U-----U---------------------------U---------------B-----------------------------------------------
------------------------------C---------C-------------------------------CC------------------------------------------------------------------------------------------------------------------------------
--------------------------------------------------------------------------------------------------------------------------------------------------------------------------------------------------------
--------------------------------------------------------------------------------------------------------------------------------------------------------------------------------------------------------
--------------------------------------------------------------------------------------------------------------------------------------------------------------------------------------------------------
--#-C--C#B---#--U-tt---U#----CB---#C-C-CB--CBCBC-------B-------------CC-BBC----C---B-#--C---##---#-CC-C-CCCCCtt-CUCCCCCCU-UUCCCCCUCCCCC-C-CCCCUCCCCUCCCC--CCUCCCCCCUCCCCUCCCCCUCCCC-CCCUCCCCCCCCCCCCCCCC
--#-----#---##---#tt----#--------##---------------tt---------#---------------tt---#--#------##---#-----------tt-----------------------------------------------------------------------------------------
--#-----#--###---#tt----#-------###-------#-------tt-------#-#--tt-----------tt-tt#--#------##tt-#-----------tt-----------------------------------------------------------------------------------------
k-#-----#-####-g-#tt--k-#k-g---####------g#-------tt-#k---g#-#-ktt-----g----ktt-tt#-k#---gk-##ttk#-----------ttg---------k-------------------------------k-------------------------g-------------------F
XXX-XXXXXXXXXX-XXXXX--XXXXXXXXXXXXXXXXXXXXXXXXXX-XXXXXXX--XX-XXXXXXXXXXXXXXXXXXXXXXXXXX-XXXXXXXXXXXXXXXXXXXXXXXXXXXXXXXXXXXXXXXXXXXXXXXXXXXXXXXXXXXXXXXX-XXXXXXXXXXXXXXXXXXXXXXXXXXXXXXXXXXXXXXXXXXXXXXX
XXX-XXXXXXXXXX-XXXXX--XXXXXXXXXXXXXXXXXXXXXXXXXX-XXXXXXX--XX-XXXXXXXXXXXXXXXXXXXXXXXXXX-XXXXXXXXXXXXXXXXXXXXXXXXXXXXXXXXXXXXXXXXXXXXXXXXXXXXXXXXXXXXXXXX-XXXXXXXXXXXXXXXXXXXXXXXXXXXXXXXXXXXXXXXXXXXXXXX
