--------------------------------------------------------------------------------------------------------------------------------------------------------------------------------------------------------
--------------------------------------------------------------------------------------------------------------------------------------------------------------------------------------------------------
--------------------------------------------------------------------------------------------------------------------------------------------------------------------------------------------------------
--------------------------------------------------------------------------------------------------------------------------------------------------------------------------------------------------------
--------------------------------------------------------------------------------------------------------------------------------------------------------------------------------------------------------
--BBBB---------B------B--U--------U--B---B--------------B--B-------U---B----------BB-----U------U-B--U----B--B---U---BB------B--U--------B-----U---U----------------------------------------------------
--------------------C-----C---C------------------------C--C---------------------------------------------------------------------------------------------------------------------------------------------
--------------------------------------------------------------------------------------------------------------------------------------------------------------------------------------------------------
--------------------------------------------------------------------------------------------------------------------------------------------------------------------------------------------------------
--------------------------------------------------------------------------------------------------------------------------------------------------------------------------------------------------------
UB----tt----------B-B----CBB--B#--C#------B-C-#----Ctt-B-CB--tt--C-C-C--B-----------tt---C---tt-CB-C-C-C---tt-CC-C-CB---#CCU--#-C--C---------CBCBC-C---tttttttttttttttttttttttttttttttttttttttttttttttt-
------tt----#------------------#---#----------#-----tt-------tt------------tt-------tt-------tt------------tt-----------#-----##----tt-----------------tttttttttttttttttttttttttttttttttttttttttttttttt-
------tt#-#-##-------#---------#---#----------#--tt-tt-------tt----------tttt-#-##--tt-tt-tt-tt------------tt-----------#-----##----tt-----tt----------tttttttttttttttttttttttttttttttttttttttttttttttt-
----g-tt###-###------#--g----g-#-g-#----gg-g--#g-tt-ttk-g---gttgg--------tttt-#-##-gttktt-tt#tt----------kgtt----------##---gg##-gg-ttgk-g-tt-------#--ttttttttttttttttttttttttttttttttttttttttttttttttF
XXXXXXXXXXX-XXX-XXXXXXXXXXXXXXXXXXXX--XXXXXXXXXXXXXXXXXXXXX-XXXXXXXXXX-XXXXXX-XXXX-XXXXXXXXXXXXXXX-XXXXXXXXXX-XXXXXXX--XXXXXXXXXXXXXXXXXXXXXXXXXXXXXXXXXXXXXXXXXXXXXXXXXXXXXXXXXXXXXXXXXXXXXXXXXXXXXXXXX
XXXXXXXXXXX-XXX-XXXXXXXXXXXXXXXXXXXX--XXXXXXXXXXXXXXXXXXXXX-XXXXXXXXXX-XXXXXX-XXXX-XXXXXXXXXXXXXXX-XXXXXXXXXX-XXXXXXX--XXXXXXXXXXXXXXXXXXXXXXXXXXXXXXXXXXXXXXXXXXXXXXXXXXXXXXXXXXXXXXXXXXXXXXXXXXXXXXXXX
