--------------------------------------------------------------------------------------------------------------------------------------------------------------------------------------------------------
--------------------------------------------------------------------------------------------------------------------------------------------------------------------------------------------------------
--------------------------------------------------------------------------------------------------------------------------------------------------------------------------------------------------------
--------------------------------------------------------------------------------------------------------------------------------------------------------------------------------------------------------
--------------------------------------------------------------------------------------------------------------------------------------------------------------------------------------------------------
-B-B-B--BB--BB---B-------------------------B---------------B----------U---------------B----------B-------B----------B--------------U---B-------------B--------B--B-BBBB-----------B-------U-U-U-UUUUUUUU
----------------C-------------C------C-----------C---C-----------------------------------------------------------C-C-------------------------------------------------------C----------------------------
--------------------------------------------------------------------------------------------------------------------------------------------------------------------------------------------------------
--------------------------------------------------------------------------------------------------------------------------------------------------------------------------------------------------------
--------------------------------------------------------------------------------------------------------------------------------------------------------------------------------------------------------
--#-U-tt------U-B-B---UU-B----B------B--------BC-BUB-B--#-------------C-C--UB-----#B---#----#--B--CBB-#-C-----##-B-B--#C--tt-------C--#-UU-U--U-#tt----------U----B----Utt-B---ttC-tt-B--CCCCCCCCCCCCCCC
--#---tt------------------------------#-----------------#---#--------#-------#--#-#----#----#---------#---tt#-##--#---#---tt---#------#---------#tt---------#--tt-------tt-----tt--tt--tt---------------
--#---tt--tt--------------------------#-----------------#---#--tt-#-##---##--#-##-#----#----#---------#---tt#-##--#---#---tt-tt##-----#---------#tt---#--tt-#--tt-------tt-----tt--tt--tt---------------
--#g--tt--tt---#---g------#g-g-----gk-#-ggg-k-----------#k-g#-#tt-####---##--####g#-k-g#g---#-g--g----#---tt#g###-#-g-#---tt-tt###g--##---#-gk--#ttg-g#-kttg#--ttg----g-tt--#g-tt--ttg-tt--------------F
XXXXXXXX--XX--XXXXXXXXXXXXXXXXXXXXXXXXXXXXXXX-XXXXXXXXXXXX-XXXXXXXXXXXXXXXXXXXXXXXXXX-XXX-XXX-XXXXXXXXXXX-XXXXXXXXXXXXXXXXXXXXXXXXXX-XXXXXXXXXXXXXXX-XXXXXXXXXXXXXXXXXXXXXXXXXXXXX-XXXXXXXXXXXXXXXXXXXXX
XXXXXXXX--XX--XXXXXXXXXXXXXXXXXXXXXXXXXXXXXXX-XXXXXXXXXXXX-XXXXXXXXXXXXXXXXXXXXXXXXXX-XXX-XXX-XXXXXXXXXXX-XXXXXXXXXXXXXXXXXXXXXXXXXX-XXXXXXXXXXXXXXX-XXXXXXXXXXXXXXXXXXXXXXXXXXXXX-XXXXXXXXXXXXXXXXXXXXX
