--------------------------------------------------------------------------------------------------------------------------------------------------------------------------------------------------------
--------------------------------------------------------------------------------------------------------------------------------------------------------------------------------------------------------
--------------------------------------------------------------------------------------------------------------------------------------------------------------------------------------------------------
--------------------------------------------------------------------------------------------------------------------------------------------------------------------------------------------------------
--------------------------------------------------------------------------------------------------------------------------------------------------------------------------------------------------------
---U--B----------BBB-------B-------UU--B----BBBU-----B---------B------------U--------------B-----U-U------------------------B----B-B-----BB-BBUU--BBB---------------------------------------------------
-------C----C----------------------------------------------------C----C-----------------------C--------------------------------C------------------------------------------------------------------------
--------------------------------------------------------------------------------------------------------------------------------------------------------------------------------------------------------
--------------------------------------------------------------------------------------------------------------------------------------------------------------------------------------------------------
--------------------------------------------------------------------------------------------------------------------------------------------------------------------------------------------------------
tt-Ctt-B--#-Btt-B---tttt-U#-C---B--CCC---------C-UCU--tt--tt-----B--#-BU----C-C-------tt--U-B-B#-C-C---#----BU----#----------C-B------BB------CC-----tt--tt---------------------------------------------
tt--tt----#--tt-----tttt--#-----------#--#----------#-tt--tt------tt#-----------------tt-----#-#------###------tt-#----#------------------------tt---tt--tt---#-###-####################################
tt--tt----#--tt-----tttt--#--tt--tt---#--#-#--------#-tt--tt------tt#----tt-----#tttt#tt-----#-#-----#####-----tt-#--#-#tt----------tt-----#----tt---tt--tt-#-#-###-####################################
tt--ttg-g-#--ttg----tttt--#--tt#-tt---#-k#-#--g-k---#-tt--tt-g----tt#---#tt-----#tttt#ttg----#-#----#######----ttk##-#-#tt-k----g---tt----g#g---tt---tt-ktt-#-#-###g###################################F
XXXXXXXXXXXXXXXXX---XXXX-XX-XXXXXXXXXXX-XXXX-XXXXXXXXXXXXXXXXX-XXXXXXXXXXXXXXXX-XXXXXXXXXXXXXXXXXXXXXXXXXXXXXXXXXXXX-X-XXXXXXXXXX---XXXXXXXXX-XXXX--XXXXXXX-X-X-XXXXXXXXXXXXXXXXXXXXXXXXXXXXXXXXXXXXXXXX
XXXXXXXXXXXXXXXXX---XXXX-XX-XXXXXXXXXXX-XXXX-XXXXXXXXXXXXXXXXX-XXXXXXXXXXXXXXXX-XXXXXXXXXXXXXXXXXXXXXXXXXXXXXXXXXXXX-X-XXXXXXXXXX---XXXXXXXXX-XXXX--XXXXXXX-X-X-XXXXXXXXXXXXXXXXXXXXXXXXXXXXXXXXXXXXXXXX
