--------------------------------------------------------------------------------------------------------------------------------------------------------------------------------------------------------
--------------------------------------------------------------------------------------------------------------------------------------------------------------------------------------------------------
--------------------------------------------------------------------------------------------------------------------------------------------------------------------------------------------------------
--------------------------------------------------------------------------------------------------------------------------------------------------------------------------------------------------------
--------------------------------------------------------------------------------------------------------------------------------------------------------------------------------------------------------
BB---U--U--BB-------------------------------B-----B----U-----U-----------U---B----B-------BB-----B-----------UB---U---------------BB------B-----B-------------------BB--------B--B-BU---UU--------------
---------C----------------C---------------------C----------------------------------------------C----------------------------------------------------------------------------C---C-----------------------
--------------------------------------------------------------------------------------------------------------------------------------------------------------------------------------------------------
--------------------------------------------------------------------------------------------------------------------------------------------------------------------------------------------------------
--------------------------------------------------------------------------------------------------------------------------------------------------------------------------------------------------------
---C-C-CCB-----tt----B----B#---B---B--U-------#-B#-----C----BC--------C--CB-------------C-----CBB-tt-----tt--C-#--C---C--#-#B-----------B-----UB--------tt--#-----tt--------BC--B---C---CC-------tt-----
--#-----------#tt-------#--#-----tt----#tt----#--#------#----------#----------tt----tt------#-----tt-----tt----#-#--tt-#-#-#----------------------#-----tt--#-----tt------#----------------------tt-----
--#-----------#tttt-----#--#-tt--tt----#tttt--##-#------#tt---#--#-#----------tt----tt------#-----tt-tt--tt----###--tt-#-#-#-tt------------tt-----#---tttt#-#---#-tt------#---------------#--tt--tt-----
g-#-------#gg-#tttt#---k#--#ktt-#tt----#tttt--##-#-ggg--#ttg--##-#-#---------gttkg--ttkg-#-g#g----tt-tt-gttg---###--tt-#k#-#-ttkkg--kk---g-tt----##kkgtttt###g#-#-tt-gg#g-#---gk--g--g##--#--ttg-tt----F
XXXXXXXXXXXXXXXXXXXXXX-XXXXXXXXXXXXXXXXXXXXXXXXXXX-XXXXXXXXXXXXX-X-XX-XXXXXXXXXXXXX-XXXXXX-XXXXXX-XXXXXXXXXXXX-XXXXXXXXXXXXXXXXXXX--XXXXXXXXXXXX-XXXXXXXXXXXXXX-XXXX-XXXXXXXXXXXX-XXXXXXXXXXXXXXXXX-----
XXXXXXXXXXXXXXXXXXXXXX-XXXXXXXXXXXXXXXXXXXXXXXXXXX-XXXXXXXXXXXXX-X-XX-XXXXXXXXXXXXX-XXXXXX-XXXXXX-XXXXXXXXXXXX-XXXXXXXXXXXXXXXXXXX--XXXXXXXXXXXX-XXXXXXXXXXXXXX-XXXX-XXXXXXXXXXXX-XXXXXXXXXXXXXXXXX-----
