--------------------------------------------------------------------------------------------------------------------------------------------------------------------------------------------------------
--------------------------------------------------------------------------------------------------------------------------------------------------------------------------------------------------------
--------------------------------------------------------------------------------------------------------------------------------------------------------------------------------------------------------
--------------------------------------------------------------------------------------------------------------------------------------------------------------------------------------------------------
--------------------------------------------------------------------------------------------------------------------------------------------------------------------------------------------------------
-S--SU--------S-------S----------US-S--------------------------U-S---SSS---SU------S-S----------U------U--S-----SS-S-----SSS-SSS--SSS-SSS-SSS-SSS-SS-SS--SSS---SSS-S--S-SSS-SSSS--SSS-SSS-SSSSS-SSSSSSSS
---------C----------------------------------------------------------------------------------------------------------------------------------------------------------------------------------------------
--------------------------------------------------------------------------------------------------------------------------------------------------------------------------------------------------------
--------------------------------------------------------------------------------------------------------------------------------------------------------------------------------------------------------
--------------------------------------------------------------------------------------------------------------------------------------------------------------------------------------------------------
---#-CttCS------C-S----U------ttUC-#------------------tt---CU--C----S-------CC--------S--------#C-#--#UC----S-----------S---S--------S---S---S---S--S---------------tt-S---S-----S---S---S-----S--------
---#--tt--tt---#---#----------tt---#---#tt------------tt-#-----------------------------#-------#-##--#--tt----------------------tt---------------------tt-----------tt----------------------------------
---#--tt--tttt-#---##-----tt--tt---#-#-#tt---tt-------tt-#---------------------tt------##--#tt-#-##--#--tt-----#----#-----------tt---------------------tt----tt-----tt----------------------------------
-g-#--tt--ttttg#---###---kttg-tt---#-#-#tt##gtt-------tt-#---k-----------kg---gtt---g--###-#tt-#-##--#--tt-g-#-#g---#-----------tt---------------------tt----tt---k-tt---------------------------------F
%|%|%%||%%||||||%%%|||%%-||||%||%%%|-|-||||||||%%%-%%%||%|%%%|%%%%%%%%%--||%%%|||-%-|-%|||-|||%|%||%%|%%||-|%|-||%%-|%%%%---%---||---%---%---%--%%--%--||---%||---|-||-%---%----%%---%---%-----%-------%
||||||||||||||||||||||||-|||||||||||-|-|||||||||||-||||||||||||||||||||--||||||||-|-|-||||-|||||||||||||||-|||-||||-|||||---|---||---|---|---|--||--|--||---|||---|-||-|---|----||---|---|-----|-------|
