--------------------------------------------------------------------------------------------------------------------------------------------------------------------------------------------------------
--------------------------------------------------------------------------------------------------------------------------------------------------------------------------------------------------------
--------------------------------------------------------------------------------------------------------------------------------------------------------------------------------------------------------
--------------------------------------------------------------------------------------------------------------------------------------------------------------------------------------------------------
--------------------------------------------------------------------------------------------------------------------------------------------------------------------------------------------------------
------S----------S------S------------U------SS-S------SS-U---------S--S----S--SS--S----------------------S-----------S----------U--U------SS----SS------S--S--U-------UUUUUUUUUUU--UUUUUUUUUUUUUUUUUUUUU
----------------------C------------C------------------------C-----------------------------------------------------C-------------------------------------------------------------------------------------
--------------------------------------------------------------------------------------------------------------------------------------------------------------------------------------------------------
--------------------------------------------------------------------------------------------------------------------------------------------------------------------------------------------------------
--------------------------------------------------------------------------------------------------------------------------------------------------------------------------------------------------------
S---------S---tt----S-S--UU#C----S-S-CttC-#S-----S--#----C--Stt--U---U---tt-tt-------------C------#--#---------#--S---#---##-CCSCSCC---U-#--UU-#-----#---#S---CU------CCCCCCCCCCC--CCCCCCCCCCCCCCCCCCCCC
----tt--#----#tt-----------#--#-------tt--#--------###-------tt-----#----tt-tt--------------------#--#--------##------#---##---------#---#-----#--tt-#tt-#--#-----tt-------------tt---------------------
----tt--#----#tt-----------#--##------tt--#-------####-------tt-----#----tt-tt--tt-tt-------tt--tt#--#-------###tt----#-tt##---------#---#-----#--tt-#tt-#--#-----tt-------------tt---------------------
--g-ttgg#----#tt---g---k---#-g###---g-tt--#-------####----#g-tt---kg#----tt-tt--tt-tt---k---tt--tt#--##g#--g####tt-#--##tt##--------##k--#g----#--tt-#ttg#--#g--k-tt-g-----------tt--------------------F
%%|%|||||%%%%|||%%%|%%%|%%%|%||||%%%|%||%%|%--%-%%||||-%%%||%||%%%|||%%--||%||-%||-||%%%|-%%||%%|||%%||||%%|||||||%|%%||||||%%%%%%%%|||%%||-%%%|%-||%|||||%%||%%|%||%|%%%%%%%%%%%||%%%%%%%%%%%%%%%%%%%%%
||||||||||||||||||||||||||||||||||||||||||||--|-||||||-||||||||||||||||--|||||-|||-||||||-|||||||||||||||||||||||||||||||||||||||||||||||||-|||||-||||||||||||||||||||||||||||||||||||||||||||||||||||||
