--------------------------------------------------------------------------------------------------------------------------------------------------------------------------------------------------------
--------------------------------------------------------------------------------------------------------------------------------------------------------------------------------------------------------
--------------------------------------------------------------------------------------------------------------------------------------------------------------------------------------------------------
--------------------------------------------------------------------------------------------------------------------------------------------------------------------------------------------------------
--------------------------------------------------------------------------------------------------------------------------------------------------------------------------------------------------------
---------B--BB-----------------BB--B-------------------------------------BB------B----------B-B-----U-----------------------BB----U-------U------------BB------------BBBBBBBBBB-BBBBBBBBBB-BBBBBBBBBBBBB
C----------------------------------------------------------------------------------------------------------------------C------------------------------------------------------------------C-------------
--------------------------------------------------------------------------------------------------------------------------------------------------------------------------------------------------------
--------------------------------------------------------------------------------------------------------------------------------------------------------------------------------------------------------
--------------------------------------------------------------------------------------------------------------------------------------------------------------------------------------------------------
B-B-tttt---U---------------#-UB--------B-CttB---C-tt---U---Ctt---#--#---B--tt---U--tt--U--#--#--ttC-C-C----B-C----U----B--#-------C------CC------#-------Utt-UU--UUUU----------#----------B-------------
----tttt-------------tt---##--------------tt--tt--tt--------tt--##--#------tt------tt-----#--#--tt--------#----tt--------##---------tt---------#-##--tt---tt-------------------#------------------------
-#--tttt-------------tt#-###------------#-tt--tt-#tt--#---#-tt-###--#------tt-tt---tt-----#--#-#tt--------#----tt--tt---###--------#tt--#-----##-###-tt---tt----#--------------#------------------------
-#-#tttt#------------tt#####------kgkgg-#-tt--tt-#tt#-#-#-#-tt####--#-k----tt-tt--kttg---##k-#-#tt-----g--#-g--tt--ttk--###--------#ttg-#----###g####tt---tt---g#----gggggggggg#gggggggggg-ggggggggggggF
XXXXXXXXXXXXXX-X-XXXXXXXXXXX-XXXXXXXXXXXXXXXXXXXXXXXX-XXX-XXXXXXXXXXXXXXX--XXXXXX-XXXXXXXXXXXXXXXXXXXXXXXXXXXX-XXXXXXX-XXXXX--X-X-XXXXXXXXXXXXXXXXXXXXXXXXXXXXXXXXXXXXXXXXXXXXXXXXXXXXXXXXXXXXXXXXXXXXXX
XXXXXXXXXXXXXX-X-XXXXXXXXXXX-XXXXXXXXXXXXXXXXXXXXXXXX-XXX-XXXXXXXXXXXXXXX--XXXXXX-XXXXXXXXXXXXXXXXXXXXXXXXXXXX-XXXXXXX-XXXXX--X-X-XXXXXXXXXXXXXXXXXXXXXXXXXXXXXXXXXXXXXXXXXXXXXXXXXXXXXXXXXXXXXXXXXXXXXX
