--------------------------------------------------------------------------------------------------------------------------------------------------------------------------------------------------------
--------------------------------------------------------------------------------------------------------------------------------------------------------------------------------------------------------
--------------------------------------------------------------------------------------------------------------------------------------------------------------------------------------------------------
--------------------------------------------------------------------------------------------------------------------------------------------------------------------------------------------------------
--------------------------------------------------------------------------------------------------------------------------------------------------------------------------------------------------------
---U---BB-B----------------------B-----U---U------------BU------B----B---BB---U-B-----------------------------------------------------------------------------------B-BB-BBB-BB-BB-BB-BBBB-BBBB--BBBBBBB
----------------------------------------------------C-------------------------------------------C-------------------------------------------------------------------------------------------------------
--------------------------------------------------------------------------------------------------------------------------------------------------------------------------------------------------------
--------------------------------------------------------------------------------------------------------------------------------------------------------------------------------------------------------
--------------------------------------------------------------------------------------------------------------------------------------------------------------------------------------------------------
UC-C--B----------C-#-----------#---CBB-C-C-C-C---UttB----CB--UC---------------C--tt-----CB---BCUB--------------------------------------------------------------------B---------B--B--B----B-------------
-----------#---tt--#----------##------------------tt---#---tt--------------------tt------------------------------------------------------------------------------------------------------------tt-------
-----------##--tt--#--#---#--###------------------tt-tt#---tt--#--------#--------tt-tt----#------#---------------------------------------------------------------------------------------------tt-------
-----------###gtt-###-#-#-#k####--g-------------g-tt-tt#g--tt--#---kg-#-#-gg----gtt-tt-g--#g-----#----g----------------------------------------------------------------------------------------tt------F
XXXXXXXXX-XXXXXXXXXXX-XXX-XXXXXXXXXXXXXXXXXXXXXXXXXXXXXXXXXXXXXXXXXXX-X-XXXXXXXXXXXXXX-XXXXXXXXXXXX-XXXX-XXXX-XX-XXXX-XXX-XX-XX-XX-XXX-XXXX-XXX-XX-XX-XX-XX-XXXX-XXXXX--X---X--X--X--X----X----XX-------
XXXXXXXXX-XXXXXXXXXXX-XXX-XXXXXXXXXXXXXXXXXXXXXXXXXXXXXXXXXXXXXXXXXXX-X-XXXXXXXXXXXXXX-XXXXXXXXXXXX-XXXX-XXXX-XX-XXXX-XXX-XX-XX-XX-XXX-XXXX-XXX-XX-XX-XX-XX-XXXX-XXXXX--X---X--X--X--X----X----XX-------
