--------------------------------------------------------------------------------------------------------------------------------------------------------------------------------------------------------
--------------------------------------------------------------------------------------------------------------------------------------------------------------------------------------------------------
--------------------------------------------------------------------------------------------------------------------------------------------------------------------------------------------------------
--------------------------------------------------------------------------------------------------------------------------------------------------------------------------------------------------------
--------------------------------------------------------------------------------------------------------------------------------------------------------------------------------------------------------
-BB-----B-----B-----B---------BBB-U---B--------------B----------B-------B--------------B----------------------------UB--UBB-----------U--B-B----U-----B-------B-UU-B---B-----------B---------B-BBB-BBBBB
----------------------C----------C---------------CCCC--------------------------------------C-----------------------------------------------------------C------------------------------------------------
--------------------------------------------------------------------------------------------------------------------------------------------------------------------------------------------------------
--------------------------------------------------------------------------------------------------------------------------------------------------------------------------------------------------------
--------------------------------------------------------------------------------------------------------------------------------------------------------------------------------------------------------
B------#-#tt-C--------BC#U-------BCCUU--B--tt----BBBB-C-CC---------U-----U--B---#-C------U-B----#-tt---C-----C--#---C--BC--U----B-#---C-----ttU-CC-----B----C---CC--tt--##----B-----B--UCCCC--B---B-----
------##-#tt------------#-tt---------------tt----------------tt-----tt--------#-#--tt-----------#-tt------------#-------------tt--#tt#------tt-----tt---#-----------tt--###-----------------------------
-----###-#tt----tt------#-tttt-------------tt-------------#--tt-----tt--------#-#--tt-----------#-tt-tt--tt-----##----#-------tt-##tt#------tt-----tt---##----------tt--###tt---------------#-----------
---#-###-#ttk--gtt------#-ttttg-g----------tt#kkg------k--#-#ttggg#-tt----kk--#-#--tt-#---k---#-#-tt-tt--tt#--g-##gg-g#--g--kktt-##tt#------tt----gttk--###--#-g----tt#-###ttk-------##-----#----------F
XXXX-XXX-XXXXX-XXX-X-XXXXXXXXXX-XXXXXXXXXXXXXXXXXXXXX-XXXXXXXXXXXXXXXXXX-XXXXXXXXXXXX-XXXXXXX-XXXXXXXXXXXXXXXXX-XXXXXXXXXXXXXXXXXXXXXXXXX-XXXXX-XXXXXX-XXXXXXX-XXXXXXXX-XXXXXXXXXXXXXXXXXXXXXXXXXXXXXXXX
XXXX-XXX-XXXXX-XXX-X-XXXXXXXXXX-XXXXXXXXXXXXXXXXXXXXX-XXXXXXXXXXXXXXXXXX-XXXXXXXXXXXX-XXXXXXX-XXXXXXXXXXXXXXXXX-XXXXXXXXXXXXXXXXXXXXXXXXX-XXXXX-XXXXXX-XXXXXXX-XXXXXXXX-XXXXXXXXXXXXXXXXXXXXXXXXXXXXXXXX
