--------------------------------------------------------------------------------------------------------------------------------------------------------------------------------------------------------
--------------------------------------------------------------------------------------------------------------------------------------------------------------------------------------------------------
--------------------------------------------------------------------------------------------------------------------------------------------------------------------------------------------------------
--------------------------------------------------------------------------------------------------------------------------------------------------------------------------------------------------------
--------------------------------------------------------------------------------------------------------------------------------------------------------------------------------------------------------
----B------U-B--------B--------------B----U-BU---------------BB----BB----------------B---------------U---U--------------B-BB-----------------------U--------------------B-------------------------------
------------------------------C--------------------------------------------------------C----------C---------------------------------------C-----------------------C---CC--------------------------------
--------------------------------------------------------------------------------------------------------------------------------------------------------------------------------------------------------
--------------------------------------------------------------------------------------------------------------------------------------------------------------------------------------------------------
--------------------------------------------------------------------------------------------------------------------------------------------------------------------------------------------------------
C----------C------------tt----B##-UU------C--C----B----U----C---------------#---tt-B---Btttt-----BBC-C-C-C-----Btt-U-B---B----U-----------B--U-C---C---C---#-----CB---BB--------------------------------
--------------#---------tt-----##---------------tt-------tt-----------------#---tt------tttt--tt--------------#-tt--#--------------------#-------tt--tt-#--#-#--#---------------------------------------
---#------#---#-tt#-----tt-tt--##---------------tt-tt----tt-------#--tt-----#---tt------tttt#-tt-----------#--#-tt--#-------tt-----------#-------tt--tt-#--#-##-#---------------------------------------
-#-#------#--g#-tt#--g-#tt-ttg-##-----g-g------gtt-tt---gtt#------#ggttgk-g-#k-ktt---gg-tttt##ttg-------g-##g-#-ttg-#--g----tt--------#--#----g--tt--tt-#--#-##-#--#---------g-------------------------F
XX-XXX-XXXXXXXXXXXXXXXXXXXXXXXXXXXXXX-XXXXX-XX-XXXXXXXXXXXXXX---XXXXXXXXXXXXXXXXXXXXXXXXXXXXXXXXXXXXXXXXXXXXXXXXXXXXXXXXXXXXXXXXX-XXXXXX-XXXXXXXXXXXXXXXXXXXXXX-XXXXXXXX-XXXXXXXXXXXXXXXXXXXXXXXXXXXXXXX
XX-XXX-XXXXXXXXXXXXXXXXXXXXXXXXXXXXXX-XXXXX-XX-XXXXXXXXXXXXXX---XXXXXXXXXXXXXXXXXXXXXXXXXXXXXXXXXXXXXXXXXXXXXXXXXXXXXXXXXXXXXXXXX-XXXXXX-XXXXXXXXXXXXXXXXXXXXXX-XXXXXXXX-XXXXXXXXXXXXXXXXXXXXXXXXXXXXXXX
