--------------------------------------------------------------------------------------------------------------------------------------------------------------------------------------------------------
--------------------------------------------------------------------------------------------------------------------------------------------------------------------------------------------------------
--------------------------------------------------------------------------------------------------------------------------------------------------------------------------------------------------------
--------------------------------------------------------------------------------------------------------------------------------------------------------------------------------------------------------
--------------------------------------------------------------------------------------------------------------------------------------------------------------------------------------------------------
-------------U------------------------U-------------------------U-------U--U--BBB--B-B--B--------U--------U---U---U---U---------------------------------------------------------------------------------
-------------------------------------------------C-C-C-C-C-C---C----------------------------------------------------------------------------------------------------------------------------------------
--------------------------------------------------------------------------------------------------------------------------------------------------------------------------------------------------------
--------------------------------------------------------------------------------------------------------------------------------------------------------------------------------------------------------
--------------------------------------------------------------------------------------------------------------------------------------------------------------------------------------------------------
U---U-tt-----C-#U--C--#-CCBCU-U-------C----CC-#-BBBBBBBBBBBBB--BCU#-----C-UC-B----U-C-C--------C-C-C----C-C-C-C-C-C-C-C---------------------------------------------------------------------------------
------tt--#----#-----##-------------tt--tt----#-------------------#----------------------tt--------------------------------------------------------------------------------------------------#----------
------tt--#----#-tt-###------#-#----tt--tt----#-------------------#tt--------------------tt--tt----------------------------------------------------------------------------------------------#----------
-----ktt--#g--g#-tt-###------#-#--#gtt--tt----#k------------------#tt-k------------------tt--tt----------------------------------------------------------------------------------------------#---------F
X-X-XXXX-XXXXXXXXXXXXXXXXXXXXXXXXXXXXXXXXXXXXXXXXXXXXXXXXXXXXXXXXXXXX-XXXXXXXX----X-X-XXXXXXXXXXXXXXX-XXXXXXXXXXXXXXXXXXX-XX-XXXX-XX-XX-XXX-XXX-XXXX-XX-XXX-XX-XX-XX-XX-XX-XX-XXXX-XX-XXX-XXXXX-XXX-XXXX
X-X-XXXX-XXXXXXXXXXXXXXXXXXXXXXXXXXXXXXXXXXXXXXXXXXXXXXXXXXXXXXXXXXXX-XXXXXXXX----X-X-XXXXXXXXXXXXXXX-XXXXXXXXXXXXXXXXXXX-XX-XXXX-XX-XX-XXX-XXX-XXXX-XX-XXX-XX-XX-XX-XX-XX-XX-XXXX-XX-XXX-XXXXX-XXX-XXXX
