--------------------------------------------------------------------------------------------------------------------------------------------------------------------------------------------------------
--------------------------------------------------------------------------------------------------------------------------------------------------------------------------------------------------------
--------------------------------------------------------------------------------------------------------------------------------------------------------------------------------------------------------
--------------------------------------------------------------------------------------------------------------------------------------------------------------------------------------------------------
--------------------------------------------------------------------------------------------------------------------------------------------------------------------------------------------------------
U--------------B------------B-----BU---BBU---------U--BB-B------B--U-------U-----------------BB--------------------------------U---------------B--U-UU--U------B---U------------------------------------
-----------------------------------------------------------------------------------C--------------------------------------------------------------------------------------------------------------------
--------------------------------------------------------------------------------------------------------------------------------------------------------------------------------------------------------
--------------------------------------------------------------------------------------------------------------------------------------------------------------------------------------------------------
--------------------------------------------------------------------------------------------------------------------------------------------------------------------------------------------------------
CBU----#U--------tt#-CCC-#tt-BB----C--B--C--B--ttC#C---------tt----C-----UBC---U#--B--tt#----------#---U--C---B---B------------C-----#--tt-U----B-C-CC--C----#----BC-#----------------------------------
---tt--#----tt---tt#-----#tt--------tt---------tt-#-------tt-tt--tt-#-----------#tt---tt#-#-------##-tt-------------#-----------tt--##tttt-------------------#-------#----------------------------------
---tt--#----tt---tt#-----#tt--------tt----tt---tt-#-------tt-tt--tt-#tt---------#tt-tttt#-##-----###-tt------#-tt---##-----tt---tt-###tttt--tt---------------#--#----#----------------------------------
---tt-g#--#-tt-g#tt#-----#tt----gk--tt----tt---tt-#-g#-gkgtt-tt-gtt-#ttk----g---#tt-tttt#k###---####gtt-#g-#-#-tt---###g-g-tt-k-tt-###tttt--ttgg---g--gg-#-g-#g-#k---#--kg-----------------------------F
XXXXX-XXXXXXXXXXXXXXXXXXXXXX-XXXXX-XXXX--XXXX--XXXXXXX-XXXXXXXX-XXXXXXXX-XXXXX-XXXXXXXXXXXXXXX-XXXXXXXXXXXXX-XXXXXXXXXXX-X-XX-XXXX-XXXXXXXXXXXXXXXXXXXXXXXXXXXX-XXXXXXXXXXXXXXXXXXXXXXXXXXXXXXXXXXXXXXXX
XXXXX-XXXXXXXXXXXXXXXXXXXXXX-XXXXX-XXXX--XXXX--XXXXXXX-XXXXXXXX-XXXXXXXX-XXXXX-XXXXXXXXXXXXXXX-XXXXXXXXXXXXX-XXXXXXXXXXX-X-XX-XXXX-XXXXXXXXXXXXXXXXXXXXXXXXXXXX-XXXXXXXXXXXXXXXXXXXXXXXXXXXXXXXXXXXXXXXX
