--------------------------------------------------------------------------------------------------------------------------------------------------------------------------------------------------------
--------------------------------------------------------------------------------------------------------------------------------------------------------------------------------------------------------
--------------------------------------------------------------------------------------------------------------------------------------------------------------------------------------------------------
--------------------------------------------------------------------------------------------------------------------------------------------------------------------------------------------------------
--------------------------------------------------------------------------------------------------------------------------------------------------------------------------------------------------------
-----US--S--------S-----------S-----S----------------U---S--U-S-----U-------U-U----------------------------------------U---U--S----U----------US---S--S--U----------------------------------------------
-------------------------------C------------------------C---------------------------------------------------------------------------------C------------------------C-----------C------------------------
--------------------------------------------------------------------------------------------------------------------------------------------------------------------------------------------------------
--------------------------------------------------------------------------------------------------------------------------------------------------------------------------------------------------------
--------------------------------------------------------------------------------------------------------------------------------------------------------------------------------------------------------
##tt-C--U--U--------tt-tt--U---S-S-----C------#tt--C-C-CS---C---tt--C----#--C-C----U#------CS--#UUtt--------U-C----#UC-C-C-C-----U-C------SC-CC----------C---------S----------#S-C----------------------
##tt------#-----#---tt-tt---------tt------tt-##tt---------------tt-----#-#tt--------#--------tt#--tt-------------tt#------#-------#-----------------tt------tt---tt-tt--------#-------------------------
##tt------#-----#---tt-tt---------tt----tttt###tt#--------------tt-----#-#tt-----tt-#----#---tt#--tt-tt----------tt#------#-------#---#----------tt-tt----tttt-tttt-tt-tt-----#-#-----------------------
##tt------#-g--##g--ttgtt#g-----k-ttg-#-tttt###tt#-------g-g-g-#ttgg-g-#k#tt---kktt-#--gg#---tt#--tt-tt-g----#---tt#------#-g-gg--#--g#--g--g---ktt-tt----tttt-tttt-tt-ttkg-g-#-#-gggggggggggggggggggggF
||||%%-%%-|%|%-|||%%|||||||%---%|%|||%|%||||||||||%%%%%%%|%|%|-|||||%|%|||||%%%||||%|%%|||%%%|||%%||%||%|-%%%|%%%|||%%%%%%|%|-||%%|%%||%-|%%|%%%|||%||%%%%||||%||||%||-||||%|%|%|%|||||||||||||||||||||%
||||||-||-||||-|||||||||||||---|||||||||||||||||||||||||||||||-||||||||||||||||||||||||||||||||||||||||||-|||||||||||||||||||-||||||||||-|||||||||||||||||||||||||||||-|||||||||||||||||||||||||||||||||
