--------------------------------------------------------------------------------------------------------------------------------------------------------------------------------------------------------
--------------------------------------------------------------------------------------------------------------------------------------------------------------------------------------------------------
--------------------------------------------------------------------------------------------------------------------------------------------------------------------------------------------------------
--------------------------------------------------------------------------------------------------------------------------------------------------------------------------------------------------------
--------------------------------------------------------------------------------------------------------------------------------------------------------------------------------------------------------
---B--UU-------------------------B-----------------U--------B------------------BBU--------------------BB-BB------BBB-BB--BB-BB---BBBB-BB-BBBB-BB--BBB-B-BB--BB-BBB-BBB-BBBB-BBB-BBBB-BB-BBB-------------
--------------------------------------------------------------------------------------------------------------------------------------------------------------------------------------------------------
--------------------------------------------------------------------------------------------------------------------------------------------------------------------------------------------------------
--------------------------------------------------------------------------------------------------------------------------------------------------------------------------------------------------------
--------------------------------------------------------------------------------------------------------------------------------------------------------------------------------------------------------
-tt---CC-----------------U-CB---#-BUU-CBB-U-----#CBCBC-------B##-U-#-CC----tt----CB-----#---ttU------B--B------tt---B--BB--B--U-B----B--B----B--UB---B-B---B--B---B---B----B---B----B------UCCCCCCCUCCCC
-tt--------------------#-------##---------------#--------tt---##---#-----#-tt----------###--tt-tt-------------#tt----------------------------------------------------------------------#----------------
-tt-tt--------------##-#------###---------------#-----tt#tt---##---#---#-#-tttt-------#####-tt-tt--tt-------#-#tt----------------------------------------------------------------------#----------------
gttgtt-----------##-##-#g----####----#-------k--#-----tt#tt---##---#---#-#-ttttgg---#-######tt-tt--tt------k#-#tt----------------------------------------------------------------------#---------------F
XXXXXXXXXX-XX-XXXXX-XX-XXXXXXXXXX-XXXXXXXXXXXXX-XXXXXXXXXXXX-XXXXX-XXXXX-X-XXXXXXXXXX-XXXXXXXXXXXXXXXXXXXXXXX-XXXXXXXXXXXXXXXXXXXXXXXXXXXXXXXXXXXXXXXXXXXXXXXXXXXXXXXXXXXXXXXXXXXXXXXXXXXXXXXXXXXXXXXXXX
XXXXXXXXXX-XX-XXXXX-XX-XXXXXXXXXX-XXXXXXXXXXXXX-XXXXXXXXXXXX-XXXXX-XXXXX-X-XXXXXXXXXX-XXXXXXXXXXXXXXXXXXXXXXX-XXXXXXXXXXXXXXXXXXXXXXXXXXXXXXXXXXXXXXXXXXXXXXXXXXXXXXXXXXXXXXXXXXXXXXXXXXXXXXXXXXXXXXXXXX
