--------------------------------------------------------------------------------------------------------------------------------------------------------------------------------------------------------
--------------------------------------------------------------------------------------------------------------------------------------------------------------------------------------------------------
--------------------------------------------------------------------------------------------------------------------------------------------------------------------------------------------------------
--------------------------------------------------------------------------------------------------------------------------------------------------------------------------------------------------------
--------------------------------------------------------------------------------------------------------------------------------------------------------------------------------------------------------
----------------S--U------S------------S------------U------------------------S------SS-----------------------S-------S----------------------U----U-U------SS-----S--S-S-S-------------------------------
-------------------------C---------C--------C---------------------------------------------------------------------------------------------------------------C--------C----------------------------------
--------------------------------------------------------------------------------------------------------------------------------------------------------------------------------------------------------
--------------------------------------------------------------------------------------------------------------------------------------------------------------------------------------------------------
--------------------------------------------------------------------------------------------------------------------------------------------------------------------------------------------------------
tt-S-----tt-S--U---CU----S---#tt---SttC-----SS-----CC---------------------#-#-tt------------------tt---ttC--C---C-ttU-#tt-----------C----C--CCS--C-C-C-#----S-CS--#C-S------S---------------------------
tt----#--tt------#---------#-#tt----tt--tt#-------------------------tt----#-#-tt--------tt--tt----tt---tt---------tt--#tttt------#---------------------#----------#------tt-----------------------------
tt----##-tt------#----tt---#-#tt-tt-tt--tt#-----#------tttt-#tt-#tt-tttt--#-#-tt---#----tttttttt--tt-tttt---------tt--#tttt------##---tt-------tt------#----------#------tt-----------------------------
tt----###ttg----g#g--gtt---#g#tt-tt-tt--tt#---#-#k-----ttttg#tt-#ttkttttg-#-#-tt---#-g--tttttttt--tt-tttt-#---g---tt-g#tttt------###--ttg-#----tt---k--#g-gg------#------tt--####################k#####F
||%%%%||||||%%%%|||%%|||%%%|||||%||%||%%|||%%%|-||%%%-%||||||||%|||||||||%|%|-||%%%|-|-%||||||||%-||%||||%|%%-|-%%||%||||||%-%%%%|||%%|||%|%%%%||%%%|%-||%||%%%%%-|%%%-%-||%%||||||||||||||||||||||||||%
|||||||||||||||||||||||||||||||||||||||||||||||-|||||-|||||||||||||||||||||||-||||||-|-||||||||||-|||||||||||-|-||||||||||||-|||||||||||||||||||||||||-||||||||||-||||-|-|||||||||||||||||||||||||||||||
