--------------------------------------------------------------------------------------------------------------------------------------------------------------------------------------------------------
--------------------------------------------------------------------------------------------------------------------------------------------------------------------------------------------------------
--------------------------------------------------------------------------------------------------------------------------------------------------------------------------------------------------------
--------------------------------------------------------------------------------------------------------------------------------------------------------------------------------------------------------
--------------------------------------------------------------------------------------------------------------------------------------------------------------------------------------------------------
-----B-----------------------------------U----------------------------------BB-----------U------BU------BU--BB-----BUBBUB----------B----UB--B-----------------------------------------------------------
-C---------------------------------------------------------------------------------------------C---------------C--C--------------------------C----------------------------------------------------------
--------------------------------------------------------------------------------------------------------------------------------------------------------------------------------------------------------
--------------------------------------------------------------------------------------------------------------------------------------------------------------------------------------------------------
--------------------------------------------------------------------------------------------------------------------------------------------------------------------------------------------------------
-B--#-----#--#--B---------------#------#-C--ttCBB-tt-UB-C-U#---C--------UU-B--##--C-----UC-tt--B-Ctt-----C-B---B--B-C--C-tt------C------C----BU--------------------------------tt-----------------------
----#-----#--#-----------------##tt----#----tt----tt-------#tt----------------##---#-------tt-----tt---------------------tt---------tt---------#-------------------------------tt-----------------------
----#-----#--#------------tt#-###tt--tt##---tt----tt---#---#tt----tt----------##---##------tt-----tt-tt---------tt-------tt-------#-tt---------#-tttttt--tttttttttttttttttttttttttttttttttt--tttttttttt#
k-#-#--#-g#--#gg----------tt#####ttg-tt##--ktt----tt---#-g-#tt--k-ttg-kk--k---##-g-###----ktt-----tt-tt-g-g-----tt-g-----tt----#--#gtt#---kkg--#-tttttt--tttttttttttttttttttttttttttttttttt--ttttttttttF
XXXXX-XXXXXXXXXXXX-XXX-XXXXXXXXXXXXXXXXXXXXXXXXXXXXXXXXXXXXXXXXXXXXXXXXXXXXX--XXXXXXXXXXXXXXXXXXXXXXXXX-XXXX---XXXXXXX-X-XXXXXXXXXXXXXXXX-XXXXXXXXXXXXXX-XXXXXXXXXXXXXXXXXXXXXXXXXXXXXXXXXXX-XXXXXXXXXXX
XXXXX-XXXXXXXXXXXX-XXX-XXXXXXXXXXXXXXXXXXXXXXXXXXXXXXXXXXXXXXXXXXXXXXXXXXXXX--XXXXXXXXXXXXXXXXXXXXXXXXX-XXXX---XXXXXXX-X-XXXXXXXXXXXXXXXX-XXXXXXXXXXXXXX-XXXXXXXXXXXXXXXXXXXXXXXXXXXXXXXXXXX-XXXXXXXXXXX
