--------------------------------------------------------------------------------------------------------------------------------------------------------------------------------------------------------
--------------------------------------------------------------------------------------------------------------------------------------------------------------------------------------------------------
--------------------------------------------------------------------------------------------------------------------------------------------------------------------------------------------------------
--------------------------------------------------------------------------------------------------------------------------------------------------------------------------------------------------------
--------------------------------------------------------------------------------------------------------------------------------------------------------------------------------------------------------
------------S-S-S----------S----U--------SSSS----SU---S---S----S-------UU---S---------------------------U--UU--U-----------U---------------------U-----------------------------S------------------------
-----C---------------C---C-----------C----------------------CC----------------------------------C-------------------------------------C---------------------------------------C-C-----------------------
--------------------------------------------------------------------------------------------------------------------------------------------------------------------------------------------------------
--------------------------------------------------------------------------------------------------------------------------------------------------------------------------------------------------------
--------------------------------------------------------------------------------------------------------------------------------------------------------------------------------------------------------
---ttSSC------------SS---S------C--U-S--S-----CC--C----U-U--SSU--#U----CCS-#--tt---C----C-------S--SS---CS-CC--C----#---C-CC-------S--S---#----ttCtt---#C-U-#--#Utt---ttUtt-C-S-Stt---#---U-U-UUU-------
---tt-------------#--------------------#------------tt-----------#---------#--tt---------------#------------------#-#---------##----------#----tt-tt-tt#----#tt#-tt---tt-tt------tt--##-----------------
tt-tt-------------#----------tt--tt----#-----#--#---tt-----#-----#--------##--tt-tt---#--tt----#-tt-------------tt#-#-------#-##----tt--tt#---#tt-tt-tt#----#tt#-tt---tt-tt------tt-###tt---------------
ttgtt----g#kg--#-g#g------#-#ttk-tt----#-----#--#---ttg----#---g-#--#-g---##-gtt-tt-#-##-ttk--g#-tt---g---------tt#g#--k-g--#-##-kg-tt-gtt#g-k#tt-tt-tt#----#tt#-tt-g-tt-tt#-#---ttg###tt--------------F
|||||%%%%||||%-|%|||%%-%-%|%||||%||%-%-|%%%--|%%|-%%|||%%%-|%%%|%|%%|%|%%%||-|||%||%|-||%|||%%||%||%%%|-%%%%%%%%|||||%%|%|%%|-||%||%||%|||||%||||%||%|||%%%-||||%||%|%||%|||%|%-%||||||||%%%%%%%%%%%%%%%
||||||||||||||-|||||||-|-|||||||||||-|-||||--||||-||||||||-|||||||||||||||||-||||||||-|||||||||||||||||-|||||||||||||||||||||-|||||||||||||||||||||||||||||-|||||||||||||||||||-||||||||||||||||||||||||
