--------------------------------------------------------------------------------------------------------------------------------------------------------------------------------------------------------
--------------------------------------------------------------------------------------------------------------------------------------------------------------------------------------------------------
--------------------------------------------------------------------------------------------------------------------------------------------------------------------------------------------------------
--------------------------------------------------------------------------------------------------------------------------------------------------------------------------------------------------------
--------------------------------------------------------------------------------------------------------------------------------------------------------------------------------------------------------
--B----------------------------BB----B-------------B-----BB-B--BB-----BBB--U--U--B---------------U--------------B----------BB-------B--U--BU-------------------------B-----BB---BBB-BBB-BBB-BB----------
------------------------C----------------C-----------------------------------------------------------------C--------------------------------------------------------------------------------------------
--------------------------------------------------------------------------------------------------------------------------------------------------------------------------------------------------------
--------------------------------------------------------------------------------------------------------------------------------------------------------------------------------------------------------
--------------------------------------------------------------------------------------------------------------------------------------------------------------------------------------------------------
----------C-----U-------BC-U--B----------B-C------U--#tt-----------------CBCBCC----U-B-----------CCC-#---#-B#------B--BCttB--tt#------BC---C--B-#---tt----------------tttt-----B---B---B---B------------
---tt---------------#-------------------#------------#tt---#-------tt---------------------tt#--#-----#---#--#-----------tt---tt#------------tt--#---tt------tt---tt---tttt------------------------------
#--tt#-----------tt-#-tt----tt----tt----#------------#tt---#-------tt-------------#------#tt#--#-----#---#--#tt---#-tt--tt---tt#-tt------#--tt--#tt-tt------tt-##tt---tttt------------------------------
#k-tt#---k-k-g---tt-#gtt----tt---ktt---k#-----#--#-g-#tt--g#g-kgg#-tt-g--------g--#----#-#tt#-k#-----#---#--#tt#--#-tt--tt---tt#-tt------#--tt-k#ttktt------ttg##ttkg-tttt---gg---------------gggggggggF
XXXXXXXXXXXXXXX-XXXXXXXXXX-XXXXXXXXX-XXXXXXX--XXXXXX-XXXX-XXX-XXXXXXXXXX-XXXXXXXX-XXXX-X-XXXX-XX-XXXXXXX-XXXXXXX-XXXXXXXXXX--XXXXXXXXXXXXXXXXXXXXXXXXXX-XXXXXXXXXXXXXXXXXXXXXXXXXXXXXXXXXXXXXXXXXXXXXXXX
XXXXXXXXXXXXXXX-XXXXXXXXXX-XXXXXXXXX-XXXXXXX--XXXXXX-XXXX-XXX-XXXXXXXXXX-XXXXXXXX-XXXX-X-XXXX-XX-XXXXXXX-XXXXXXX-XXXXXXXXXX--XXXXXXXXXXXXXXXXXXXXXXXXXX-XXXXXXXXXXXXXXXXXXXXXXXXXXXXXXXXXXXXXXXXXXXXXXXX
