--------------------------------------------------------------------------------------------------------------------------------------------------------------------------------------------------------
--------------------------------------------------------------------------------------------------------------------------------------------------------------------------------------------------------
--------------------------------------------------------------------------------------------------------------------------------------------------------------------------------------------------------
--------------------------------------------------------------------------------------------------------------------------------------------------------------------------------------------------------
--------------------------------------------------------------------------------------------------------------------------------------------------------------------------------------------------------
--------U---------U----------B---------U--B--B-------------BB----B----BB------------B--U----------------------------------------------------------------------------------------------------------------
---------C----------------------------------C----------------C----------------------------C-------------------------------------------------------------------------------------------------------------
--------------------------------------------------------------------------------------------------------------------------------------------------------------------------------------------------------
--------------------------------------------------------------------------------------------------------------------------------------------------------------------------------------------------------
--------------------------------------------------------------------------------------------------------------------------------------------------------------------------------------------------------
--B---ttCB-----B-#C---tt-U-tt----------C----B--------#-CC-B--B-CB---UB---#--#ttttU---B-C--Btt-----#tt---C---CUCCCCUCCCCCCCCUCCCCCCUCCCCC-UCCCCUCCCCUCCCCCCUCCCCC-#UCCCC---------------------------------
------tt-----tt--#----tt---tt-----------#-----------##------------##-----#--#tttt-------#--tt#---##tt------------------------------------------------------------#--------------------------------------
-----#tt--tt-tt--#-tt-tt---tt-----------##----tt-##-##------------##----##--#tttt-------#--tt##-###tt-tt---------------------------------------------------------#--------#-----------------------------
---#-#tt--tt-tt--#-tt-tt#--ttg-g--------##---gtt-##-##---g----#--g##----##--#tttt-#-g---#--tt######tt-tt---k-----------------------------------------------------#-----##-#########-############g##-###F
X-XX-XXXXXXX-XXX-XXXXXXXXXXXXXXXXXX-XXXXXX-XXXXXXXX-XXXXXXX--XXXXXXXXX--XXXXXXXXXXXXXXXXXXXXXXXXXXXXXXXXXXXXXXXXXXXXXXXXXXXXXXXXXXXXXXXXXXXXXXXXXXXXXXXXXXXXXXXXXXXXXXXXX-XXXXXXXXXXXXXXXXXXXXXXXXXXXXXX
X-XX-XXXXXXX-XXX-XXXXXXXXXXXXXXXXXX-XXXXXX-XXXXXXXX-XXXXXXX--XXXXXXXXX--XXXXXXXXXXXXXXXXXXXXXXXXXXXXXXXXXXXXXXXXXXXXXXXXXXXXXXXXXXXXXXXXXXXXXXXXXXXXXXXXXXXXXXXXXXXXXXXXX-XXXXXXXXXXXXXXXXXXXXXXXXXXXXXX
