--------------------------------------------------------------------------------------------------------------------------------------------------------------------------------------------------------
--------------------------------------------------------------------------------------------------------------------------------------------------------------------------------------------------------
--------------------------------------------------------------------------------------------------------------------------------------------------------------------------------------------------------
--------------------------------------------------------------------------------------------------------------------------------------------------------------------------------------------------------
--------------------------------------------------------------------------------------------------------------------------------------------------------------------------------------------------------
-----S---------------------S-------S--------SS--S----S------S-U--------U-------------UU----------S----S-U-----SU------SS------S-----S-------S---------S--U---------S------------------------------------
------C---------------------C----------------------------------------------------------------------------------------------------------------------C----------------------------------------------------
--------------------------------------------------------------------------------------------------------------------------------------------------------------------------------------------------------
--------------------------------------------------------------------------------------------------------------------------------------------------------------------------------------------------------
--------------------------------------------------------------------------------------------------------------------------------------------------------------------------------------------------------
-S----S---C-----------------Stt------------S--tt----C--U------C---#tt--CU----tt----C-CCSU#-S------CSS---C------C#-ttU--------#---U-----tt-------tt-SUC-C-C---#S----------------tt-----------------------
--tt---#----#----------#-----tt--#---tt-------tt------------------#tttt--tt--tt----------#----------------------#-tt----#---##----#----tt-----tttt-----------#--------tt-------tt-----------------------
--tt---#----##--#-tt---##----tt#-#---tt--#----tt---#--------------#tttt--tt--tt-tt-------##--------------#tt----#-tt----#--###----#----tt-tt-#tttt--------tt-#--------tt-------tt-----------------------
k-tt---#g---###-#-tt---###-g-tt#-#---tt#-#----tt-#-#----gg#--k-#kk#tttt--tt--tt-tt--#----##-g#-g---------#tt-k--#-tt-gg-##-###-g--#-g--tt-ttg#tttt--------tt-#-gggggggttgggggggttggggggggggggggggggggggF
|%||-%%||%%%|||-|%||-%-|||%|%|||-|%-%|||-|%%--||-|-|%-%%|||%-|%||||||||%%||-%||%||-%|%%%%||%||%|%-%%%%%%%|||%|-%|%||%||-||-|||-|%%|%|%%||%||||||||%%%%-%%%||%|%||||||||||||||||||||||||||||||||||||||||%
||||-||||||||||-||||-|-|||||||||-||-||||-|||--||-|-||-||||||-||||||||||||||-||||||-||||||||||||||-||||||||||||-||||||||-||-|||-|||||||||||||||||||||||-|||||||||||||||||||||||||||||||||||||||||||||||||
