--------------------------------------------------------------------------------------------------------------------------------------------------------------------------------------------------------
--------------------------------------------------------------------------------------------------------------------------------------------------------------------------------------------------------
--------------------------------------------------------------------------------------------------------------------------------------------------------------------------------------------------------
--------------------------------------------------------------------------------------------------------------------------------------------------------------------------------------------------------
--------------------------------------------------------------------------------------------------------------------------------------------------------------------------------------------------------
-----------------SSU---------S---S----S-------------SSS---------------S-S----------S---U--S---S-SS------U--U-SS----------------S-SS-------SS-----------SU--SS----S--S----S---UUUUUUUUUUUUUUUUUUUUUUUUUUU
--------------C---------------------------------------------CC------C--------------------------------------------------------------CC-------------------------------------------------------------------
--------------------------------------------------------------------------------------------------------------------------------------------------------------------------------------------------------
--------------------------------------------------------------------------------------------------------------------------------------------------------------------------------------------------------
--------------------------------------------------------------------------------------------------------------------------------------------------------------------------------------------------------
---U-S-------SS#S--C-C---------S-------C-tt---SS-ttC----#--SSS----#-S--U-------------S-C---#---S--tt----CS-CS--U-------------US-S--SSCttS------tt-------C#-----tt-tt------U-SCCCCCCCCCCCCCCCCCCCCCCCCCCC
#--------------#-------------------tt----tt------tt-----#---------#------#---#---tt-----tt-#------tt------------#tt-------------------tt-#-----tttt#-#---#---tttt-tt------------------------------------
#---#----#-----#----#---tt---------tt#---tt-tt---tt-----#-----tt-##------#---#---tt-----tt-#-#----tt-tt---------#tt-------------------tt-#--tt-tttt#-#---#---tttt-tt------------------------------------
#---#-g#-#gg---#----#--gtt#--gg-k-gtt#---tt-tt---tt--ggg#-----tt-##g-#---#g--#-g#tt-----tt-#-#----tt-tt#--------#tt-------------------tt-#ggttktttt#g#---#---tttt-ttgk#ggg-----------------------------F
|%%%|%||-|||%%%|%--%|%%||||%%||%|%||||-%%||%||%%%||%-||||%%%%%||%|||%|-%-||%%|%||||%%%%%||-|%|%%%%||%|||%%%%%%%%|||%-%%%%-%%-%%%%--%%%||%|||||||||||||%%%|%-%||||-||||||||%%%%%%%%%%%%%%%%%%%%%%%%%%%%%%
||||||||-||||||||--|||||||||||||||||||-|||||||||||||-|||||||||||||||||-|-|||||||||||||||||-|||||||||||||||||||||||||-||||-||-||||--||||||||||||||||||||||||-|||||-||||||||||||||||||||||||||||||||||||||
