--------------------------------------------------------------------------------------------------------------------------------------------------------------------------------------------------------
--------------------------------------------------------------------------------------------------------------------------------------------------------------------------------------------------------
--------------------------------------------------------------------------------------------------------------------------------------------------------------------------------------------------------
--------------------------------------------------------------------------------------------------------------------------------------------------------------------------------------------------------
--------------------------------------------------------------------------------------------------------------------------------------------------------------------------------------------------------
S----U-SU---------------------------------------S--------S---S----SSSS-----------SS------S-------U------------------------------------------------------------------------------------------------------
-C--------------------------C-----------------------------------------------------------C---------------------------------------------------------------------------------------------------------------
--------------------------------------------------------------------------------------------------------------------------------------------------------------------------------------------------------
--------------------------------------------------------------------------------------------------------------------------------------------------------------------------------------------------------
--------------------------------------------------------------------------------------------------------------------------------------------------------------------------------------------------------
-S--SCU-Ctt--C-tt-----------S--SS-SS--US--Ctt--------------------S----S--tt-tt--C--S----S-U------C-----------------------------------------------------------------------------#------------------------
---------tt----tt------tt----tt-----#------tt----#--#---------#----------tt-tt-------#-----tt#---------------------------------------------------tt----------------------------#------------------------
--tt-----tt#---tt-tttt-tt#---tt-----#------tt-tt-##-##--#-----#----------tt-tt-------##----tt#-tt------------------------------------------------tt----------------------------#------------------------
--tt---g-tt##--tt-tttt-tt#gg-tt--#--#g--##-tt-tt-##-###-#gk--g#gg------#gttgtt-g----####-g-tt#-tt--------------------------------k---------------tt----------------------------#-----------------------F
-%||%%%|%||||%-||%||||%|||||%||%%|%%||%%||%||%||%||-|||-|||%%||||%---%%|||||||%|%%-%||||%|%|||%||%%-%%%-%%-%%-%%-%%-%%%-%%%%-%%%%|%-%%-%%%-%%-%%%||-%%%%-%%-%%%-%%%%%%-%%%-%%%%|%-%%%-%%-%%%%%%%%%%%%%%%
-|||||||||||||-||||||||||||||||||||||||||||||||||||-|||-||||||||||---|||||||||||||-||||||||||||||||-|||-||-||-||-||-|||-||||-||||||-||-|||-||-|||||-||||-||-|||-||||||-|||-||||||-|||-||-|||||||||||||||
