--------------------------------------------------------------------------------------------------------------------------------------------------------------------------------------------------------
--------------------------------------------------------------------------------------------------------------------------------------------------------------------------------------------------------
--------------------------------------------------------------------------------------------------------------------------------------------------------------------------------------------------------
--------------------------------------------------------------------------------------------------------------------------------------------------------------------------------------------------------
--------------------------------------------------------------------------------------------------------------------------------------------------------------------------------------------------------
B--B-------B--BU-B----U------------BB----BB---------B-----B-----B--------B----B---BB--B-----B---UB-------BU------B------BB-----U------B----B-----------B---------B--B------B---B------------------------
----------------C--------------------------------------------------------------------C------------C-------------------------------------------------------------C---------------------------------------
--------------------------------------------------------------------------------------------------------------------------------------------------------------------------------------------------------
--------------------------------------------------------------------------------------------------------------------------------------------------------------------------------------------------------
--------------------------------------------------------------------------------------------------------------------------------------------------------------------------------------------------------
---------------CB----UC----B#tt-tt----#----tt-tt-BC--tt-------------tt---------------B---#tt----C-BCBB----C#C----------B----#--Ctt#----C-U-----C----tt----CB--U-B----U#---------------------------------
-tt--------------------tt---#tt-tt----#-#--tt-tt-----tt-#----------#tt-----tt-------#----#tt---#-----------#---------#------#---tt#-------#------tt-tt#---------------#--------------###################
-tt--------------------tttt-#tt#tt----#-#--tt-tt-----tt##----tt---##tt-----tt---#---#----#tt--##-----------#---------#----#-#---tt#-tt----#-tt---tt-tt#-tt---#----#---#---#-#----#-#-###################
-tt-gg-----------g--g--tttt-#tt#tt----#k#--tt#tt---ggtt##--g-ttgg###tt---ggttg--#k--#--g##ttg###-------#---#-g--g-kk-#----#g#---tt#-ttg-g-#gtt---ttgtt#-tt---#----#k--#-#-#-#----#-#-##################F
XXX-XXX-XXX-XX-XXXXXXXXXXXXXXXXXXXX-X-XXXX-XXXXXXXXXXXXXXX-XXXXXXXXXXXXXXXXXXXXXXX-XXX-XXXXXXXXXX-XXXXXXX-XXXX-XX-XXXXXX--XXXXXXXXXXXXXXXXXXXXXX-XXXXXXXXXXXXXX-X-XXXXXXX-X-XXX--XXX-XXXXXXXXXXXXXXXXXXX
XXX-XXX-XXX-XX-XXXXXXXXXXXXXXXXXXXX-X-XXXX-XXXXXXXXXXXXXXX-XXXXXXXXXXXXXXXXXXXXXXX-XXX-XXXXXXXXXX-XXXXXXX-XXXX-XX-XXXXXX--XXXXXXXXXXXXXXXXXXXXXX-XXXXXXXXXXXXXX-X-XXXXXXX-X-XXX--XXX-XXXXXXXXXXXXXXXXXXX
