--------------------------------------------------------------------------------------------------------------------------------------------------------------------------------------------------------
--------------------------------------------------------------------------------------------------------------------------------------------------------------------------------------------------------
--------------------------------------------------------------------------------------------------------------------------------------------------------------------------------------------------------
--------------------------------------------------------------------------------------------------------------------------------------------------------------------------------------------------------
--------------------------------------------------------------------------------------------------------------------------------------------------------------------------------------------------------
-----------------US---U----------S---------U--------------U---SS---SS------------------U-U---------------U-------U------U-------------------S-----------------------------------------------------------
-----C--C-----C----------C-------------C-------------C-C-----------------C------------------------------------------------------------------------------------------------------------------------------
--------------------------------------------------------------------------------------------------------------------------------------------------------------------------------------------------------
--------------------------------------------------------------------------------------------------------------------------------------------------------------------------------------------------------
--------------------------------------------------------------------------------------------------------------------------------------------------------------------------------------------------------
---S#S--S-S---SS-C--C-C-CS-tt----------S-#CC--------#S-S--C--------------S-tt-----C----C-C----S---CSS-SCSCSCSS-C-C-CSS-SCSCSS-CSS-S-SS------------------------------------------------------------------
#---#-tt---tt--------------tt------------#--tt------#----#-----------tt----tt--------------------#-----------------------------------------------------------#------------------------------------------
##--#-tt---tt--------------tt---#--------#--tttt#---#----#--#----tt--tt----tt-#tt----------------#-------------------------------------------#-------------#-#------------------------------------------
###-#-tt-g-ttg----g-------ktt--g#g-------#--tttt#---#---g#-g#--ggtt--ttg---ttg#tt--gg-----k--g---#-------------------------------------------#-------------#-#----------------g-gggg-ggggggggggg-ggggggF
|||%|%||%|%|||%%-%|%%%%%%%|||%%|||%-%%%%%|%%|||||%%%|%%%||%||%-||||%-|||%%%||||||%%||%%%%%|%%|%%%|%%%%%%%%%%%%%%%%%%%%%%%%%%%%%%%%%%%%%%%%%%%|%%%%%%%-%%%%%|-|%%%%%%%%%%%%%%%%|%||||%|||||||||||%||||||%
||||||||||||||||-||||||||||||||||||-||||||||||||||||||||||||||-|||||-||||||||||||||||||||||||||||||||||||||||||||||||||||||||||||||||||||||||||||||||-||||||-|||||||||||||||||||||||||||||||||||||||||||
