--------------------------------------------------------------------------------------------------------------------------------------------------------------------------------------------------------
--------------------------------------------------------------------------------------------------------------------------------------------------------------------------------------------------------
--------------------------------------------------------------------------------------------------------------------------------------------------------------------------------------------------------
--------------------------------------------------------------------------------------------------------------------------------------------------------------------------------------------------------
--------------------------------------------------------------------------------------------------------------------------------------------------------------------------------------------------------
----------------------------------------------------------------------------------------------S-------------S-----------------------U--SU-----S---------S----------U------------------------------------
C-C-C-C-C-C-C-C-C-C-C-C-C-C-C-C-C-C-C-C-C-C-C-C-C-C-C-C-C-C-C-C-C-C-C-C-C-C-C-C-C-C-C-C-C---------------------------------------------------------------------------------------------------------------
--------------------------------------------------------------------------------------------------------------------------------------------------------------------------------------------------------
--------------------------------------------------------------------------------------------------------------------------------------------------------------------------------------------------------
--------------------------------------------------------------------------------------------------------------------------------------------------------------------------------------------------------
SSSSSSSSSSSSSSSSSSSSSSSSSSSSSSSSSSSSSSSSSSSSSSSSSSSSSSSSSSSSSSSSSSSSSSSSSSSSSSSSSSSSSSSSStt----tt---------------#--tt--------#------Ctt-C------S--S----------#-----C-------------------C---C------------
-----------------------------------------------------------------------------------------tt----tt-----#--------##--tt---tt---#-------tt----------------------#------------------#-----------------------
-----------------------------------------------------------------------------------------tt-tt-tt-tt-###--#---###--tt--#tt-#-#----tt-tt---------------------##---#------#------##-----------------------
-----------------------------------------------------------------------------------------tt-tt-tt-tt#####-##-######tt#-#tt-#######tt-tt--#####--##--####g##-####-##-###-###############-###-###########F
%%%%%%%%%%%%%%%%%%%%%%%%%%%%%%%%%%%%%%%%%%%%%%%%%%%%%%%%%%%%%%%%%%%%%%%%%%%%%%%%%%%%%%%%%||%||%||%|||||||-||%|||||||||-|||-|||||||||%||%%|||||-%||%%|||||||-||||-||%|||-|||||||||||||||%|||%|||||||||||%
|||||||||||||||||||||||||||||||||||||||||||||||||||||||||||||||||||||||||||||||||||||||||||||||||||||||||-||||||||||||-|||-|||||||||||||||||||-||||||||||||-||||-||||||-||||||||||||||||||||||||||||||||
