--------------------------------------------------------------------------------------------------------------------------------------------------------------------------------------------------------
--------------------------------------------------------------------------------------------------------------------------------------------------------------------------------------------------------
--------------------------------------------------------------------------------------------------------------------------------------------------------------------------------------------------------
--------------------------------------------------------------------------------------------------------------------------------------------------------------------------------------------------------
--------------------------------------------------------------------------------------------------------------------------------------------------------------------------------------------------------
------B------U-------------B--B----BB--------------------------------BB------B------U------------B----------BBB-----B-----------U-----U---------BBB-BB-B-BB-BBU-BB---------BB---------------------------
------------------------------------------------------------------------C--------------------------------------------C----------------------------------------------------------------------------------
--------------------------------------------------------------------------------------------------------------------------------------------------------------------------------------------------------
--------------------------------------------------------------------------------------------------------------------------------------------------------------------------------------------------------
--------------------------------------------------------------------------------------------------------------------------------------------------------------------------------------------------------
C----#--tt-C-C-CCC-----tt#U-------B----tt---#U#---------------------B---B---#--tt---C#U---#-#-----tt----B-tt---#-tt--B#---------C-----C--------B---B----B--B--CB----------------------------------------
---#-#--tt----------tt#tt#-------------tt---#-#------------------#-#-------##--tt#---#---##-#-----tt------tt---#-tt---#---------------------------------------------------------------------------------
-#-#-#--tt--------tttt#tt#--tt--tt---tttt-tt#-#tt--------------#-#-#------###--tt##--#--###-##-#--tt-tt---tt---#-tt---#-----------------------#----------------------------------#-----tt---------------
-#-#-#g-tt--------tttt#tt#-gttg-tt---tttt-tt#-#tt--------------#-###-----####ggtt###-#-####-##k#g-tt-tt--ktt--g#gttgg-#-------g-------------#-#-------k-----------gg#gggggggggggg#gg-ggttggggggggggggggF
XX-XXXX-XX-XXXXXXXXXXXXXXXXXXXXXXXX--XXXXXXXXXXXXXXXX-XX-XXX-XXX-XXXXXX-XXXXXXXXXXXXXXXXXXX-XXXXXXXXXXXXXXXXX-XXXXXXXXXXXXXXXXXXXXXXXXXXXXXXXXXXXXXXXXXXXXXXXXXXXXXXXXXXXXXXXXXXXXXX-XXXXXXXXXXXXXXXXXXX
XX-XXXX-XX-XXXXXXXXXXXXXXXXXXXXXXXX--XXXXXXXXXXXXXXXX-XX-XXX-XXX-XXXXXX-XXXXXXXXXXXXXXXXXXX-XXXXXXXXXXXXXXXXX-XXXXXXXXXXXXXXXXXXXXXXXXXXXXXXXXXXXXXXXXXXXXXXXXXXXXXXXXXXXXXXXXXXXXXX-XXXXXXXXXXXXXXXXXXX
