--------------------------------------------------------------------------------------------------------------------------------------------------------------------------------------------------------
--------------------------------------------------------------------------------------------------------------------------------------------------------------------------------------------------------
--------------------------------------------------------------------------------------------------------------------------------------------------------------------------------------------------------
--------------------------------------------------------------------------------------------------------------------------------------------------------------------------------------------------------
--------------------------------------------------------------------------------------------------------------------------------------------------------------------------------------------------------
--------B--B--U---B---------BB-----B----------U---------------------B----------BUB--UU---U--UU--------------------BB-B---B--B-------B----------------------------------------B--------------------------
----------------------C------------------------------CC-C----------------------------------C------------------------------------------------------------------------------------------------------------
--------------------------------------------------------------------------------------------------------------------------------------------------------------------------------------------------------
--------------------------------------------------------------------------------------------------------------------------------------------------------------------------------------------------------
--------------------------------------------------------------------------------------------------------------------------------------------------------------------------------------------------------
ttB----------CC-tt----BB------------C-------C-C-C----BB-B--tt----tt--U--B-------C---CC---C-BCC-U-----------------U------B-U---tt-----Btt----------U-UUUUUUUUU--ttttUUUU--UUUU-UUUUU--U------------------
tt--------------tt--------------------------------#----#-tttt----tt---------tt-----#---tt-#---------------------------tt------tt#-----tt---#--tt---------------tttt-----#-------------------------------
tt-------#-----#tt---------#---#-------#-tt------###---#-tttt-tt-tt---------tt#----#---tt-#---------------------------tt------tt#-tt--tt-tt##-tt-------------tttttt-----#-------------------------------
tt------g#ggg--#ttgk-g--gg-#g--#-#---#-#kttk-----####--#-tttt-tt#tt#g----g-ktt#--gg#--ktt-#-----kk---------gk---------tt-g-#-#tt##ttg-tt-tt###tt---g---------tttttt-----#------------------------------F
XXXX-XXXXXXXXXXXXXXXXXXXXXXXXXXXXXX-XX-XXXXXXXXXXXXXXXXXXXXXXXXXXXXXXXXXXXXXXXXXXXXXXXXXXXXXXXXXXXX-XXX-XXXXXXXXXXX--XXXXXXXXXXXXXXXXXXXXXXXXXXXXXXXXXXXXXXXXXXXXXXXXXXXXXXXX-XXXXXXXXXXXXXXXXXXXXXXXXXX
XXXX-XXXXXXXXXXXXXXXXXXXXXXXXXXXXXX-XX-XXXXXXXXXXXXXXXXXXXXXXXXXXXXXXXXXXXXXXXXXXXXXXXXXXXXXXXXXXXX-XXX-XXXXXXXXXXX--XXXXXXXXXXXXXXXXXXXXXXXXXXXXXXXXXXXXXXXXXXXXXXXXXXXXXXXX-XXXXXXXXXXXXXXXXXXXXXXXXXX
