--------------------------------------------------------------------------------------------------------------------------------------------------------------------------------------------------------
--------------------------------------------------------------------------------------------------------------------------------------------------------------------------------------------------------
--------------------------------------------------------------------------------------------------------------------------------------------------------------------------------------------------------
--------------------------------------------------------------------------------------------------------------------------------------------------------------------------------------------------------
--------------------------------------------------------------------------------------------------------------------------------------------------------------------------------------------------------
---S---S--------------SS-------------------------S---------USSS--------------------S---------------U--S--------SS-------S-------S-S---------------------------------------------------------------------
-----------------------------------C-----C---------------C--------------------------------------------------------------------C-------------------------------------------------------------------------
--------------------------------------------------------------------------------------------------------------------------------------------------------------------------------------------------------
--------------------------------------------------------------------------------------------------------------------------------------------------------------------------------------------------------
--------------------------------------------------------------------------------------------------------------------------------------------------------------------------------------------------------
----------tt-ttU--------------tt---Stt---S----tt---------S-C---------------------#-----------------C-C------#-S--S-tt------C--S--U------CU----#---------------------------------------------------------
----tt#--#tt-tt-tttt-------#--tt----tt-----tt-tt---------------------------------#---------tt----------#---##------tt---------------tttt--tttt#tttttttttttt-tt---tttttttttttt-tt-tttttttttttttttttttttt-
#---tt#--#tt-tt-tttttt--tt-#--tt-tt-tt-tt--tt-tt---------------------------------#--tt-----tt----------#--####----#tt-tt--#---------tttt--tttt#tttttttttttt-tt-tttttttttttttt-tt-tttttttttttttttttttttt-
#---tt#-k#tt-tt-tttttt--tt-#-gtt-tt-tt-tt-gtt-ttk--------------k-----------------#-gtt-g-##tt----------#-#####----#tt-tt--#-k-----g-tttt--tttt#tttttttttttt-tt-tttttttttttttt-tt-ttttttttttttttttttttttF
|%%-|||-||||%||%||||||-%||%|%|||-||%||-||%|||%|||%%-%%%%%%-%%-%|%%%-%%%-%%-%%%%%%|%|||%|%||||%%-%%%%%%%|-|||||%%%%|||%||%%|%|%%%-%|%||||%%|||||||||||||||||%||%||||||||||||||%||%||||||||||||||||||||||%
|||-|||-||||||||||||||-|||||||||-|||||-||||||||||||-||||||-||-|||||-|||-||-||||||||||||||||||||-||||||||-|||||||||||||||||||||||-|||||||||||||||||||||||||||||||||||||||||||||||||||||||||||||||||||||||
