--------------------------------------------------------------------------------------------------------------------------------------------------------------------------------------------------------
--------------------------------------------------------------------------------------------------------------------------------------------------------------------------------------------------------
--------------------------------------------------------------------------------------------------------------------------------------------------------------------------------------------------------
--------------------------------------------------------------------------------------------------------------------------------------------------------------------------------------------------------
--------------------------------------------------------------------------------------------------------------------------------------------------------------------------------------------------------
-B--------B--BB-----------------B-B--------BB---------BB-----B--------UU-----------B-----------U--B--U--------------B--------B--B-U-----------------------UB--------------------------------------------
-------------------C--------C---------------------------------------------------------------C-------------------------------C---------------------------------------------------------------------------
--------------------------------------------------------------------------------------------------------------------------------------------------------------------------------------------------------
--------------------------------------------------------------------------------------------------------------------------------------------------------------------------------------------------------
--------------------------------------------------------------------------------------------------------------------------------------------------------------------------------------------------------
C-ttC----------#---B-C------B--------CU--------#CU-------------------CCC--------------------B-CC---C-C-CC-#------------#---BB----UC-tt--Btt---------------C--------------------------------------C------
--tt--tt-------#----#----#---#-----------------#--tt--------------#-----#tt-------#--#----tt----tt--------#----#-------#------tt----tt---tttt--#----#----------------------------#----------------------
--tt--tt----#--#----#----#---##--------tt------#--tt--------------#-----#tt-tt---##--##--#tt----tt--------#-##-#-----tt#------tt----tt#--tttt-###-#-##--##--###############-####-##-#############-######
-gtt-gtt----#gg#----#----#---###-k-----ttg-gg-g#--tt-kgg#-#---k-g-#g----#ttgttg#-##--###-#tt----ttg-------#k##-##g---tt##gg--gtt----tt#--tttt######-###-##--###############-####-################-#####F
XXXXXXXXXXXXXXXXXXXXXXXXXXX-XXXX-XXXXXXXXXXXX-XXXXXXXXXXXXXXX-XXXXXX-XXXXXXXXXXX-XX-XXXX-XXXXXXXXXXXXXXXXXXXXX-XXXXX-XXXXXXXXXXXXXXXXXXXXXXXXXXXXXX-XXX-XXXXXXXXXXXXXXXXXXXXXXXX-XXXXXXXXXXXXXXXXXXXXXXX
XXXXXXXXXXXXXXXXXXXXXXXXXXX-XXXX-XXXXXXXXXXXX-XXXXXXXXXXXXXXX-XXXXXX-XXXXXXXXXXX-XX-XXXX-XXXXXXXXXXXXXXXXXXXXX-XXXXX-XXXXXXXXXXXXXXXXXXXXXXXXXXXXXX-XXX-XXXXXXXXXXXXXXXXXXXXXXXX-XXXXXXXXXXXXXXXXXXXXXXX
