--------------------------------------------------------------------------------------------------------------------------------------------------------------------------------------------------------
--------------------------------------------------------------------------------------------------------------------------------------------------------------------------------------------------------
--------------------------------------------------------------------------------------------------------------------------------------------------------------------------------------------------------
--------------------------------------------------------------------------------------------------------------------------------------------------------------------------------------------------------
--------------------------------------------------------------------------------------------------------------------------------------------------------------------------------------------------------
---BB----BB--B-------BU-------------------B-----B---B------------B-----------B----------B---------------------------------U-----------------------------U----B--------B---B--BB-------------------------
-----C--------------------------------------------------------------C--------------------------C--C-C-C-C-C-C-C-C-C-CC----------------------------------------------------------------------------------
--------------------------------------------------------------------------------------------------------------------------------------------------------------------------------------------------------
--------------------------------------------------------------------------------------------------------------------------------------------------------------------------------------------------------
--------------------------------------------------------------------------------------------------------------------------------------------------------------------------------------------------------
-----B#UB--#--U---C---C--------Btt----CC-#-----U-C----U-------------B-U-----#-#-CC------------#B--BBBBBBBBBBBBBBBBBBBB----C--U--------------------------C-----------------------------------------------
------#----#---tt---------#-tt--tt-------#-------------------##------#---#--#-#-------------#-#-----------------------------------tt--------------------------------------------------------------------
------#----#---tt---------#-tt--tt-tt----#----#------------#-##------#-#-##-#-#---tt--tt-##-#-#--#--------------------------------tt-------#---#----------------------------------------------tt--------
--kg--#----#gg-ttg-##--##-#kttg-tt-tt----#--#-#---g----g##-#-###g----#-#-####-#---tt--ttg##-#-#--#---------------------ggg-g--kk--tt-----#-###-#--k--#------gg########-###g--gg---------------tt-------F
XXXX-XXXX--XXXXXXXXXX-XXXXXXXXXXXXXXXXXXXX-XX-XX-XXX--XXXX-X-XXXXXXXXXXX-XXXXXXXXXXXXXXXXXX-XXXXXXXXXXXXXXXXXXXXXXXXXX-XXXXXXXXX-XXX-X---X-XXX-XX-X--X--X---XXXXXXXXXX-XXXX--XXX-XX-XXX--XX---XX--X-----
XXXX-XXXX--XXXXXXXXXX-XXXXXXXXXXXXXXXXXXXX-XX-XX-XXX--XXXX-X-XXXXXXXXXXX-XXXXXXXXXXXXXXXXXX-XXXXXXXXXXXXXXXXXXXXXXXXXX-XXXXXXXXX-XXX-X---X-XXX-XX-X--X--X---XXXXXXXXXX-XXXX--XXX-XX-XXX--XX---XX--X-----
