--------------------------------------------------------------------------------------------------------------------------------------------------------------------------------------------------------
--------------------------------------------------------------------------------------------------------------------------------------------------------------------------------------------------------
--------------------------------------------------------------------------------------------------------------------------------------------------------------------------------------------------------
--------------------------------------------------------------------------------------------------------------------------------------------------------------------------------------------------------
--------------------------------------------------------------------------------------------------------------------------------------------------------------------------------------------------------
---------------B-B-------------------U--U--------B--------B----BU-------------B-BB-----------------------------------------------------BB---------------------------------------------------------------
-------------------C--CC--------------------------------------------------------------------------------------------------------------------------------------------------------------------------------
--------------------------------------------------------------------------------------------------------------------------------------------------------------------------------------------------------
--------------------------------------------------------------------------------------------------------------------------------------------------------------------------------------------------------
--------------------------------------------------------------------------------------------------------------------------------------------------------------------------------------------------------
#-----BCBB---------BB-BBCC-B----#-CC-C-CC----U-----U--#---------C-----Ctt------B-----------C-#U-------#-----------#-U-----------------B----------U---B-tt------------------#----------------------------
#-------------------------------#----------#---------###------#--tt----tt-----------#-----#--#---#---#########---###-#################---######-#-###-#tt#########---------#----------------------------
#tt-------------------------tt-##--------#-#--#-----#####---#-#--tt-tt-tt-tt------#-##--#-#--#--###-###########-####-#################---######-#-###-#tt##########----#---#----------------------------
#tt--g----------g-----------tt-##--------#-#--#-#---######gg#-#g-tt-tt-tt-ttg-----#-###-#-#-k#-#####################-#################---######-#-###-#tt#############-#########g######################F
XXXXXXXXXXX-XXX-X--XXXXXXX-XXXXXXXXXXXXXXX-X-XXXX-XXXXXXXXXXX-XXXXXXXXXXXXXXXX-XXXX-XXX-X-XXXXXXXXXXXXXXXXXXXXXXXXXXXXXXXXXXXXXXXXXXXXXXXXXXXXXXXXXXXXXXXXXXXXXXXXXXXX-XXXXXXXXXXXXXXXXXXXXXXXXXXXXXXXXX
XXXXXXXXXXX-XXX-X--XXXXXXX-XXXXXXXXXXXXXXX-X-XXXX-XXXXXXXXXXX-XXXXXXXXXXXXXXXX-XXXX-XXX-X-XXXXXXXXXXXXXXXXXXXXXXXXXXXXXXXXXXXXXXXXXXXXXXXXXXXXXXXXXXXXXXXXXXXXXXXXXXXX-XXXXXXXXXXXXXXXXXXXXXXXXXXXXXXXXX
