--------------------------------------------------------------------------------------------------------------------------------------------------------------------------------------------------------
--------------------------------------------------------------------------------------------------------------------------------------------------------------------------------------------------------
--------------------------------------------------------------------------------------------------------------------------------------------------------------------------------------------------------
--------------------------------------------------------------------------------------------------------------------------------------------------------------------------------------------------------
--------------------------------------------------------------------------------------------------------------------------------------------------------------------------------------------------------
-U-S----------SS------SS----S------SSS----------------------------U----U---SS---------------------------U-----------U--------------------------------S--------------------------------------------------
-----------------------------C--C-----------------------------------------------------------------------------------------------------------------------------------------------------------------------
--------------------------------------------------------------------------------------------------------------------------------------------------------------------------------------------------------
--------------------------------------------------------------------------------------------------------------------------------------------------------------------------------------------------------
--------------------------------------------------------------------------------------------------------------------------------------------------------------------------------------------------------
-CU-------#S-----U--C--------SttSCS---------tt-tt----------U-U##C-C-C--C---------tt----UU-------ttCSS-CSCSCSS-SCSS-SCSCSS-SSS#SCSS-SSSCSS--CSS-CSS-SS--S-SCSS-#SCSS-SSSSCSS-SSSSSSSSSSSSSCSS-SS---------
---------##---------------#---tt----------#-tt-tttt-tt--#-----##-----------------tt--#----------tt---------------------------#------------------------#-------#-----------------------------------------
-----tt-###-------------tt#---tt--------#-#-tt#tttt-tt-##-----##-------------tt--tttt#----tt-#--tt---------------------------#------------#-----------#-------#-----------------------------------------
----ktt####-ggg----g----tt#k--tt------g-#g#-tt#tttt-tt-##-----##-----kk------tt--tttt#----ttk#k-tt---------------------------#------------#-----------#-g-----#----------------------------------------F
%%%%|||||||%|||%%%%|%-%%||||-%||%%%---|-|||%|||||||%||-||%-%%%||%%%%%||%%%%-%||%%|||||%%%%|||||%||%%%%%%%%%%%%%%%%%%%%%%%%%%%|%%%%%%%%%%%%|%%%%%%%%%%%|%|%%%%%|%%%%%%%%%%%%%%%%%%%%%%%%%%%%%%%%%%%%%%%%%
|||||||||||||||||||||-||||||-||||||---|-||||||||||||||-|||-||||||||||||||||-||||||||||||||||||||||||||||||||||||||||||||||||||||||||||||||||||||||||||||||||||||||||||||||||||||||||||||||||||||||||||||
