--------------------------------------------------------------------------------------------------------------------------------------------------------------------------------------------------------
--------------------------------------------------------------------------------------------------------------------------------------------------------------------------------------------------------
--------------------------------------------------------------------------------------------------------------------------------------------------------------------------------------------------------
--------------------------------------------------------------------------------------------------------------------------------------------------------------------------------------------------------
--------------------------------------------------------------------------------------------------------------------------------------------------------------------------------------------------------
B-------B-------U---B----B----------B----------------BB---U--B----B-B-B--------BBB---------------------U------------------------------------------------------------------------------------------------
--C----------------C------------------C-----------------------------------------------------------------------------------------------------------------------------------------------------------------
--------------------------------------------------------------------------------------------------------------------------------------------------------------------------------------------------------
--------------------------------------------------------------------------------------------------------------------------------------------------------------------------------------------------------
--------------------------------------------------------------------------------------------------------------------------------------------------------------------------------------------------------
--B--------C##--C--B-C----U-----------B-------------B---CBCBC---tt----------CCB---C----------------CBB-CBBCBB-BB-CBB-CBB-BCBB-CBB--BBBB--BCBB-BCBB-B-B--CBB-BBBBBCBB-CBB-BCBB-BBBCCCCBB-BBBBBBBBBBBBBBBB
---#--------##--------#-#---tt------------#---tt----------------tt-----#-----------#----#tt-------#------------------------------------tt-------------tt------------------------------------------------
---#--tt----##--------#-#---tt---tt-----tt##--tt--#-----------tttt-----##--#-------#-tt-#tt--tt-#-#------------------------------------tt-------------tt------------------------------------------------
-g-#--tt-#--###g--g---#k#g--ttk--tt#-g-gtt###gtt#-#-----------tttt---g-###-#-------#-tt-#tt--tt##-#-------------g-----------------g----tt-------------tt-----------------------------------------------F
-XXXXXXX-XXXXXXXXXXXXXXXXXXXXXXXXXXX-XXXXXXXXXXXX-XXXXXXXXXXX-XXXX-X-X-XXX-XXXX--XXXXXX-XXXXXXXXX-XXXXXXXXXXXXXXXXXXXXXXXXXXXXXXXXXXXXXXXXXXXXXXXXXXXXXXXXXXXXXXXXXXXXXXXXXXXXXXXXXXXXXXXXXXXXXXXXXXXXXX
-XXXXXXX-XXXXXXXXXXXXXXXXXXXXXXXXXXX-XXXXXXXXXXXX-XXXXXXXXXXX-XXXX-X-X-XXX-XXXX--XXXXXX-XXXXXXXXX-XXXXXXXXXXXXXXXXXXXXXXXXXXXXXXXXXXXXXXXXXXXXXXXXXXXXXXXXXXXXXXXXXXXXXXXXXXXXXXXXXXXXXXXXXXXXXXXXXXXXXX
