--------------------------------------------------------------------------------------------------------------------------------------------------------------------------------------------------------
--------------------------------------------------------------------------------------------------------------------------------------------------------------------------------------------------------
--------------------------------------------------------------------------------------------------------------------------------------------------------------------------------------------------------
--------------------------------------------------------------------------------------------------------------------------------------------------------------------------------------------------------
--------------------------------------------------------------------------------------------------------------------------------------------------------------------------------------------------------
----------U-UB-------------------U-------------------------U--------B-B----------BB---------B--------------BB--------U------------------------------------B---------------------------------------------
---------------------------------------------------------C----------------------------------------------C-----------------------------------------------------------------------------------------------
--------------------------------------------------------------------------------------------------------------------------------------------------------------------------------------------------------
--------------------------------------------------------------------------------------------------------------------------------------------------------------------------------------------------------
--------------------------------------------------------------------------------------------------------------------------------------------------------------------------------------------------------
--#-tt---CC-C--B----B----ttU---U#C-B----#-#--CttU----#--CBCCC#Utt-C----C-#--------------tt----tt--tt----B------CBB-CBCBC-C-CCCUCCCC-UCCCCUCCCCCCCCUCCCCCCC-UCCCCUCCCCUCCCCC-#CUCCCCUCCCCUCCCCCCUCCCCCCCC
--#-tt-------------#---tttt-----#------##-#---tt---tt#-------#-tt--------#----#---------tt----tt--tt---#-tt-----------------------------------------------------------------#---------------------------
--#-tt-tt-----#--#-#---tttt-----#-----###-#---tt---tt#tt-----#-tt--------#tt-###-----#--tttt--tt--tt-tt#-tt--#--------------------------------------------------------------#---------------------------
-k#ktt-tt--k-g#--#-#-g-tttt-g-g-#---#-#####g--tt---tt#tt-----#-tt--kg-g--#tt-####--#-#-ktttt-gtt-ktt-tt#-tt--#------------g--------k----------------------------------------#--------------------------F
XXXXXXXXXXXXXXXXXX-XXXXXXXXXXXXXXXXXX-XXXXXXXXXXXXXXXXXXXXXXXXXXX-XXX-XXXXXXXXXXX--X-XXXXXXX-XXXXXXXXXXXXXX--XXXXXXXXXXX-XXXXXXXXXXXXXXXXXXXXXXXXXXXXXXXXXXXXXXXXXXXXXXXXXXXXXXXXXXXXXXXXXXXXXXXXXXXXXXX
XXXXXXXXXXXXXXXXXX-XXXXXXXXXXXXXXXXXX-XXXXXXXXXXXXXXXXXXXXXXXXXXX-XXX-XXXXXXXXXXX--X-XXXXXXX-XXXXXXXXXXXXXX--XXXXXXXXXXX-XXXXXXXXXXXXXXXXXXXXXXXXXXXXXXXXXXXXXXXXXXXXXXXXXXXXXXXXXXXXXXXXXXXXXXXXXXXXXXX
