--------------------------------------------------------------------------------------------------------------------------------------------------------------------------------------------------------
--------------------------------------------------------------------------------------------------------------------------------------------------------------------------------------------------------
--------------------------------------------------------------------------------------------------------------------------------------------------------------------------------------------------------
--------------------------------------------------------------------------------------------------------------------------------------------------------------------------------------------------------
--------------------------------------------------------------------------------------------------------------------------------------------------------------------------------------------------------
--------B-U----------B-BB--BB---------B-------------U--U-------------B-------------BB-UB---------B----------U--------U-------U-----------B-----------------------------------------U--------------------
-----------------------------C---------C-------------C--------------C-----------------------------------------------------------------C------------------C-C-C------------------------------------------
--------------------------------------------------------------------------------------------------------------------------------------------------------------------------------------------------------
--------------------------------------------------------------------------------------------------------------------------------------------------------------------------------------------------------
--------------------------------------------------------------------------------------------------------------------------------------------------------------------------------------------------------
-tt----#--C---------B-B--tt--BB--C-tt--Btt-----tt---CBUC-#------#-CCB--ttUU##-----B---C---tt------CBB-CBB-BBCBCBB-BCBCBCBB-CBCBCBBCBB-BBB-CBB-BBBCBB-CBB-BBBBBCBB-BCBB-BCBB-BBBBBBBCBCBB-BBBBBBBBBBBBBBB
-tt---##----------tt-----tt--------tt---tt--tt-tt--------#-----##-----#tt--##--#-----#----tt------------------------------------------------------------------------------------------------------------
-tt---##----tt#--#tt-----tt--------tt---tt--tt-tt--------#tt#-###-----#tt--##tt##----#---#tt-tt---------------------------------------------------------------------------------------------------------
gtt-g-##-k--tt##-#tt-----tt-----g-#tt---tt-gtt-tt-#g----k#tt#####----g#tt--##tt###---#-g-#tt-tt-kg-----------------------------------------------------------------------------------------------------F
XXXXXXXX-XXXXXXX-XXXX-X--XXXXXXXXXXXXXXXXXXXXXXXXXXXXXXXXXXXXXXXXXXXXXXXXXXXXXXXXXX--XXXXXXXXXXXXXXXXXXXXXXXXXXXXXXXXXXXXXXXXXXXXXXXXXXXX-XXXXXXXXXXXXXXXXXXXXXXXXXXXXXXXXXXXXXXXXXXXXXXXXXXXXXXXXXXXXXX
XXXXXXXX-XXXXXXX-XXXX-X--XXXXXXXXXXXXXXXXXXXXXXXXXXXXXXXXXXXXXXXXXXXXXXXXXXXXXXXXXX--XXXXXXXXXXXXXXXXXXXXXXXXXXXXXXXXXXXXXXXXXXXXXXXXXXXX-XXXXXXXXXXXXXXXXXXXXXXXXXXXXXXXXXXXXXXXXXXXXXXXXXXXXXXXXXXXXXX
