--------------------------------------------------------------------------------------------------------------------------------------------------------------------------------------------------------
--------------------------------------------------------------------------------------------------------------------------------------------------------------------------------------------------------
--------------------------------------------------------------------------------------------------------------------------------------------------------------------------------------------------------
--------------------------------------------------------------------------------------------------------------------------------------------------------------------------------------------------------
--------------------------------------------------------------------------------------------------------------------------------------------------------------------------------------------------------
---U--U-U-U--B--------------B--U---B-------B--------BB----UB------B-B----------------------BBU-U-----BB-BBB----BBB--BBBB-BBB-B--BB-BB-BBB-BB-BBB-BB--BB-BB--BBB-BBB--BB-BB-BBB-BBB-B-BB-BB-BBB-BB-BBBBBB
----------------------------------C----------------------------------------------------------------------------------------------------------------C----------------------------------------------------
--------------------------------------------------------------------------------------------------------------------------------------------------------------------------------------------------------
--------------------------------------------------------------------------------------------------------------------------------------------------------------------------------------------------------
--------------------------------------------------------------------------------------------------------------------------------------------------------------------------------------------------------
-C-C-CC-CCC-----CB---#-tt----C-C-CB-tt---B--#---U--B-----#C----#----------#B---#Btt-------B--C-CCBB-B--B---C--B----B----B------B--B--B---B--B---B--BB--B---B---B---BB--B--B---B-----B--B--B---B--B------
-------------------tt#-tt#----------tt------#----------tt#----##---------##---##-tt---#tt#------------------tt------------------------------------------------------------------------------------------
-------------------tt#-tt##---------tt------#tt#-------tt#---###tt------###--###-tt-#-#tt#------------------tt--------------------------------------------------------------------#---------------------
-----------gggg---gtt#-tt###--------ttg----g#tt#------ktt#-g####tt--gk#-###-####-ttg#-#tt#------------------tt--------------#-----------------------------------------------------#--------------------F
XXXXXXXXXXXXXXXXXXXXXXXXXXXXXXXXXXX-XXXX-XXXXXXXXXXXXXXXXXXXXXXXXXXXXXX-XXXXXXXXXXXXX-XXXXXXXX-XXXXXX--X---XXXX---XX----X---X-XX--X--X---X--X---X--XX--X--XX---X---XX--X--X---X---X-X--X--X---X--X------
XXXXXXXXXXXXXXXXXXXXXXXXXXXXXXXXXXX-XXXX-XXXXXXXXXXXXXXXXXXXXXXXXXXXXXX-XXXXXXXXXXXXX-XXXXXXXX-XXXXXX--X---XXXX---XX----X---X-XX--X--X---X--X---X--XX--X--XX---X---XX--X--X---X---X-X--X--X---X--X------
