--------------------------------------------------------------------------------------------------------------------------------------------------------------------------------------------------------
--------------------------------------------------------------------------------------------------------------------------------------------------------------------------------------------------------
--------------------------------------------------------------------------------------------------------------------------------------------------------------------------------------------------------
--------------------------------------------------------------------------------------------------------------------------------------------------------------------------------------------------------
--------------------------------------------------------------------------------------------------------------------------------------------------------------------------------------------------------
--B--BB------B-------U--B-------------------------------------------B-B-----U-----B---B-----B-----------B------BB-----B-B-----------B-------------BU--BB----------B--B--B-------------------------------
------------C-----------------------------C-----C---------C--------------------------------------------------------------C------------------------------------------------------------------------------
--------------------------------------------------------------------------------------------------------------------------------------------------------------------------------------------------------
--------------------------------------------------------------------------------------------------------------------------------------------------------------------------------------------------------
--------------------------------------------------------------------------------------------------------------------------------------------------------------------------------------------------------
-#--B--tt---B--------C----#--B-----#------B-----B#---tt---B--U----------#-CBCBCtt#------------U-B-----tt-------------#-#-B-#----tttt--#--Utt-##-tt-C#-----tt-U--tt----C---------------------------------
-#-----tt--#--tt---------##--------#----tt-------#---tt---------tt------#------tt#-tt------------tt---tt-tt--------tt#-#---#----tttt--#---tt-##-tt--#-----tt----tt--#----tt-----------------------------
-#-----tt#-#--tt---#--tt-##-----#--#--tttt-------#---tt---------tttt----#------tt#-tt-----tt-----tt---tt-tt--------tt#-#---#----tttt--#---tt-##-tt--#-----tt----tt--#--#-tt#############################
-#-g---tt#-#--tt-#-#g-tt-###k-#-#-##ggtttt-k-k---###-tt#k--gg---ttttgg-k#g-----tt#-tt-g---tt-g---tt---ttgtt-----g-ktt#-#--##--#-ttttg-#gk-tt-###ttg-#k--#gttk--gtt-##--#-tt############################F
XX-XX--XXX-XX-XXXX-XXXXXXXXXXXX-XXXXXXXXXXXXXXX-XXXXXXXXX-XXXXXXXXXXXXXXXXXXXXXXXX-XXXXXXXXX-XXXXXX-XXXXXXXX-XXXXXXXXXXX-XXXXXXXXXXXXXXXXXXXXXXXXXXXXXX-XXXXXXXXXX-XXXXX-XXXXXXXXXXXXXXXXXXXXXXXXXXXXXXX
XX-XX--XXX-XX-XXXX-XXXXXXXXXXXX-XXXXXXXXXXXXXXX-XXXXXXXXX-XXXXXXXXXXXXXXXXXXXXXXXX-XXXXXXXXX-XXXXXX-XXXXXXXX-XXXXXXXXXXX-XXXXXXXXXXXXXXXXXXXXXXXXXXXXXX-XXXXXXXXXX-XXXXX-XXXXXXXXXXXXXXXXXXXXXXXXXXXXXXX
