--------------------------------------------------------------------------------------------------------------------------------------------------------------------------------------------------------
--------------------------------------------------------------------------------------------------------------------------------------------------------------------------------------------------------
--------------------------------------------------------------------------------------------------------------------------------------------------------------------------------------------------------
--------------------------------------------------------------------------------------------------------------------------------------------------------------------------------------------------------
--------------------------------------------------------------------------------------------------------------------------------------------------------------------------------------------------------
---S-----S--U---S---SS----------U-----------------------SSUU--------------U---U---U--U--U----U-S-----S---------S-------U----S---------------------------------------------------------S-----------------
------C--------C---------------------------------------------C------------------------------------------------------------------------C-----------------------------------------------------------------
--------------------------------------------------------------------------------------------------------------------------------------------------------------------------------------------------------
--------------------------------------------------------------------------------------------------------------------------------------------------------------------------------------------------------
--------------------------------------------------------------------------------------------------------------------------------------------------------------------------------------------------------
----ttStt---C--S-ttS-----tt-----C--------#------#----#-S--CC-S-U----UCCCCSCSC-C-C-C-CC--C---SC---------S---Stt#------C-C-C----U--tt---S----#----------------------tt------------------------------------
----tt-tt--#-----tt------tttt------#---tt#--#--##---##--------#--tt-----------------------tt----------------tt#----------------#-tt--------##--------------#------tt--------------------------#-#-#-----
-#--tt-tt--#-----tt------tttt----tt#---tt##-#-###--###--------#--tt-----------------------tt----#-----------tt#-----#----------#-tt-tt-----##--------------#------tt--------------------------#-#-#-----
-#--tt-ttg-#-----tt---gg-tttt----tt#--gtt##-#####g####------g-#--tt#------------------g--gtt----#--------gg-tt#g-g#-#-------gk-#gttgtt-----##--------------#------tt--------------------------#-#-#----F
%|%%||%|||%|%%%%%||%%%||%||||-%%%|||%%|||||-||||||||||-%--%%|%|%%|||%%%%%%%%%%%%%%%%%%|%%|||%%%%|%-%%-%%-||%||||%||-|%%%%%%%||%|||||||%%%%%||%%%%%%%%%%%%%%|%%%%%%||%%%%%%%%%%%%%%%%%%-%%%%%%%|%|%|%%%%%
|||||||||||||||||||||||||||||-|||||||||||||-||||||||||-|--||||||||||||||||||||||||||||||||||||||||-||-||-||||||||||-||||||||||||||||||||||||||||||||||||||||||||||||||||||||||||||||||-|||||||||||||||||
