--------------------------------------------------------------------------------------------------------------------------------------------------------------------------------------------------------
--------------------------------------------------------------------------------------------------------------------------------------------------------------------------------------------------------
--------------------------------------------------------------------------------------------------------------------------------------------------------------------------------------------------------
--------------------------------------------------------------------------------------------------------------------------------------------------------------------------------------------------------
--------------------------------------------------------------------------------------------------------------------------------------------------------------------------------------------------------
---------------------B-----B--B---------B--------U------------B---------------------------------------B--B-------BB-------------U------B---B-B------B---------B-B---B-------------B--B-------B----------
-C-------C--------------------------C-------------------------------------------------------------------C----------------------------------------C---C--------------------------------------------------
--------------------------------------------------------------------------------------------------------------------------------------------------------------------------------------------------------
--------------------------------------------------------------------------------------------------------------------------------------------------------------------------------------------------------
--------------------------------------------------------------------------------------------------------------------------------------------------------------------------------------------------------
BBtt--B--Btt-C-----UB-B----------#-UBU-U-tt--U--UC--U--------U--------U--B--U--------------tt------BB---B--B--tt---C-##-#-------C-UC-------------B---B--#------C--CU---Utt------#---#-----B-U--#-tttttt-
--tt------tt---tt-----------tt---##------tt-------tt-----tt----#--#-------tt--#----------#-tt-------------#---tt-----##-#----#-----------------tt--#----#------------tt-tt------#---#----------#-tttttt-
--tt------tt---tt--------tt-tt---##---#--tt-------tt--#--tt----##-#-----#-tt--##-tt-tt---#-tt-tt-tt-------#---tt----###-#-tt-#----------tt-----tt--#----#tt----------tt-tt------#---#---#------#-tttttt-
--tt---kg-tt---ttkg------tt-tt--k##---#--ttg--#---tt-g#ggttgg--####kg--g#-tt--###tt-tt-k-#-tt-tt-tt----g--#-#-ttkgg-###g#-tt-#gg-k--#-#-tt-----tt-##g---#tt-g---gg--gtt-tt#g--gk#-g-#g-g#--k---#-ttttttF
XXXX--XXXXXXXXXXXXXXX-XXXXXXXXX-XXXXXXXXXXXXXXXXXXXXXXXXXXXXXXXXXXXXXXXXXXXXXXXXXXX-XXXXXX-XXXXXXXXXXX-XXXXXXXXXXXXXXXXXXXXXXXXXXXXXXXX-XXX-XXXXXXXXXX-XXXXXXXXXXXXXXXXXXXXXXXXXXXXXXXXXXXXXXXXXXXXXXXXX
XXXX--XXXXXXXXXXXXXXX-XXXXXXXXX-XXXXXXXXXXXXXXXXXXXXXXXXXXXXXXXXXXXXXXXXXXXXXXXXXXX-XXXXXX-XXXXXXXXXXX-XXXXXXXXXXXXXXXXXXXXXXXXXXXXXXXX-XXX-XXXXXXXXXX-XXXXXXXXXXXXXXXXXXXXXXXXXXXXXXXXXXXXXXXXXXXXXXXXX
