--------------------------------------------------------------------------------------------------------------------------------------------------------------------------------------------------------
--------------------------------------------------------------------------------------------------------------------------------------------------------------------------------------------------------
--------------------------------------------------------------------------------------------------------------------------------------------------------------------------------------------------------
--------------------------------------------------------------------------------------------------------------------------------------------------------------------------------------------------------
--------------------------------------------------------------------------------------------------------------------------------------------------------------------------------------------------------
-----U-UB-----UB---B-BB-B-B-----B---BBB---------------------------U-----BU---B-B----U--------------U----B-------B-------------B------B-------B-B-BB-BB-------U-------------------U----------------------
----C-C---C---------------------------------------------------------C-----------------------------------------------------------------------------------------------------------------------------------
--------------------------------------------------------------------------------------------------------------------------------------------------------------------------------------------------------
--------------------------------------------------------------------------------------------------------------------------------------------------------------------------------------------------------
--------------------------------------------------------------------------------------------------------------------------------------------------------------------------------------------------------
ttU-BCBC-UB-ttC-----C--------------B---U----U------------------tt-C-B--#-C-------B--Ctttttt--#-----C-C---------#----C----U--UC------------------B--B--BCBB-BBCBCBB--BB-BBCBB-BBCBCBCB-BBBBB-BBBBBBBBBBBB
tt----------tt----------------------------tt---------#--#------tt------#-------------tttttt--#----------------##-#-----tt-tt----tt-#--tt----------------------------------------------------------------
tt----------tt--------------#-#---------#-tt---tt---###-#------tt------#--tt---------tttttt--#--------------tt##-##----tt-tt----tt-#--tt-tttt-----------------------------------------------------------
tt---------ktt---g-g-g--g--g#g#-------g-#gtt---ttg-####-##-g--ktt----kg#--tt-g-gg-gg-tttttt--#-k-#-------#--tt##-###-k-tt-tt---gtt-#-gtt-tttt-#--------------------------------------------------------F
XXXXXXXXXXXXXXXXXX-XXX-XXX-XXXXXX-XX--XXXXXXX--XXXXXXXX-XXXX-XXXXXXXXXXX-XXXXXXXXXXXXXXXXXXX-X-X-XXXXX--XXXXXXXXXXXXXXXXXXXXXX-XXX-XXXXXXXXXX-XXXXXXXXXXXXXXXXXXXXX-XXXXXXXXXXXXXXXXXXXXXXX-XXXXXXXXXXXX
XXXXXXXXXXXXXXXXXX-XXX-XXX-XXXXXX-XX--XXXXXXX--XXXXXXXX-XXXX-XXXXXXXXXXX-XXXXXXXXXXXXXXXXXXX-X-X-XXXXX--XXXXXXXXXXXXXXXXXXXXXX-XXX-XXXXXXXXXX-XXXXXXXXXXXXXXXXXXXXX-XXXXXXXXXXXXXXXXXXXXXXX-XXXXXXXXXXXX
