--------------------------------------------------------------------------------------------------------------------------------------------------------------------------------------------------------
--------------------------------------------------------------------------------------------------------------------------------------------------------------------------------------------------------
--------------------------------------------------------------------------------------------------------------------------------------------------------------------------------------------------------
--------------------------------------------------------------------------------------------------------------------------------------------------------------------------------------------------------
--------------------------------------------------------------------------------------------------------------------------------------------------------------------------------------------------------
--SUS-----U----S---SS-S-S------U----S--S--------------USUS---------S--------S-----U-----------S------S-SS-S----U-----------------------S--SS-SSS-SS-SS-SS-SSSSS--SS-SSSSSS-SSSSSSS-SS-SSSSSSSSSSSSSSSSSS
-----C----------C----------------------------------------------C---------C------------------------------------------------------------------------------------------------------------------------------
--------------------------------------------------------------------------------------------------------------------------------------------------------------------------------------------------------
--------------------------------------------------------------------------------------------------------------------------------------------------------------------------------------------------------
--------------------------------------------------------------------------------------------------------------------------------------------------------------------------------------------------------
---C-S----C---#-S-S--S-#-#---C#C--tt-#--SS-----------CC-C---C--S------S--S--------C--------------CC-#---------CC-#U------------S------------S---C--S--S--S---------S------S-------S--S------------------
-#------------#--------#-#----#---tt-#-------tt-#------------tt-------------------------------------#------#-----#--tt--tt---#-----tt-#------------------------tt---------------------------------------
-#----------tt#--------#-#----#---tt-#-------tt-#--tt--------tt--------------tttt---tt--tt-tt--##---#------##----#--tttttttt-#-----tt-#-tt---------------------tt---------------------------------------
-#g-g---g--gtt#--g-----#g#--g-#-#gtt-#g---#-gtt##k-tt--g-g---tt-#gg-##-g--g-gtttt#--tt--tt-tt#-##---#gg----###--g#-gttttttttg#----gtt##-tt---------------------tt--------------------------------------F
%||%|%%-|%%||||-%|%%%%-|||%%|%|%||||%||%%%|%||||||%||%%|%|%%%||%|||%||%|%%|%||||||%%||%%||%|||%||%%%|||%%%-|||%%||%|||||||||||%%%-|||||-||%%%%%%%%%%%%%%%%%%%%%||%%%%%%%%%%%%%%%%%%%%%%%%%%%%%%%%%%%%%%%
|||||||-|||||||-||||||-|||||||||||||||||||||||||||||||||||||||||||||||||||||||||||||||||||||||||||||||||||-||||||||||||||||||||||-|||||-||||||||||||||||||||||||||||||||||||||||||||||||||||||||||||||||
