--------------------------------------------------------------------------------------------------------------------------------------------------------------------------------------------------------
--------------------------------------------------------------------------------------------------------------------------------------------------------------------------------------------------------
--------------------------------------------------------------------------------------------------------------------------------------------------------------------------------------------------------
--------------------------------------------------------------------------------------------------------------------------------------------------------------------------------------------------------
--------------------------------------------------------------------------------------------------------------------------------------------------------------------------------------------------------
SS---S-------S-U---------------U---U----------U-SU---S-------------S-S--------U---S---------S------------S-S------------------------------------------------U----------------------S--------------------
------------------------------------------------------------------------------------------------------------C-----------------C-------------------------------------------------------------------------
--------------------------------------------------------------------------------------------------------------------------------------------------------------------------------------------------------
--------------------------------------------------------------------------------------------------------------------------------------------------------------------------------------------------------
--------------------------------------------------------------------------------------------------------------------------------------------------------------------------------------------------------
--S--------##-UC------ttCC-#---C-C-C--C-------C--C----US-----tt-----C-#-------C--------tt----S----tt----C---S#-#--------------S---tt-------------------#----C--------------C----------------------------
---tt-----###---#-----tt---#tt--------------#--#---tt---#---#tt-------#tt------#-------tt-----tt--tt---------#-#------------------tt-------------------#------------------------------------------------
---tt--tt####---##--#-tt---#tt-----------#--#--#---tt---##-##tt-tt----#tt------##---tt-tt-tt--tt--tt-tt------#-#-----#---tt-------tt-------------tt---##------------------------------------------------
-g-ttggtt####---###-#-tt---#tt-------g-#-#g-#--#---tt---#####tt-tt---g#tt------###--tt-tt-tt--tt--tt-tt----g-#-#kkkkk#kkkttkkk-#kktt-g-k---kkkkkkttkkk##kkkk-kkkkkkkkkkkkkk-kkkkk-kgkkkkkkkkkkkkkkkkkkkF
-|%||||||||||%%%|||-|%||%%%|||%%%%%%%|%|-||%|%%|%%%||%%%|||||||%||%%%||||-%%%%%|||%%||%||%||-%||%%||%||%%%%|%|%|||||||||||||||%|||||%|%|%%%|||||||||||||||||%||||||||||||||%|||||%|||||||||||||||||||||%
-||||||||||||||||||-||||||||||||||||||||-||||||||||||||||||||||||||||||||-||||||||||||||||||-|||||||||||||||||||||||||||||||||||||||||||||||||||||||||||||||||||||||||||||||||||||||||||||||||||||||||||
