--------------------------------------------------------------------------------------------------------------------------------------------------------------------------------------------------------
--------------------------------------------------------------------------------------------------------------------------------------------------------------------------------------------------------
--------------------------------------------------------------------------------------------------------------------------------------------------------------------------------------------------------
--------------------------------------------------------------------------------------------------------------------------------------------------------------------------------------------------------
--------------------------------------------------------------------------------------------------------------------------------------------------------------------------------------------------------
------------------B-----------U------------------------BB--B--------B---------------U------------------------BBB-BB-B-BB-BB-BB-B--B---B-BU----U---------------------------------------------------------
-C----------------------------------------------------------------C------------------C--------------C-C-C-C---------------------------------------------------------------------------------C-----------
--------------------------------------------------------------------------------------------------------------------------------------------------------------------------------------------------------
--------------------------------------------------------------------------------------------------------------------------------------------------------------------------------------------------------
--------------------------------------------------------------------------------------------------------------------------------------------------------------------------------------------------------
CB--tt----U---###--------#--C-C-C--#------------B-----B---#----ttCB--U--------------CB---------#--#BBBBBBBBBB---B--B-B--B--B--U----U-U-U-CUUUUC#UUU-UUUUU---ttUUUUUUUUUUUUUUUUUUUUUUUUUUUUUUBUUUUUUUUUUU
--tttt-------####---#---##--------##----------------------#----tt--------#-----#---------#----##--#--------------------------------------------#-----------#tt------------------------------------------
--tttt-tt---#####---##-###-------###--------------tt------#----tt------#-#-----##--#-----##--###--#-----------------------------tt-------------#---------#-#tt------------------------------------------
--tttt-tt--######ggg######k------###--------------tt------#gg-gtt-----##-#-----###-#---kg###-###--#-----------------------------ttg------------#---------#-#tt-----------------------------------------F
XXXXXXXXXXXXXXXXXXXXXXXXXXXXXXXXXXXXXX-XX-XX-XXXXXXXX-XXXXXXXXXXXXX-XXXX-XX-XXXXXX-XXXXXXXXX-XXXXXXXXXXXXXXXXXXXXXXXXXXXXXXXXXX-XXXXXXXXXXXXXXXXXXXXXXXXXX-XXXXXXXXXXXXXXXXXXXXXXXXXXXXXXXXXXXXXXXXXXXXX
XXXXXXXXXXXXXXXXXXXXXXXXXXXXXXXXXXXXXX-XX-XX-XXXXXXXX-XXXXXXXXXXXXX-XXXX-XX-XXXXXX-XXXXXXXXX-XXXXXXXXXXXXXXXXXXXXXXXXXXXXXXXXXX-XXXXXXXXXXXXXXXXXXXXXXXXXX-XXXXXXXXXXXXXXXXXXXXXXXXXXXXXXXXXXXXXXXXXXXXX
