--------------------------------------------------------------------------------------------------------------------------------------------------------------------------------------------------------
--------------------------------------------------------------------------------------------------------------------------------------------------------------------------------------------------------
--------------------------------------------------------------------------------------------------------------------------------------------------------------------------------------------------------
--------------------------------------------------------------------------------------------------------------------------------------------------------------------------------------------------------
--------------------------------------------------------------------------------------------------------------------------------------------------------------------------------------------------------
-------------SSSSU-------SS------------------S---------SS---------S-SS---------U---S-----------SS----------------------------------------S-------------------S------------------------------------------
--------------------------------C----------C---------------C----------C-----------C---------------------------------------------------------------------------------------------------------------------
--------------------------------------------------------------------------------------------------------------------------------------------------------------------------------------------------------
--------------------------------------------------------------------------------------------------------------------------------------------------------------------------------------------------------
--------------------------------------------------------------------------------------------------------------------------------------------------------------------------------------------------------
----tt----tt-----C---#--S-----#-SS---------S--------U#S----SU--tt--S--S-#------C-CS-#----#----S--tt---###-S---###---##U#C###---#----#####-########U#####--###-##--#--###################-##########-----
----tt----tt--------##-------##----------------------#----#----tt-------#---tt------#---###--#---tt--####----####--###-#-###--##tt--#####-########-#####--###-##--#--###################-##########-----
----tt-tt#tt-------###-#----###----tt----------------#----#--tttt-------#tt-tt------#--#####-#---tt-#####---#####-####-#-###-###tt--#####-########-#####--###-##--#--###################-##########tttt-
----tt-tt#ttk-g---####k#---####----ttgkg-----gg------#----#--tttt#g-----#ttgtt------#-########---tt######k-###########-#-#######tt--#####g########-#####--###-##--#--###################k##########ttttF
%%--||%||||||%|%-%||||||%--||||-%%%|||||%%-%%||%-%%%%|%%%%|%%||||||%%%%-||||||%%%%%-|%||||||||%--|||||||||%|||||||||||%|%|||||||||%%||||||||||||||%|||||%%|||-||%%|%%||||||||||||||||||||||||||||||||||%
||--||||||||||||-||||||||--||||-||||||||||-|||||-||||||||||||||||||||||-|||||||||||-|||||||||||--||||||||||||||||||||||||||||||||||||||||||||||||||||||||||||-||||||||||||||||||||||||||||||||||||||||||
