--------------------------------------------------------------------------------------------------------------------------------------------------------------------------------------------------------
--------------------------------------------------------------------------------------------------------------------------------------------------------------------------------------------------------
--------------------------------------------------------------------------------------------------------------------------------------------------------------------------------------------------------
--------------------------------------------------------------------------------------------------------------------------------------------------------------------------------------------------------
--------------------------------------------------------------------------------------------------------------------------------------------------------------------------------------------------------
----------S-----------------U-----------------------------------U---U------------UU---------U-----------------S----------S-S------------------------------------------------S---------------------------
-----------------------------C-C-C-C-C-C-C-C-C-C-C---------------C---------------------------------------------------C-C--C--C--CC---CC-CCC-CC-C-C-C-C-C-CCCCCCCCCCCCCCCC-CC-CCCCCCC-C-C-C-CCCCCCCCCCCCC
--------------------------------------------------------------------------------------------------------------------------------------------------------------------------------------------------------
--------------------------------------------------------------------------------------------------------------------------------------------------------------------------------------------------------
--------------------------------------------------------------------------------------------------------------------------------------------------------------------------------------------------------
#--S----#--C#------U---S--U-CSSSSSSSSSSSSSSSSSSSSS--------------CSttC-C----#C--ttCC-----tt-SC------tt-------C--------S-SU-S--S--SS--CSSCSSSUSSSSSSSSSSSSSSSSSSSSSSSSSSSSS#SS-SSSSSSS-S-S#S#SSSSSSSSSSSSS
#------##---#--------------------------------------tt-------------tt---tt-##---tt---tt--tt-----#---tt-----------#--------------------------------------------------------#--------------#-#-------------
#-#---###---#--#----#---tt-------------------------tt##---tt------tt---tt###---tt---tt-#tt----###--tt-tt-tt-----#-tt----------tt-----------------------------------------#--------------#-#-------------
#k#--####gg-##-#g---#kk-tt-------------------------tt##k--ttg-g#--tt-g-tt###-g-tt--gtt-#tt---#####-tt-tt-ttk-gg-#-tt--k-----g-tt-----------------------------------------#--g-----------#-#------------F
|||%%||||||%||-||%%%|||%||%%%%%%%%%%%%%%%%%%%%%%%%%|||||%%|||%||%%||%|%|||||%|%||%%|||-|||%%%|||||%||%||%|||%||%|%||-%|%%-%%|%||%%%%%%%%%%%%%%%%%%%%%%%%%%%%%%%%%%%%%%%%%|%%|%%%%%%%%%%%|%|%%%%%%%%%%%%%
||||||||||||||-|||||||||||||||||||||||||||||||||||||||||||||||||||||||||||||||||||||||-|||||||||||||||||||||||||||||-||||-||||||||||||||||||||||||||||||||||||||||||||||||||||||||||||||||||||||||||||||
