--------------------------------------------------------------------------------------------------------------------------------------------------------------------------------------------------------
--------------------------------------------------------------------------------------------------------------------------------------------------------------------------------------------------------
--------------------------------------------------------------------------------------------------------------------------------------------------------------------------------------------------------
--------------------------------------------------------------------------------------------------------------------------------------------------------------------------------------------------------
--------------------------------------------------------------------------------------------------------------------------------------------------------------------------------------------------------
S-------S-------U---S----S----------S----------------SS---U--S----S-S-S--------SSS---------------------U------------------------------------------------------------------------------------------------
--C----------------C------------------C-----------------------------------------------------------------------------------------------------------------------------------------------------------------
--------------------------------------------------------------------------------------------------------------------------------------------------------------------------------------------------------
--------------------------------------------------------------------------------------------------------------------------------------------------------------------------------------------------------
--------------------------------------------------------------------------------------------------------------------------------------------------------------------------------------------------------
--S--------C##--C--S-C----U-----------S-------------S---CSCSC---tt----------CCS---C----------------CSS-CSSCSS-SS-CSS-CSS-SCSS-CSS--SSSS--SCSS-SCSS-S-S--CSS-SSSSSCSS-CSS-SCSS-SSSCCCCSS-SSSSSSSSSSSSSSSS
---#--------##--------#-#---tt------------#---tt----------------tt-----#-----------#----#tt-------#------------------------------------tt-------------tt------------------------------------------------
---#--tt----##--------#-#---tt---tt-----tt##--tt--#-----------tttt-----##--#-------#-tt-#tt--tt-#-#------------------------------------tt-------------tt------------------------------------------------
-g-#--tt-#--###g--g---#k#g--ttk--tt#-g-gtt###gtt#-#-----------tttt---g-###-#-------#-tt-#tt--tt##-#-------------g-----------------g----tt-------------tt-----------------------------------------------F
-|%|%%||-|%%||||%%|%%%||||%%|||%%|||-|%||||||||||-|%%%%%%%%%%-||||-%-|-|||-|%%%--%%|%||-|||%%||||-|%%%%%%%%%%%%%|%%%%%%%%%%%%%%%%%|%%%%||%%%%%%%%%%%%%||%%%%%%%%%%%%%%%%%%%%%%%%%%%%%%%%%%%%%%%%%%%%%%%%
-|||||||-|||||||||||||||||||||||||||-||||||||||||-|||||||||||-||||-|-|-|||-||||--||||||-|||||||||-||||||||||||||||||||||||||||||||||||||||||||||||||||||||||||||||||||||||||||||||||||||||||||||||||||||
