--------------------------------------------------------------------------------------------------------------------------------------------------------------------------------------------------------
--------------------------------------------------------------------------------------------------------------------------------------------------------------------------------------------------------
--------------------------------------------------------------------------------------------------------------------------------------------------------------------------------------------------------
--------------------------------------------------------------------------------------------------------------------------------------------------------------------------------------------------------
--------------------------------------------------------------------------------------------------------------------------------------------------------------------------------------------------------
-----------------------U---B--B---BU--B---------------------B-------------------B-------B--BU------------------------------------------B--B-------------------------------------------------------------
------------------------------------------------------C---C---------------------------------------------------------------------------------------------------------------------------------------------
--------------------------------------------------------------------------------------------------------------------------------------------------------------------------------------------------------
--------------------------------------------------------------------------------------------------------------------------------------------------------------------------------------------------------
--------------------------------------------------------------------------------------------------------------------------------------------------------------------------------------------------------
ttU--tt--tt------------C-----------C---U---CC-#------UB---B---------#--tt--#tttt-#Ctt-----U-C-B--#------------------------C------------------------------------tt---------------------------------------
tt---tt--tttt---#--------tt-#-----------------#tt-#----tt-----------#--tt--#tttt-#-tt-----------##--------------------------------------------------#----------tt----------------------------tt---------
tt---tt--tttt-#-##-------tt-#-------tt--------#tt-##---tt-----tt----#tttt--#tttt-#-tt-tt-------###---------------------#-----------------------tt---#----------tt-tttt-----------------------tt---------
tt--gtt--ttttk#-##------#tt-#--g--g-tt--gg----#tt-###--ttg-#-gtt-g-g#tttt--#tttt-#-tt-tt---g-k-###---------------g---#-#---------------g----g--tt---#--k-------tt-tttt------------k----------tt--------F
XXXXXXXXXXXXXXX-XXX-XXXXXXXXX--XXXXXXX-XXXXXXXXXXXXXXXXXXXXXXXXXXXXXXXXXXXXXXXXXXXXXXXXXX-XXXXXXXXX-XX-XX-XXX-XX-X--XX-X--X-X-XX-XXXX--X--X-X--XX--XX--X--X-X--XX-XXXXXXXXXXXXXXXXXXXXXXXXXXXXXXXXXXXXXX
XXXXXXXXXXXXXXX-XXX-XXXXXXXXX--XXXXXXX-XXXXXXXXXXXXXXXXXXXXXXXXXXXXXXXXXXXXXXXXXXXXXXXXXX-XXXXXXXXX-XX-XX-XXX-XX-X--XX-X--X-X-XX-XXXX--X--X-X--XX--XX--X--X-X--XX-XXXXXXXXXXXXXXXXXXXXXXXXXXXXXXXXXXXXXX
