--------------------------------------------------------------------------------------------------------------------------------------------------------------------------------------------------------
--------------------------------------------------------------------------------------------------------------------------------------------------------------------------------------------------------
--------------------------------------------------------------------------------------------------------------------------------------------------------------------------------------------------------
--------------------------------------------------------------------------------------------------------------------------------------------------------------------------------------------------------
--------------------------------------------------------------------------------------------------------------------------------------------------------------------------------------------------------
S---U-SSS-----------------------S--------SS------S----SS--U--U-----U-U--------------U-S---------------------S--S----S--U------U----U----S----S-----------US-------------S------S-S----------------------
---C---------------C--C-------------------------------------------------------------------------------------------C-------------------------------------------------------------------------------------
--------------------------------------------------------------------------------------------------------------------------------------------------------------------------------------------------------
--------------------------------------------------------------------------------------------------------------------------------------------------------------------------------------------------------
--------------------------------------------------------------------------------------------------------------------------------------------------------------------------------------------------------
---SCS-------------S-#Stt-----tt--tt-------Utt----C--#----C-SCtt-ttC#C------tt------C--U--------#--tt------#------S--C-C----#-C----C---#-------#-----S#ttC--C-----U--ttU----U------tt-------------------
-------------tt------#-tttttt-tt--tt-tt-----tt--#----#--------tt-tt-#-------tt----tt-----------##--tt---##-#-#-----#-----tt-#----tt---##-------#------#tt------------tt---------#--tt-------------------
-------------tttt----#-tttttt-tt--tt-tt-----tt--#----#--tt----tt-tt-#-tt----tt-tt-tt----------###-#tt-tt##-#-#-----#-----tt-#----tt--###--tt---#------#tt------------tt---tt----#--tt-------------------
--g------k---tttt-k-k#-tttttt-tt--tt-tt-g---ttk-#---g#--tt----tt-tt-#-tt----tt-ttktt-g---g---####g#tt-tt##-#-#-g-g-#--g-ktt-#g-g-tt-####-#ttgg-#g-k---#tt----g--k--g-tt-g-tt-kk-#-gtt------------------F
-%|%%%%%%|%%%||||%|%||%||||||%||-%||%||-|%-%|||%|%%%||%-||%%%%||%||%|%||%%%%||%|||||%|-%%|%%%||||||||%||||%|%|%|%|%|-%|%|||-||%|%||%||||%|||||%||-|-%%|||%--%|%-|%%|%||%|%||%||-|-|||%%%%%%%%%%%%%%%%%%%
-|||||||||||||||||||||||||||||||-||||||-||-||||||||||||-||||||||||||||||||||||||||||||-|||||||||||||||||||||||||||||-||||||-|||||||||||||||||||||-|-||||||--|||-|||||||||||||||-|-||||||||||||||||||||||
