--------------------------------------------------------------------------------------------------------------------------------------------------------------------------------------------------------
--------------------------------------------------------------------------------------------------------------------------------------------------------------------------------------------------------
--------------------------------------------------------------------------------------------------------------------------------------------------------------------------------------------------------
--------------------------------------------------------------------------------------------------------------------------------------------------------------------------------------------------------
--------------------------------------------------------------------------------------------------------------------------------------------------------------------------------------------------------
----------BU-----BBBB--B---------------B----BB----------------------BU----------------B---------BB-----------B--------B--U----B---------------------B--------------UB-B-B--------B----------------------
----------------------------C----------------------------------C-------------------------------------------------------------------C----C------------------------C--------------------------------------
--------------------------------------------------------------------------------------------------------------------------------------------------------------------------------------------------------
--------------------------------------------------------------------------------------------------------------------------------------------------------------------------------------------------------
--------------------------------------------------------------------------------------------------------------------------------------------------------------------------------------------------------
C----#-C-B-C----------------B---#tt-------UB------#-CUtt------CB-----C---------tt------C#--U---B---CBB-#----------#------C-----B---B----BU---------#-tt----------B-C------------------------------------
--tt-#-------------------#-----##tt--------------##---tt#tt--#---------#-------tt-------#--------------#----------#---------tt--------tt------tt---#-tt-----#-------------------------------------------
--tt-#---------tt--------##---###tt-tt----------###---tt#tt#-#----tt---##--#---tt#------#tt--tt---#----#---tt--#--#-------tttt---#----tt------tt-tt#-tt---#-#-------------------------------------------
-#ttg#k---g-kk-tt-----#--###-####tt-tt-g-g----k####g--tt#tt#-#--#-ttg--###-#g-gtt#g-k-g-#tt-gtt---#----#g--tt--#kg#-------ttttg--#g---tt---k-gttgtt#-ttg-g#-#-----#--#-#-#######--#####################F
XXXXXXXXXXXXXXXXXXXX-XX-XXXXXXXXXXXXXX-XXXXX--XXXXXXXXXXXXXX-XXXXXXXXXXXXX-XXXXXXXXXXXXXXXXXXXXX--XXXXXXXXXXXXXXXXXXXXXXXXXXXXXXXXXXXXXXXXXXXXXXXXXXXXXX-XX-X--XXXXXXXXXXXXXXXXXX-XXXXXXXXXXXXXXXXXXXXXX
XXXXXXXXXXXXXXXXXXXX-XX-XXXXXXXXXXXXXX-XXXXX--XXXXXXXXXXXXXX-XXXXXXXXXXXXX-XXXXXXXXXXXXXXXXXXXXX--XXXXXXXXXXXXXXXXXXXXXXXXXXXXXXXXXXXXXXXXXXXXXXXXXXXXXX-XX-X--XXXXXXXXXXXXXXXXXX-XXXXXXXXXXXXXXXXXXXXXX
