--------------------------------------------------------------------------------------------------------------------------------------------------------------------------------------------------------
--------------------------------------------------------------------------------------------------------------------------------------------------------------------------------------------------------
--------------------------------------------------------------------------------------------------------------------------------------------------------------------------------------------------------
--------------------------------------------------------------------------------------------------------------------------------------------------------------------------------------------------------
--------------------------------------------------------------------------------------------------------------------------------------------------------------------------------------------------------
--SS--SS----SS---SS-----U-----U-------S-S------S---U-------S----SU--S-----S--S--S--U----S---S-------SS----------U--S--U------SSU--------------S-U-U----UUUUUUS--U--U-UUUU-UUUUUUU-UUUUUUUUUSUUUUUUUUUUUU
-------------------------C------------------------------------C----------------------------------------------------------------------------C------------------------------------------------------------
--------------------------------------------------------------------------------------------------------------------------------------------------------------------------------------------------------
--------------------------------------------------------------------------------------------------------------------------------------------------------------------------------------------------------
--------------------------------------------------------------------------------------------------------------------------------------------------------------------------------------------------------
-S---S-----S----S--US---CS----C-----C-----#---S----CU-tt-----SS--C#--tt--------C---CCSS-------------------------C-----CC-------C---##U---S-S----CSC----CCCCCC-CSCSCC-CCCCUCCCCCCC-CCCCCCCCC-CCCCCCCCCCCC
----------------------------tt-#----------##----------tt----------#--tt------------------tt----------------------tt--#--#----------##-----------------#-------------------------------------------------
--------tt------------------tt-#----------###----#----tt-tt-------#--tt-tt---------------tt--tt#---#----tt-------tt--#--#tt--------##---#-----------#-#-------------------------------------------------
g-------ttg----#------#g--ggtt-#-g-g-#-#--####-g-#----tt-tt-g-----#k-tt-tt-gk---g-#------ttk-tt#-#-#----tt-----#-tt-k#--#ttg--g-g--##-#-#-k-k#g----g#-#--------------------------#---------------------F
|%--%%%%|||%%%%|%--%%%||%%||||%|-|-|%|-|%%||||%|%|%%%%||%||%|%%%-%||%||%||%||--%|%|%%%%%-|||%|||%|-|%%%%||-%%%%|%||%||%%||||%%|%|%%||%|-|%|%|||%%%%||-|%%%%%%%%%%%%%%%%%%%%%%%%%%|%%%%%%%%%-%%%%%%%%%%%%
||--|||||||||||||--|||||||||||||-|-|||-|||||||||||||||||||||||||-||||||||||||--|||||||||-|||||||||-|||||||-||||||||||||||||||||||||||||-|||||||||||||-|||||||||||||||||||||||||||||||||||||-||||||||||||
