--------------------------------------------------------------------------------------------------------------------------------------------------------------------------------------------------------
--------------------------------------------------------------------------------------------------------------------------------------------------------------------------------------------------------
--------------------------------------------------------------------------------------------------------------------------------------------------------------------------------------------------------
--------------------------------------------------------------------------------------------------------------------------------------------------------------------------------------------------------
--------------------------------------------------------------------------------------------------------------------------------------------------------------------------------------------------------
S----------------SS-SS---S-------------------------------U--S------S----------------------S-------------------------------S-----------------------------------------------------------------------------
----C---------------------C-CC------------------------------------------------------------------C-------------------------------------------------------------------------------------------------------
--------------------------------------------------------------------------------------------------------------------------------------------------------------------------------------------------------
--------------------------------------------------------------------------------------------------------------------------------------------------------------------------------------------------------
--------------------------------------------------------------------------------------------------------------------------------------------------------------------------------------------------------
-#USS------##--#S--S------S#SSS--------------tt--------C-C---tt---#---------U#---tt----C------#US---------#---------U-U-------------------tt---------------U-tt--------------#---------------UUUUUUU-U--
-#--------###--#-----------#-------------##--tt-----tt--#----tt--##----#-----#--#tt-tt-------##---tt-#---##-------------------------------tt--#---#---#------tt---------#---##--------------------------
-#-----#-####--#-----------#------------####-tt-tt--tt--#----tt-###---###----##-#tt-tt------###---tt###-###tt#----##-#--##--##############tt#-##-###-###--#-#tt########-##-##################-----------
-#---#-######--#-------g-g-#---g-----k-######tt-ttkktt--#----tt####-#-####k--##-#tt#tt----g####---tt#######tt#--#-##-#--##--##############tt#-###########-#-#tt########-#####################-------g-gF
%|%%%|-||||||%%|%--%%%%|%|%|%%%|%-%%%|%||||||||%||||||%%|%%%-||||||%|-|||||%%||-||||||%%%%|||||%%%||||||||||||%-|-||%|%%||%%|||||||||||||||||-|||||||||||-|%|||||||||||-|||||||||||||||||||||%%%%%%%|%|%
||||||-||||||||||--||||||||||||||-||||||||||||||||||||||||||-||||||||-|||||||||-|||||||||||||||||||||||||||||||-|-|||||||||||||||||||||||||||-|||||||||||-|||||||||||||-||||||||||||||||||||||||||||||||
