--------------------------------------------------------------------------------------------------------------------------------------------------------------------------------------------------------
--------------------------------------------------------------------------------------------------------------------------------------------------------------------------------------------------------
--------------------------------------------------------------------------------------------------------------------------------------------------------------------------------------------------------
--------------------------------------------------------------------------------------------------------------------------------------------------------------------------------------------------------
--------------------------------------------------------------------------------------------------------------------------------------------------------------------------------------------------------
---S---S-------------------S----S--------------------U--------S-----S-------------------S--U--SSS---U-------------S--------U----S-S---U-------------------S---------------------------------------------
------------------C-C-C-----C-----------------------------------------C-C-C-C-C-C-C-C-------------------------------------C--------------C---------------C----------------------------------------------
--------------------------------------------------------------------------------------------------------------------------------------------------------------------------------------------------------
--------------------------------------------------------------------------------------------------------------------------------------------------------------------------------------------------------
--------------------------------------------------------------------------------------------------------------------------------------------------------------------------------------------------------
----U-------#--ttSSSSSS-----S----#---------------S--CC----C--C-#-----SSSSSSSSSSSSSSSS--U---CSS----C-C-C#----tt-Ctt-C----ttSCU#---U--S-C-#S-U-UC--#----#--S-----------------C---tt-----------------------
tt------#---#--tt-------tt---tt--#--tt-----tt--tt--------------#-tt-------------------#----------------#tt--tt--tt-----#tt---#tt--------#------#-#---##------------------------tt-----------------------
tt------#tt-#--tt-------tt---tt--#--tt-----tt--tt-#------------#-tt-------------------#----------------#tt--tt--tt-----#tt---#tt---#----#------#-#--###----tttttttttttttttt--tttttttttttttttttttttttttt-
ttg-----#tt-#--tt-------tt#g-tt--#k-tt#-#k-tt--tt-#g----g#-#g--#gttg-----------------##-g--------------#tt-ktt--tt--gk-#tt---#ttg-g#----#------#-#g####----tttttttttttttttt--ttttttttttttttttttttttttttF
|||%%%--|||%|%-||%%%%%%-||||%||-%||%|||%||%||%%||%||%%%%||%||%-|||||%%%%%%%%%%%%%%%%%||%|%-%%%%%%%%%%%%|||%|||%%||%%||%|||%%%||||%||%%%%|%%%-%%|%||||||%-%%||||||||||||||||%%||||||||||||||||||||||||||%
||||||--||||||-||||||||-|||||||-||||||||||||||||||||||||||||||-|||||||||||||||||||||||||||-|||||||||||||||||||||||||||||||||||||||||||||||||-|||||||||||-|||||||||||||||||||||||||||||||||||||||||||||||
