--------------------------------------------------------------------------------------------------------------------------------------------------------------------------------------------------------
--------------------------------------------------------------------------------------------------------------------------------------------------------------------------------------------------------
--------------------------------------------------------------------------------------------------------------------------------------------------------------------------------------------------------
--------------------------------------------------------------------------------------------------------------------------------------------------------------------------------------------------------
--------------------------------------------------------------------------------------------------------------------------------------------------------------------------------------------------------
----------------------------B---------BB--------------BB-BU---U-B----U---U---U---U---U---U---U---B-------U--------------U---B---B-----------BBB----BB-BBBB-BB-BB-BB-BB--BB-B-------B--------------------
-----------------------------------------------------------------C------------------------------------------------------------------------------C-------------------------------------------------------
--------------------------------------------------------------------------------------------------------------------------------------------------------------------------------------------------------
--------------------------------------------------------------------------------------------------------------------------------------------------------------------------------------------------------
--------------------------------------------------------------------------------------------------------------------------------------------------------------------------------------------------------
-B-------------#tt----------------##-B-----#--------------C---C#-BBCBCBCBCBCBCBCBCBCBCBCBCBC-C-C--B---#--C----U---C-#---C------------tt#---B---UBUB--B----B--B--B--B---B--------------------#-----------
----------#---##tt-#---------#---####-----###------------------#-------------------------------------##-------------#----------------tt#-----------------------------------------------#----#-----------
--tt-#--#-##-###tt###--------##-#####----####-----------#---tt-#------------------------------------###-------------#-------------tt-tt#-----------------------------------------------#----##----------
--tt-##-#-######tt####-------########---#####-----------#---tt-#g--------------------------------g-####-------------#--#----g----#tt-tt#-----------------------------------------------#----##---------F
XXXX-XX-X-XXXXXXXXXXXXXX-XXXXXXXXXXXXXXXXXXXXX-XXX-XXX-XX-XXXXXXXXXXXXXXXXXXXXXXXXXXXXXXXXXXXXXXXXXXXXXX-XXXXXXXXXXXXXXXXXXXXX-X-XXXXXXXXXXXXXXXXXXXXXXXXXXXXXXXXXXXXXXXXXXXXXXXXXX-XXXXXXXXXXXXXXXXXXXX
XXXX-XX-X-XXXXXXXXXXXXXX-XXXXXXXXXXXXXXXXXXXXX-XXX-XXX-XX-XXXXXXXXXXXXXXXXXXXXXXXXXXXXXXXXXXXXXXXXXXXXXX-XXXXXXXXXXXXXXXXXXXXX-X-XXXXXXXXXXXXXXXXXXXXXXXXXXXXXXXXXXXXXXXXXXXXXXXXXX-XXXXXXXXXXXXXXXXXXXX
