--------------------------------------------------------------------------------------------------------------------------------------------------------------------------------------------------------
--------------------------------------------------------------------------------------------------------------------------------------------------------------------------------------------------------
--------------------------------------------------------------------------------------------------------------------------------------------------------------------------------------------------------
--------------------------------------------------------------------------------------------------------------------------------------------------------------------------------------------------------
--------------------------------------------------------------------------------------------------------------------------------------------------------------------------------------------------------
------------U-----U---------U---------------UU-------S----SS-----U----------UU------------U-S--------SS----U--S------S---------S----SS-----U-U---S------------------------------------------------------
-----------C-----------------------------------C--------------------------------------------------------------------------------------------C-----------------------------------------------------------
--------------------------------------------------------------------------------------------------------------------------------------------------------------------------------------------------------
--------------------------------------------------------------------------------------------------------------------------------------------------------------------------------------------------------
--------------------------------------------------------------------------------------------------------------------------------------------------------------------------------------------------------
#-#--------SC-----CC-----CC-C-CC-----U--C---CC-S---tt-CU----S----C-#-tt----UCC----C----C--CC------------US-CSU----#-----tt--U---------S#---CSC--S------tttttt----U--------------------------------------
#-#---tt--------------#----------tt------#---------tt--------------#-tt--------------#---------#-----------------##---tttt-------------#--#-------#----tttttttttt-tttttttttttttttt-tttttt-tttt-tttttttt-
#-#---tttt------#---tt##---------tt------#---------tt---tt---------#-tt-tt#---tt---#-#--tt-----#----#--#--------###---tttt-------------##-#---tt--##---tttttttttt-tttttttttttttttt-tttttt-tttt-tttttttt-
#-#k-gttttg--g#-##--tt###--------tt-g-#g-#----g--kktt---tt----g-k-g#-tt-tt#---tt---#-#g-tt--g-g#-k#-#--#--g---g####g--tttt-g--g-g#---g-##-#---tt-g###ggtttttttttt-ttttttttttttttttgtttttt-ttttkttttttttF
|-||%||||||%%||-||%%|||||%%%%%%%%||%|%||%|%%%%|%%||||%%%||%%%%|%|%||%||%|||%%%||%%%|-||%||%%|-||%||-|--|%%|%%%||||||%-||||%|%%|%||%%-|%||-|%%%||%||||||||||||||||%|||||||||||||||||||||||%|||||||||||||%
|-|||||||||||||-||||||||||||||||||||||||||||||||||||||||||||||||||||||||||||||||||||-||||||||-|||||-|--||||||||||||||-||||||||||||||-||||-||||||||||||||||||||||||||||||||||||||||||||||||||||||||||||||
