--------------------------------------------------------------------------------------------------------------------------------------------------------------------------------------------------------
--------------------------------------------------------------------------------------------------------------------------------------------------------------------------------------------------------
--------------------------------------------------------------------------------------------------------------------------------------------------------------------------------------------------------
--------------------------------------------------------------------------------------------------------------------------------------------------------------------------------------------------------
--------------------------------------------------------------------------------------------------------------------------------------------------------------------------------------------------------
----S--------------------------------SS-----S-----------------------U------------------S-S-SSS-S---------------------------------------------------S--U-----U-------------------------------------------
------C-----------C---C----------------------C-------------------------------C------------C------C-C-C-C------C--C-CC-----------------------------------------------------------------------------------
--------------------------------------------------------------------------------------------------------------------------------------------------------------------------------------------------------
--------------------------------------------------------------------------------------------------------------------------------------------------------------------------------------------------------
--------------------------------------------------------------------------------------------------------------------------------------------------------------------------------------------------------
------SU---#---S--S---SC---#---tt---#---U----SU-U--U-------#------C-C-CC-#---S-S----C-#---S------SSSSSSS------SttS-SS---------------------------------C-----C-------------------------------------------
--tt------##-tt----tt-----##---tt--##----------#-tt----#--##-------------#--------tt--#---------------------tt-tt-------#---#-------------------------------------------------#-------------------------
tttt-----###-tt----tt---#-##---tt-###----------#-tt--#-#-###tt-----------#--------tt--#---------------------tt-tt----##-##-###--#####-#tttt########-##-#####-##---##-#################-#################
tttt-#--####gtt----tt---#-##-gktt####--#-g-k---#-tt--#-#####tt-----------#k-g-g---tt--#g-----g--#---------##tt-tt-k--##-#######-#####-#tttt########g##-#####-##g#-##g#################-################F
||||%|%%|||||||%-%%||%%%|-||%||||||||%%|%|%|%%%|%||%%|-|||||||%%--%%%%%%%||%|%|%--||%%||%%%-%|%%|%%%%%%%%%||||%||%|%%||-|||||||-|||||%||||||||||||||||%|||||%||||-||||||||||||||||||||%||||||||||||||||%
||||||||||||||||-||||||||-||||||||||||||||||||||||||||-|||||||||--||||||||||||||--|||||||||-|||||||||||||||||||||||||||-|||||||-|||||||||||||||||||||||||||||||||-||||||||||||||||||||||||||||||||||||||
