--------------------------------------------------------------------------------------------------------------------------------------------------------------------------------------------------------
--------------------------------------------------------------------------------------------------------------------------------------------------------------------------------------------------------
--------------------------------------------------------------------------------------------------------------------------------------------------------------------------------------------------------
--------------------------------------------------------------------------------------------------------------------------------------------------------------------------------------------------------
--------------------------------------------------------------------------------------------------------------------------------------------------------------------------------------------------------
-----B-B----U-----BB---------------BB-B--B-B----B-B------------UB-BBUB--U-----------B-B-------U---U------------------B-------B-------------B------------U----B--------BB--------------------------------
---------------------------------------------------C------C----------------------------------------------------------------------------C------C---------------------------------------------------------
--------------------------------------------------------------------------------------------------------------------------------------------------------------------------------------------------------
--------------------------------------------------------------------------------------------------------------------------------------------------------------------------------------------------------
--------------------------------------------------------------------------------------------------------------------------------------------------------------------------------------------------------
-tt-----ttCBCBC-UB---------B--------------C--------B------BBtt-C----C-ttC---UC-tt---------##--C---C-----Btt---------U-B----------------Btt----B-----C-ttC-B---C--tt-------------------------------------
-tt-----tt-----------tt#-------------#-tt----tt----------#--tt--------tt-------tt--------###-------------tttt-----tt-----------------tt-tt------------tt---------tt----------#-------##-----------------
-tt-----tt-----------tt#---------tt--#-tt----tt-------tt-#--tt--------tt-------tt-------####----tt---#---tttt---tttt-----#-----tt----tt-tt------tt----tt---------tt--------#-##----#-##----------tt-----
-tt--gg-tt-----#-----tt#gg----k-gtt-g#-tt----tt--#g---tt-#--ttg---g--gtt-g-k---ttgg---g#####----tt-#-#-g-tttt---tttt----g#-----ttkg--tt-ttg-#k--ttg--gtt-g------gtt----g-#-#-###-#-#-##kkkkkkkkkkttkkkkF
-XXXXXX-XXXXXXXXXX--XXXXXXXXXXXXXXX-XXXXX-X-XXXX-XXXX-XXXXXXXXXX-XXXXXXXXX-XXXXXXXXX--XXXXXXXXXXXXXX-XXXXXXXX-X-XXXXX-XXXXXX-XXXXXXXXXXXXXX-XXXXXXX-XXXXXXXX-XXXXXXXXX-X-X-X-XXX-X-X-XXXXXXXXXXXXXXXXXXX
-XXXXXX-XXXXXXXXXX--XXXXXXXXXXXXXXX-XXXXX-X-XXXX-XXXX-XXXXXXXXXX-XXXXXXXXX-XXXXXXXXX--XXXXXXXXXXXXXX-XXXXXXXX-X-XXXXX-XXXXXX-XXXXXXXXXXXXXX-XXXXXXX-XXXXXXXX-XXXXXXXXX-X-X-X-XXX-X-X-XXXXXXXXXXXXXXXXXXX
