--------------------------------------------------------------------------------------------------------------------------------------------------------------------------------------------------------
--------------------------------------------------------------------------------------------------------------------------------------------------------------------------------------------------------
--------------------------------------------------------------------------------------------------------------------------------------------------------------------------------------------------------
--------------------------------------------------------------------------------------------------------------------------------------------------------------------------------------------------------
--------------------------------------------------------------------------------------------------------------------------------------------------------------------------------------------------------
--S-U--------S---------------U-S--S----------------S---------------SS-----------U-----S----S----S-----------------------------S-------------------------------------------------------------------------
-----------------C--------------------------------------------------------------------------------------------------------------------------------------------------------------------------------------
--------------------------------------------------------------------------------------------------------------------------------------------------------------------------------------------------------
--------------------------------------------------------------------------------------------------------------------------------------------------------------------------------------------------------
--------------------------------------------------------------------------------------------------------------------------------------------------------------------------------------------------------
tt-CC-------S-S##S-----------C-----#---##-CCtt-U----#------------------------C#-C--tt--#U-----C----------------------------------------S------#----------#--UC------------tt-C-#-#----------------------
tt-------------##--tt---#--tt------#--###---tt----#-#tt#-----#--------#----#--#---#tt#-#--------------------------------#---------------#-----#--tt--tt--#----------------tt---#-#----------------------
tt-------#-----##-#tt---#--tt------##-###---tt--#-#-#tt##--#-##-#-----#----#--#---#tt#-#-tt---------------------------#-#-------#----tt-#-----#--tt--tttt#----------------tt---#-#----------------------
ttg---k#-##--g-##-#tt---#--tt--g---##-###---tt--#-#-#tt###-#-####k-g--#-g--#--#k--#tt#g#-ttg------------------------#-#-##k---g-#----tt-#---g-#--tt--tttt#-----------g-g--tt---#-#--g------------------F
|||%%%||-||%%|%||%|||-%%|%%||%%|%%-||-|||%%%||%%|-|-||||||-|-|||||-|-%|%|%%|%%||%%||||||%|||%-%%%%-%%-%%-%%-%%-%%-%%|-|-|||---|-|%-%%||%|---|-|--||--|||||--%%--%%---|-|--||-%-|-|--|---%%-%%---%------%
||||||||-||||||||||||-||||||||||||-||-|||||||||||-|-||||||-|-|||||-|-||||||||||||||||||||||||-||||-||-||-||-||-||-|||-|-|||---|-||-||||||---|-|--||--|||||--||--||---|-|--||-|-|-|--|---||-||---|------|
