--------------------------------------------------------------------------------------------------------------------------------------------------------------------------------------------------------
--------------------------------------------------------------------------------------------------------------------------------------------------------------------------------------------------------
--------------------------------------------------------------------------------------------------------------------------------------------------------------------------------------------------------
--------------------------------------------------------------------------------------------------------------------------------------------------------------------------------------------------------
--------------------------------------------------------------------------------------------------------------------------------------------------------------------------------------------------------
----S------S-SS----U--S-S-----------SS----------S---------U-U--S-------S-----S-------------SS------------SS---U-SS-------S--S-S-SU--S-----SS---S--------------------------------------------------------
--------------------------------------C------------------C---C-------------C---------C------------C------------------------------------------------------C----------------------------------------------
--------------------------------------------------------------------------------------------------------------------------------------------------------------------------------------------------------
--------------------------------------------------------------------------------------------------------------------------------------------------------------------------------------------------------
--------------------------------------------------------------------------------------------------------------------------------------------------------------------------------------------------------
------------S------C----------#S--tt--S-S----------------SC-CS--UStt-------S#----tt--SC---S------SSCC-#tt----UCS--C-----U-tt-#---C---SUCCS---tt----tt----S-#UttC---tt-----------------------------------
---#-------------tt--#-------##---tt----------tt--------------#---tt----#---#-#--tt#---tt-------------#tt-----------------tt-#----tt---------tt----tt------#-tt----tt-----------------------------------
-#-#----#-#----#-tt--#------###---tt----------tt------#-------#---tt-tt-#tt-#-#--tt#---tt-------#-----#tt----------tt-----tt-#----tt---------tt----tt-tt---#-tt----tt-------------------------tt--------
-#-#--#-#k#----#-tt--#--g--####---tt-g--------ttg#--#-#k#--#--#---tt-tt-#tt-#-#g-tt#k--tt-----#-#-----#ttg-gg------tt-g---ttg#g-g-ttg--------tt--#-tt-tt--g#-tt----ttg------------------------tt-------F
%|-|%%|-|||-%%%|%||%%|%%|%%||||%-%||-|%-%%-%%%||||%%|-|||%%|%%|%%%||%||%|||%|-||%||||%%||%%%%%|-|%%%%%||||%||%%%--%||%|%%-|||||%|%|||%%%%%%%%||--|%||%||%%||%||%%%%|||%%%%%%%-%%%%%%%%%%%%%%%%||%%%%%%%%
||-||||-|||-||||||||||||||||||||-|||-||-||-||||||||||-|||||||||||||||||||||||-|||||||||||||||||-||||||||||||||||--|||||||-|||||||||||||||||||||--||||||||||||||||||||||||||||-||||||||||||||||||||||||||
