--------------------------------------------------------------------------------------------------------------------------------------------------------------------------------------------------------
--------------------------------------------------------------------------------------------------------------------------------------------------------------------------------------------------------
--------------------------------------------------------------------------------------------------------------------------------------------------------------------------------------------------------
--------------------------------------------------------------------------------------------------------------------------------------------------------------------------------------------------------
--------------------------------------------------------------------------------------------------------------------------------------------------------------------------------------------------------
----------S-----------------SS------U-S------------SS----------------S--------------------S------------------SU----------U------------SS--SSS-----------------------------------------------------------
----------------------------------C------------------------------------------------------------------------C--------------------C-----------------------------------------------------------------------
--------------------------------------------------------------------------------------------------------------------------------------------------------------------------------------------------------
--------------------------------------------------------------------------------------------------------------------------------------------------------------------------------------------------------
--------------------------------------------------------------------------------------------------------------------------------------------------------------------------------------------------------
----U---C---tt-##-U---#CSS-S----ttS-C------------SS-------S----#tt-S------#tt--------U-tt--U------tt--##-CCS--Ctt-U----C-C-CUU-US-S----------C----------------------------------------------------------
-----tt-----tt-##----##---------tt------------tt--------------##tt----tt-##tt----------tt-----#---tt-###-------tt-----------------------tt--------------------------------------------------------------
-#tt-tt-----tt-##---###---------tt------------tt-------------###tt----tt###tt-tt-tt-#--tt#---##tt-tt####-------tt--#-tt-----------------tt----#---------------------------------------------------------
-#tt-tt-----tt-##--####---------tt---g----g-#ktt-----ggggk-#-###tt#--gtt###tt-tt-ttk#--tt#--###ttgtt####----#g-tt--#ktt------------g-#g-tt--g-#-ggggggggggggggggggggggggggggggggggggggggggggggg--------F
%|||%||%%%-%||%||%%||||%%%%%%%%%||%%%|%%%%|%||||-%%%%|||||%|-||||||%%||||||||%||%||||%%|||-%||||||||||||%%%%||%||%%||||%%%%%%%%%%%%|-||%||%%|%|%|||||||||||||||||||||||||||||||||||||||||||||||%%%%%%%%%
||||||||||-|||||||||||||||||||||||||||||||||||||-|||||||||||-|||||||||||||||||||||||||||||-|||||||||||||||||||||||||||||||||||||||||-|||||||||||||||||||||||||||||||||||||||||||||||||||||||||||||||||||
