--------------------------------------------------------------------------------------------------------------------------------------------------------------------------------------------------------
--------------------------------------------------------------------------------------------------------------------------------------------------------------------------------------------------------
--------------------------------------------------------------------------------------------------------------------------------------------------------------------------------------------------------
--------------------------------------------------------------------------------------------------------------------------------------------------------------------------------------------------------
--------------------------------------------------------------------------------------------------------------------------------------------------------------------------------------------------------
----------SS---------SS-----------------------------SS-----S---------UUU----SS-------------------S--U-------SS--------S-S----SS----S--S-S-----S-S-S----S---SU-------S---------SS--------U-----UUU-UUUUUU
----------------C--C----------------------------------C--------------------C-----------------------------------------------------------------------C-------------C---------------C----------------------
--------------------------------------------------------------------------------------------------------------------------------------------------------------------------------------------------------
--------------------------------------------------------------------------------------------------------------------------------------------------------------------------------------------------------
--------------------------------------------------------------------------------------------------------------------------------------------------------------------------------------------------------
-------C------C-S--S---C--tt-----------------tt-------Stt-----U----ttCCC---S--CC----U-----UCC-#C#-C-C-C----C--tt--C-------------U------------------SS-------C--C#SU----SttS------SU-U-CSCSC---CCC-CCCCCC
--------------------------tt-tt------tt---#--tt-#-tt---tt-#--------tt--------------#-tt-tt----#-#--------tt---tt----------------------------tt-------tt--tt-----#-------tt------------------------------
#--tt-------------------#-tt-tt--tt--tt-#-#tttt-##tt---tt-#-tt-----tt----#------tt-#-tt-tt----#-#--------tt---tt---------#----------#----#--tt-------tt--tt-----#-------tt------------------------------
#--tt----gg-k--g-g#-----#gttgtt--tt-#tt-#-#tttt-##ttg--tt-#-tt---g-tt----#---g--tt-#-tt-tt----#-#------#gtt--gttk--#--g#-#k---g#-#--#----#--tt---g---tt--ttg--g-#-----g-tt-g-k--g--g-k-----g-----g-----F
|-%||%%%%||%|-%|%||%%--%|||||||%%||-|||%|-|||||%|||||%%||-|%||%%%|%||%%%%|%%%|%%||%|%||%||%%%%|%|%%%%%%||||%-||||%%|%%||-||%%%||%|%-|%%-%|%-||%%-|%%%||-%|||%%|%|%%%-%|%||%|%|%%|%%|%|%%%%%|%-%%%|%%%%%%
|-|||||||||||-|||||||--||||||||||||-|||||-|||||||||||||||-||||||||||||||||||||||||||||||||||||||||||||||||||-|||||||||||-||||||||||-|||-|||-||||-||||||-||||||||||||-||||||||||||||||||||||||-||||||||||
