--------------------------------------------------------------------------------------------------------------------------------------------------------------------------------------------------------
--------------------------------------------------------------------------------------------------------------------------------------------------------------------------------------------------------
--------------------------------------------------------------------------------------------------------------------------------------------------------------------------------------------------------
--------------------------------------------------------------------------------------------------------------------------------------------------------------------------------------------------------
--------------------------------------------------------------------------------------------------------------------------------------------------------------------------------------------------------
-----B-----------B--------BU-U-----------------------BB-----B-------B----------B------B---------B------------------------------BB-B---BBB------B--B-------B---------------------------------------------
-------C--------------C---------C------------------C-----------------------------------------------C-C-C-C-C-C----C--------------------------C--C--CCCC-C----CCCCC-CCCCCCCCCCCCCCCCCCCCCCC-CC-CCCCCCCCCC
--------------------------------------------------------------------------------------------------------------------------------------------------------------------------------------------------------
--------------------------------------------------------------------------------------------------------------------------------------------------------------------------------------------------------
--------------------------------------------------------------------------------------------------------------------------------------------------------------------------------------------------------
C--B---Btt-----tt-U---Btt--C-C--Btt--C-#-----tt----BB--C-----tt----#---C--------B----C-----------ttBBBBBBBBBBB----B-----C------------B-------BC-B--BBBB-B----BBBBB-BBBBBBBBBBBBBBBBBBBBBBB-BB-BBBBBBBBBB
------#-tt#----tt------tt---#----tt----#-----tt--------------tt----#-------tt----#-------------#-tt-----------------tt---#tt-----------------------------------------------------------------#----------
------#-tt#--#-tt------tt---#----tttt--#----#tt---------tttt-tt-tt-#-------tt----##----------#-#-tt-----------tt----tt---#tt---------------#----------------------#--------------------------#----------
--k-gg#-tt#gk#gttg-----tt-g-#----tttt--#kg#-#ttk#-g-----tttt-tt-ttg#----#--tt----###---g-g---#-#-tt-----------ttk---tt---#tt--g--g-g----g#-#g-----g---------------#--------------------------#---------F
XXXXXXXXXXXXXXXXXXXXXXXXXXXXXXXXXXXXXX-XXXX-XXXXXXXXX--XXXXXXXXXXXXX-X-XXXXXXXXXXXXXXXXX-XXXXXXX-XXXXXXXXXXXXXXXXXXXXXXXXXXXXXXX-X-X-X--XX-XXXXXXXXXXXXXXX-XXXXXXXXXXXXXXXXXXXXXXXXXXXXXXXXXXXXXXXXXXXXX
XXXXXXXXXXXXXXXXXXXXXXXXXXXXXXXXXXXXXX-XXXX-XXXXXXXXX--XXXXXXXXXXXXX-X-XXXXXXXXXXXXXXXXX-XXXXXXX-XXXXXXXXXXXXXXXXXXXXXXXXXXXXXXX-X-X-X--XX-XXXXXXXXXXXXXXX-XXXXXXXXXXXXXXXXXXXXXXXXXXXXXXXXXXXXXXXXXXXXX
