--------------------------------------------------------------------------------------------------------------------------------------------------------------------------------------------------------
--------------------------------------------------------------------------------------------------------------------------------------------------------------------------------------------------------
--------------------------------------------------------------------------------------------------------------------------------------------------------------------------------------------------------
--------------------------------------------------------------------------------------------------------------------------------------------------------------------------------------------------------
--------------------------------------------------------------------------------------------------------------------------------------------------------------------------------------------------------
U-----------U-B------B-------U-----B---BB-UB---------B----BB--B---B--B--B-B-B-------B---B------------------BB--B-B--B----------------B---------BB----U-----B--BBBBBBBBBBBBBB-BBB-BBBBBBUBBBBBBBBBBBBBBBB
--------------------------------------------------------------------C------------------------C--------------------C------C---------C----C---------------------------------------------------------------
--------------------------------------------------------------------------------------------------------------------------------------------------------------------------------------------------------
--------------------------------------------------------------------------------------------------------------------------------------------------------------------------------------------------------
--------------------------------------------------------------------------------------------------------------------------------------------------------------------------------------------------------
C---#---#C-UC---UBU-----##-CCCBC----tt----C-------B---UBtt-------#--B--C-U---tt--tt----------B--tt---#--#UB-------B----ttBC--Btt---BU---B-----#------C--C------------------------------C----------------
----#--##---------------##------##--tt---------###------tt-------#-----------tt--tt--tt---------tt--##--#-------#----#-tt-----tt-------------##--tt-----------------------------------------------------
----#-###---------------##------##--tt------tt-###-tt---tt--tt-tt#-----------tt--tt--tt--#tt----tt-###--#----tt-#----#-tt--tt-tt-tt---------###--tt-----------------------------------------------------
--#-#####----k-#-----gk###------##-gtt-g----ttg###-tt---tt--tt-tt#----g---g-gttk-tt-gttgg#tt--g-tt-###--#----tt-#g---#-tt--tt-tt-tt---k---g####-gttkk-----g-#ggggggggggggggg#gggggggggg-gggggggggggggggF
XXXXXXXXXXXXXXXXXXX-XXXXXXXXXXXXXXXXXXXX-XX-XXXXXXXXX-XXXX--XX-XXXXXX-XX-XX-XXXXXXXXXXXXXXXX-XXXXX-XXXXXXXXXXXXXXXXXXXXXXXXXXXXXXXXXX-XXXXXXXXX-XXXXXX-XXXX-XXXXXXXXXXXXXXXXXXXXXXXXXXXXXXXXXXXXXXXXXXXX
XXXXXXXXXXXXXXXXXXX-XXXXXXXXXXXXXXXXXXXX-XX-XXXXXXXXX-XXXX--XX-XXXXXX-XX-XX-XXXXXXXXXXXXXXXX-XXXXX-XXXXXXXXXXXXXXXXXXXXXXXXXXXXXXXXXX-XXXXXXXXX-XXXXXX-XXXX-XXXXXXXXXXXXXXXXXXXXXXXXXXXXXXXXXXXXXXXXXXXX
