--------------------------------------------------------------------------------------------------------------------------------------------------------------------------------------------------------
--------------------------------------------------------------------------------------------------------------------------------------------------------------------------------------------------------
--------------------------------------------------------------------------------------------------------------------------------------------------------------------------------------------------------
--------------------------------------------------------------------------------------------------------------------------------------------------------------------------------------------------------
--------------------------------------------------------------------------------------------------------------------------------------------------------------------------------------------------------
--U--U-----BB-----------------BBUB--U--------U---------U----B-U-----------------------B----B-----------------------B---------------------------------------------U--------------------------------------
----------------------------------------------C-------------------------------------------------------C-C-C-C-C-C---CC-CC-CCC--C-C--CC-C-CCCC-C--CC-C-C-C-C-C-CC--CCCCC-CCCCCCCCCCCCCCCCCCCCCCCCCCCCCCCC
--------------------------------------------------------------------------------------------------------------------------------------------------------------------------------------------------------
--------------------------------------------------------------------------------------------------------------------------------------------------------------------------------------------------------
--------------------------------------------------------------------------------------------------------------------------------------------------------------------------------------------------------
--C-UC----B-------------#--#----C-C-C-C---#--CB--------CttC---C----tt------U---------B----B-BUtttt---BBBBBBBBBBBBB--BB-BB-BBB--B-B-#BBCB-BBBBBBBUBBBBBBBBBBBBBBB-CBBBBB-BBBBBBBBBBBBBBBBBBBBBBBBBBBBBBBB
--------tt--------------#--#-------------##------tt-----tt---------tt----tt-------------------tttt---------------------------------#--------------------------------------------------------------------
tt-#--#-tt--------------#--#------------###-#----tt--tt-tt---#-----tt-tt#tt-#----#--#---------tttt-tt------------------------#-----#----------------------------#---------------------------------------
tt-#--#ktt--------------#g-#g#g--------####k#--k#tt--tt-tt---#-----tt-tt#tt-#--#-#-k#----#----tttt-tt-------------#----------#--g-g#----g-----------------------#--------------------------------------F
XXXXXXXXXXX--X-XX-XXX-XXXXXXXXXXXXXXXXXXXXXXXXXXXXXXXXXXXXXX-XXX-XXXXXXXXXXXXXXX-XXXXX-XXXXXXXXXXXXXXXXXXXXXXXXXXXXXXXXXXXXXXXXXXXXXXXXXXXXXXXXXXXXXXXXXXXXXXXXXXXXXXXXXXXXXXXXXXXXXXXXXXXXXXXXXXXXXXXXX
XXXXXXXXXXX--X-XX-XXX-XXXXXXXXXXXXXXXXXXXXXXXXXXXXXXXXXXXXXX-XXX-XXXXXXXXXXXXXXX-XXXXX-XXXXXXXXXXXXXXXXXXXXXXXXXXXXXXXXXXXXXXXXXXXXXXXXXXXXXXXXXXXXXXXXXXXXXXXXXXXXXXXXXXXXXXXXXXXXXXXXXXXXXXXXXXXXXXXXX
