--------------------------------------------------------------------------------------------------------------------------------------------------------------------------------------------------------
--------------------------------------------------------------------------------------------------------------------------------------------------------------------------------------------------------
--------------------------------------------------------------------------------------------------------------------------------------------------------------------------------------------------------
--------------------------------------------------------------------------------------------------------------------------------------------------------------------------------------------------------
--------------------------------------------------------------------------------------------------------------------------------------------------------------------------------------------------------
B----------BU--------B------B-------U---BU-B--------BB-------------BBB-BB-------------B--------------------------BUB-BU------------------------------B----BUBU--------BB------------------B-------------
----------------------------------------------C----------------------------------------------------------------------------------------C----------------------------------------------------------------
--------------------------------------------------------------------------------------------------------------------------------------------------------------------------------------------------------
--------------------------------------------------------------------------------------------------------------------------------------------------------------------------------------------------------
--------------------------------------------------------------------------------------------------------------------------------------------------------------------------------------------------------
---BU-UU-#--C----B#---tt---B-C-CU-U-C-#--CB--#BUCtt-----B---------#---B---------------------#--#---CBB----#-BB----C---C------#------#--B----------UC-------C-C------UB--------tttttttttttt-tttttttttttt-
---------#----tt--#---tt--------------##-----#---tt--------tt-----#--------tt-------tt--#---#--#--#-------#-----#------#--tt-#-----##------tt---------#------------#----##-tt#tttttttttttt-tttttttttttt-
---------#----tt#-#tt-tt-tt---#-------##-----#---tt#--tt---tt-#-tt#--------tt-------tt--#---#-###-#-------#----##------#tttt-#tt--###---tt-tt---------##---------tt#----##-tt#tttttttttttt-tttttttttttt-
--k-----k#---gtt#-#tt-tt-tt---#--g-#-k##-----#---tt#ggtt---ttg#-tt#--g-----tt---#-#ktt-##-k-#g###-#------g#---###---k--#tttt##ttk####k--tt-tt-k#------###------k-tt#----##-tt#tttttttttttt-ttttttttttttF
-XXXXXXXXXX-XXXXXXXXXXXXXXXXXXXXXXXXXXXX-XXXXXXXXXXXXXXXX-XXXXXXXXXXXXXXXX-XXXXXXXXXXXXXXXX-XXXXX-XXXXXXXXXXXXXXXXX-XXXXXXXXXXXXXXXXXXXXXXXXXXXXXXXXX-XXX--X-XXXXXXXXXXXXXXXXXXXXXXXXXXXXX-XXXXXXXXXXXXX
-XXXXXXXXXX-XXXXXXXXXXXXXXXXXXXXXXXXXXXX-XXXXXXXXXXXXXXXX-XXXXXXXXXXXXXXXX-XXXXXXXXXXXXXXXX-XXXXX-XXXXXXXXXXXXXXXXX-XXXXXXXXXXXXXXXXXXXXXXXXXXXXXXXXX-XXX--X-XXXXXXXXXXXXXXXXXXXXXXXXXXXXX-XXXXXXXXXXXXX
