--------------------------------------------------------------------------------------------------------------------------------------------------------------------------------------------------------
--------------------------------------------------------------------------------------------------------------------------------------------------------------------------------------------------------
--------------------------------------------------------------------------------------------------------------------------------------------------------------------------------------------------------
--------------------------------------------------------------------------------------------------------------------------------------------------------------------------------------------------------
--------------------------------------------------------------------------------------------------------------------------------------------------------------------------------------------------------
-U-B-----------------------------------------B--U-U---------BB-BB--B-----U---UU----------U---------------U---B--U-B--------------B--------------------------BBB--BBBBBBBBBBBBBBBBBBBBBBBBBBBBBBBBBBBBBBB
-------------------------------------C-----C------------------------------------------------C--------------------------------------C--------------------------------------------------------------------
--------------------------------------------------------------------------------------------------------------------------------------------------------------------------------------------------------
--------------------------------------------------------------------------------------------------------------------------------------------------------------------------------------------------------
--------------------------------------------------------------------------------------------------------------------------------------------------------------------------------------------------------
-C-----B-U----#----#--------------U--B---C-B----CBC#------#------tt--U-CBCBC-CCtt----C#C-C-CB------tt----C------C-----UC------B---#B---------------tt---------------------------------------------------
--#----------###---#--tt------#--------#-----------#-#---##------tt------------tttt---#----------#-tt------------#-#-#---#--------#----------------tt---------------------------------------------------
--#---------#####--#tttt---#--#-tt-----#-----------#-##-###------tt------------tttt---#--------#-##tt-tt---------#-#-#---#-----tt-#-tt--tttttttt-tttt-tttttt---tt---------------------------------------
--#-k-g----#######-#tttt--g#g-#gtt--g--#k---#-k----#g######-----gttg#-------g--tttt-g-#------#-#-##tt-tt--kkg--k-#-#-#--g#ggk--ttg#-tt--tttttttt-tttt-ttttttg-gttggggggggggggggggggggggggggggggggggggggF
XXXXXXXXXX-XXXXXXXXXXXXXXXXXXXXXXXXXXXXXXXXXX-XXXXXXXXXXXXXXX-X-XXXXXXXXXXXXXXXXXXXXXXXXXXXXXX-X-XXXXXXXXXXXX-XXXX-XXXXXXXXXXXXXXXXXXXXXXXXXXXXX-XXXXXXXXXXXXXXXXXXXXXXXXXXXXXXXXXXXXXXXXXXXXXXXXXXXXXXX
XXXXXXXXXX-XXXXXXXXXXXXXXXXXXXXXXXXXXXXXXXXXX-XXXXXXXXXXXXXXX-X-XXXXXXXXXXXXXXXXXXXXXXXXXXXXXX-X-XXXXXXXXXXXX-XXXX-XXXXXXXXXXXXXXXXXXXXXXXXXXXXX-XXXXXXXXXXXXXXXXXXXXXXXXXXXXXXXXXXXXXXXXXXXXXXXXXXXXXXX
