--------------------------------------------------------------------------------------------------------------------------------------------------------------------------------------------------------
--------------------------------------------------------------------------------------------------------------------------------------------------------------------------------------------------------
--------------------------------------------------------------------------------------------------------------------------------------------------------------------------------------------------------
--------------------------------------------------------------------------------------------------------------------------------------------------------------------------------------------------------
--------------------------------------------------------------------------------------------------------------------------------------------------------------------------------------------------------
---U---BU-----B----------BB---B----B----BB-------------B------------------------------------B-------------------U--------------------U--------------U---------------------------------------------------
-------------------------------------------------------------------------------C----------------------------C-------------------------------------------------------------------------------------------
--------------------------------------------------------------------------------------------------------------------------------------------------------------------------------------------------------
--------------------------------------------------------------------------------------------------------------------------------------------------------------------------------------------------------
--------------------------------------------------------------------------------------------------------------------------------------------------------------------------------------------------------
-CBCBC--C------tt-------B------tt-U----U---ttB-C##-------C--tt------------U--ttB----------tt------CBB-BCBB-BB-CBCBCBB--ttBCBB-CBB-BBBCBCBB-BB-BCBB-BCBCBB-BCBB-BBBBCBB-BBBBCBB-BBBBBBBBBBBCBB-BBBB-BBBBB
---------------tttt------------tt----------tt---##----------tt-------#-----#-tt-----------tt---------------------------tt-------------------------------------------------------------------------------
-------------#-tttt------------tt---------#tt---##---tt-----tt-tt-#-###----#-tt-----------tt----tt---------------------tt-------------------------------------------------------------------------------
----------gk-#gtttt----#----g--tt---k----g#tt-g-##--gtt-k---tt-tt-######g--#-tt--k--k----kttgg--tt---------------------tt------------------------------------------------------------------------------F
XXXXXXXXXXXXXXXXXXX-XXXXXXX-XXXXXXX-XX-XXXXXXXXXXXX-XXXXXXX-XXXXX-XXXXXXXXXXXXXXXXX-X-X-XXXXXXXXXXXXXXXXXXXXXXXXXXXXXX-XXXXXXXXXXXXXXXXXXXXXXXXXXXXXXXXXXXXXXXXXXXXXXXXXXXXXXXXXXXXXXXXXXXXXXXXXXX-XXXXX
XXXXXXXXXXXXXXXXXXX-XXXXXXX-XXXXXXX-XX-XXXXXXXXXXXX-XXXXXXX-XXXXX-XXXXXXXXXXXXXXXXX-X-X-XXXXXXXXXXXXXXXXXXXXXXXXXXXXXX-XXXXXXXXXXXXXXXXXXXXXXXXXXXXXXXXXXXXXXXXXXXXXXXXXXXXXXXXXXXXXXXXXXXXXXXXXXX-XXXXX
