--------------------------------------------------------------------------------------------------------------------------------------------------------------------------------------------------------
--------------------------------------------------------------------------------------------------------------------------------------------------------------------------------------------------------
--------------------------------------------------------------------------------------------------------------------------------------------------------------------------------------------------------
--------------------------------------------------------------------------------------------------------------------------------------------------------------------------------------------------------
--------------------------------------------------------------------------------------------------------------------------------------------------------------------------------------------------------
----------------------S---------------------------------U--S---------S----------U------------US--U---------S-------S-------S-S-----S---S----S---------------US-------S---S------------------------------
------C------------------------C----C-------------------------------------------------------------------------------C-----------------------------------------------------------------------------------
--------------------------------------------------------------------------------------------------------------------------------------------------------------------------------------------------------
--------------------------------------------------------------------------------------------------------------------------------------------------------------------------------------------------------
--------------------------------------------------------------------------------------------------------------------------------------------------------------------------------------------------------
--CC-#S-tt---------SC#-tt---#--S----S#----S-S-----------C---------------CS-tt---C-------#--S-C--CCtt---S---------C--S----#---------------tt--UU------tt-----C---tt--------------------------------------
-----#--tt-#---tt----#-tt---#tt------#---------tt---------------------tt---tt----------##tt----#--tt---------tt---------##-----tttt------tt----tt--#-tt#-tt-----tt-----#--tt----------------------------
tt---#--tt-#tt-tt-#--#-tt--##tt---tt-#--tt-----tttttttt#--#-----------tt---tt-tt---#--###tt----#--tt-tt--tt--tttt----tt###-----tttt-----#tt----tt#-#-tt#-tt-----tt-tt--#--tt----------------------------
tt---#--tt-#tt-tt-#--#-tt--##tt-ggtt-#g-tt-#---tttttttt#--#g----------tt--ktt-tt--g#-g###tt---g#--tt-tt--ttg-tttt----tt###-g---tttt--g#g#tt-g--tt#-##tt#kttg-g-gttgttgg##-tt---------------------------F
||%%%|%%||-|||%||%|%%|%||%%||||%||||%||%||%|%%%|||||||||%%||%%-%%%-%%%||%%|||%||%%||%||||||%-%||%%||%||%%|||%||||%%%%|||||%|%--||||%%||||||%|%%|||-|||||||||%|%||||||||||-||%%%%%%%%%%%%%%%%%%%%%%%%%%%%
||||||||||-|||||||||||||||||||||||||||||||||||||||||||||||||||-|||-|||||||||||||||||||||||||-||||||||||||||||||||||||||||||||--|||||||||||||||||||-||||||||||||||||||||||-||||||||||||||||||||||||||||||
