--------------------------------------------------------------------------------------------------------------------------------------------------------------------------------------------------------
--------------------------------------------------------------------------------------------------------------------------------------------------------------------------------------------------------
--------------------------------------------------------------------------------------------------------------------------------------------------------------------------------------------------------
--------------------------------------------------------------------------------------------------------------------------------------------------------------------------------------------------------
--------------------------------------------------------------------------------------------------------------------------------------------------------------------------------------------------------
-----S-S-----------S-S----S---------------------------SS-----------SS--S-----------------------S-----------------S----U----------S------S-S-S----------SSS---------------------------U------------------
------------------------------C----------------C----------------------------------------------------------------------------CC--------------------------------------------------------------------------
--------------------------------------------------------------------------------------------------------------------------------------------------------------------------------------------------------
--------------------------------------------------------------------------------------------------------------------------------------------------------------------------------------------------------
--------------------------------------------------------------------------------------------------------------------------------------------------------------------------------------------------------
----#-U---ttCSS-U---#---------S----tt-----tt---SS----C---S--S-C-------------S-U-U---------#-----------------U-tt--#---C---#-SS--------tt-#------#--S-------tt------#-----------------C------------------
---##-----tt--------#---tt---------tt-----tt-------------------------tt----------tt------##-tt----------------tt--#------##-----------tt-#------#----tt----tt------#------------------------------------
--###-----tt--------#---tt---------tt-tt--tt--------------tt-#-------tt------#---tt-----###-tt---tt-------#---tt--#--#--###---tt------tt-#------#-#--tt----tt------#------------------------------------
#-###---g-tt--------#ggktt---g----gtt-tt-kttk-----##--gg#-tt-#--#ggg-ttg-----#---tt#k--####-tt---tt------k#g--ttkg##-#-####---tt-g-g--ttg#-#g-k-#-#--ttg---tt------#-----------------------------------F
|-|||%%%|%||%%%%%%%%||||||-%%|%%%%|||%||%||||%%%%%||%%|||%||%|%-||||%|||%%-%%|%%%||||-%||||%||%-%||%-%%%%|||%%||||||-|%||||-%%||%|%|%%||||-||%|-|%|%%|||-%%||%%%%%%|%%%%%%%%%%%%%%%%%%%%%%%%%%%%%%%%%%%%
|-||||||||||||||||||||||||-||||||||||||||||||||||||||||||||||||-||||||||||-||||||||||-|||||||||-||||-|||||||||||||||-||||||-||||||||||||||-||||-||||||||-|||||||||||||||||||||||||||||||||||||||||||||||
