--------------------------------------------------------------------------------------------------------------------------------------------------------------------------------------------------------
--------------------------------------------------------------------------------------------------------------------------------------------------------------------------------------------------------
--------------------------------------------------------------------------------------------------------------------------------------------------------------------------------------------------------
--------------------------------------------------------------------------------------------------------------------------------------------------------------------------------------------------------
--------------------------------------------------------------------------------------------------------------------------------------------------------------------------------------------------------
--BB-------------------U--B----B-B-U----U--------UBB--B-------BB---------B-BBU----B--------------B------------BB------------------B---------------------------------------------------------------------
------C-------------------------------------------------C---------------------------CC--------CCC----------------------C-----------------------------C--------------------------------------------------
--------------------------------------------------------------------------------------------------------------------------------------------------------------------------------------------------------
--------------------------------------------------------------------------------------------------------------------------------------------------------------------------------------------------------
--------------------------------------------------------------------------------------------------------------------------------------------------------------------------------------------------------
-B---CBtttt---C-----B--C---U-------C--C-C-CB-----C--tt--BC---B---tt-------B--CU-#---BB-U--C---BBB-tt------------U----#-Btt------------tt---------C---B-------------------B--------U--tttttttttttttttttt-
-------tttt----tt-#------#------------------#-------tt-----------tt-----#-------#--------#--------tt--#--#-----------#--tt--#---------tt---------------------------------------------tttttttttttttttttt-
-------tttt-tt-tt-#------#---tt-------------##--#---tt----tt-----tt-tt#-#-------##-------#--#-----tt#-##-#-tt--------#--tt--#---------tt-tt----------------------------------------tttttttttttttttttttt-
----g--tttt-tt-tt-#------#---tt-#---g-------###-#-g-tt-k--tt----gtt-tt#-#------g##gk-----#--#g---gtt#-####gttg-g-kgkk#--tt#g##gg-k----tt-tt----------------------------k-----------ttttttttttttttttttttF
XXXXXXXXXXXXXXXXX-XXXXXXXX-XXXX-X-XXXXXXXXXXXXX-XXX-XX-XXXXXXX--XXXXXXX-X-XXXXXXXXXXXXXXXXXXXXXXXXXXX-XXXXXXXX-XXXXXXXXXXXXXXXXXXXXXXXXXXXXXXXXXXXXXXXXXXXXXXXX-XXXXXXXXXXXXXXXXXXXXXXXXXXXXXXXXXXXXXXXX
XXXXXXXXXXXXXXXXX-XXXXXXXX-XXXX-X-XXXXXXXXXXXXX-XXX-XX-XXXXXXX--XXXXXXX-X-XXXXXXXXXXXXXXXXXXXXXXXXXXX-XXXXXXXX-XXXXXXXXXXXXXXXXXXXXXXXXXXXXXXXXXXXXXXXXXXXXXXXX-XXXXXXXXXXXXXXXXXXXXXXXXXXXXXXXXXXXXXXXX
