--------------------------------------------------------------------------------------------------------------------------------------------------------------------------------------------------------
--------------------------------------------------------------------------------------------------------------------------------------------------------------------------------------------------------
--------------------------------------------------------------------------------------------------------------------------------------------------------------------------------------------------------
--------------------------------------------------------------------------------------------------------------------------------------------------------------------------------------------------------
--------------------------------------------------------------------------------------------------------------------------------------------------------------------------------------------------------
B-----------------B-U------BU-------B---------B------------------------BB----B--U-----------B----------------B---B--------------UB--------U-BB--B------B------------B-----------------------------------
----C------------------------------C--------------------------------C------------------------------------------------------------------------------------------------C----------------------------------
--------------------------------------------------------------------------------------------------------------------------------------------------------------------------------------------------------
--------------------------------------------------------------------------------------------------------------------------------------------------------------------------------------------------------
--------------------------------------------------------------------------------------------------------------------------------------------------------------------------------------------------------
-tt-B-#tt--U-#---#--C--tt---C-----CB-----------tt------tt--C---tt--#B-B---------C-#U--U--------U--tt----C---#-tt#------#-B-#--U-C-#-----ttCB---#------U-----------tt-B----------------------------------
-tt---#tttt--#-tt#-----tt#---#-----------------tt------tt----tttttt#----------tt--#----------tt---tt--------#-tt#------#---#tt----#---tttt-----#-#-#-#--#---------tt---######-###-################--####
-tt---#tttt--#-tt#-----tt#---#--#------#-------tt------tttt--tttttt#-#------#-tt--#------#-#-tt---tt-tt---tt#-tt#------##--#tt----#tt-tttt-----#-#-#-#--##--#-tt--tt---######-###-#################-####
-ttg--#tttt--#-tt#---g-tt#k--#kk#----#-#-#---ggtt------tttt--tttttt#-#---##-#gtt--#--g-#-#g#gtt--gtt-tt#-ktt#gtt#-----g##-k#tt----#tt-tttt-----#-#-#-#-g###-#gtt#ktt--g######-###k#####################F
-XXXXXXXXXXXXXXXXX-XXX-XXXX-XXXXXXXX-X-XXXXXXXXXXX-XX--XXXXXXXXXXXXXXXXXXXX-XXXXX-XXXXXX-XXXXXXXXXXXXXXXXXXXXXXXX-X-XXXXXXXXXXXXXXXXXXXXXXXX---XXXXXXXXXXXX-XXXXXXXXXXXXXXXXXXXXXXXXXXXXXXXXXXXXXXXXXXXX
-XXXXXXXXXXXXXXXXX-XXX-XXXX-XXXXXXXX-X-XXXXXXXXXXX-XX--XXXXXXXXXXXXXXXXXXXX-XXXXX-XXXXXX-XXXXXXXXXXXXXXXXXXXXXXXX-X-XXXXXXXXXXXXXXXXXXXXXXXX---XXXXXXXXXXXX-XXXXXXXXXXXXXXXXXXXXXXXXXXXXXXXXXXXXXXXXXXXX
