--------------------------------------------------------------------------------------------------------------------------------------------------------------------------------------------------------
--------------------------------------------------------------------------------------------------------------------------------------------------------------------------------------------------------
--------------------------------------------------------------------------------------------------------------------------------------------------------------------------------------------------------
--------------------------------------------------------------------------------------------------------------------------------------------------------------------------------------------------------
--------------------------------------------------------------------------------------------------------------------------------------------------------------------------------------------------------
------B--U--U----B-----------------------------------B----BB------BBBB-------U----B---B--B------BB---------B--B--------------------------B-----------------B-------B--B------B----B---------B---BBB-----
----------------C--C--------------------------C-------------------------C--------C---------------------------------------------------------C----------C-------------------------------------------------
--------------------------------------------------------------------------------------------------------------------------------------------------------------------------------------------------------
--------------------------------------------------------------------------------------------------------------------------------------------------------------------------------------------------------
--------------------------------------------------------------------------------------------------------------------------------------------------------------------------------------------------------
U##-tt-ttCCBCBC-B-UB----tt-C----tt-------tt---B#tt-----U------tt-#------B----C---B-tt--UB-----tt-------C-tt-tt---UU-------#--#----------#-CB-----tt---BB-----BB-##--UC--#--B--#-------------------------
-##-tt-tt---------------tt--tt#-tt-------tt----#tt------tt----tt-#-----------------tt#--------tt--tt-----tt-tt-tt---------#--#----tt----#----tt--tt--#----------##------#-----#-#------------------tt---
-##-tt-tt---------------tt--tt#-tt-tt----tttt--#tt----#-tt----tt-#-------#---------tt#-------#tt--tt-tt-#tt-tt-tt---------#tt#----tt----#----tt--tt--#----------##------#-----#-#------#-tt--------tt---
-##ktt-tt------k-----k-#ttk-tt#-tt-tt-ggktttt--#tt-ggg#-tt--g-ttg#---g-g-#-----g---tt#g--gg--#tt--tt-tt-#tt-tt-tt--k-k-g#k#tt#-##gttgg#-#---kttg-ttg-#--#-------##-g---g#k----#-##-k--##-tt--gkk---tt--F
XXXXXXXXXXXXXXXXXXXXXXXXXXXXXXXXXXXXXXXXXXXXXXXXXXXXXXXXXX--XXXXXXX--XXXXXX-XX-XXX-XXXXXXXXXXXXXXXXXXXXXXXX-XX-XXXXXXXXXXXXXXXXXXXXXXXXXX-XXXXXXXXXXXXXXXXX-XXX-XXXXXXXXXXXXXXXXXXXXXXXX-XXX-XXXXXXXXXXX
XXXXXXXXXXXXXXXXXXXXXXXXXXXXXXXXXXXXXXXXXXXXXXXXXXXXXXXXXX--XXXXXXX--XXXXXX-XX-XXX-XXXXXXXXXXXXXXXXXXXXXXXX-XX-XXXXXXXXXXXXXXXXXXXXXXXXXX-XXXXXXXXXXXXXXXXX-XXX-XXXXXXXXXXXXXXXXXXXXXXXX-XXX-XXXXXXXXXXX
