--------------------------------------------------------------------------------------------------------------------------------------------------------------------------------------------------------
--------------------------------------------------------------------------------------------------------------------------------------------------------------------------------------------------------
--------------------------------------------------------------------------------------------------------------------------------------------------------------------------------------------------------
--------------------------------------------------------------------------------------------------------------------------------------------------------------------------------------------------------
--------------------------------------------------------------------------------------------------------------------------------------------------------------------------------------------------------
--B--U--------BUU--U--B-----B----BB-BB-------------------------B-----B-B----------BB------B--B-BB---------------------------BB---------BB-------B----B---------B----------------------------------------
---------------------------------------------------------------------------------------------------------------C-------------------------------------------------------------CCC-CCCCCCCCCCCCCC-CCCCCCCC
--------------------------------------------------------------------------------------------------------------------------------------------------------------------------------------------------------
--------------------------------------------------------------------------------------------------------------------------------------------------------------------------------------------------------
--------------------------------------------------------------------------------------------------------------------------------------------------------------------------------------------------------
---U-C--ttUUtt-CC--C---------------B--C-------------B---tt---------tt-U-tt-B-tt-#C--Ctt--#-------CBB------B#--UB-BC#-C#---#B----------------B----tt---#ttBC---B--C----UCUCCCCBBBUBBBBBBBBBBBBBB-BBBBBBBB
--------tt--tt-----------------------------------#------tt-------tttt---tt---tt-#----tt-##-tt---------tt---#-------#--#--##---#tt#-----------tt--tt---#tt---#-----tt------------------------------------
tt------tt--tt---tt--------#-tt------------------##-----tt--tt---tttt---tt---tt-#----tt###-tt--------#tt---#-------#--#-###---#tt###---------tt--tttt-#tt---#-----tt#-----------------------------------
ttg-#-gktt--tt---tt--g-k--g#gttg-gg----g---------###-g-#tt--tt---ttttg--tt---tt-#-gg-tt###-tt--g-----#tt-k-#----g--#--#####---#tt###-k---#---tt-gtttt-#tt---#-----tt##-------------------------#-------F
XXXXXXXXXXXXXXXXXXXXXX-XXXXXXXXXXXXX--XX--XXX-XXXXXXXX-XXXXXXX-XXXXXXXXXXXXX-XX-XXXXXXXXXX-XXXXX-XXXXXXXXXXXXXXXXXXXXXXXXXXXXXXXXXXXXXXX-XXXXXXXXXXXX-XXXXXXX-XXXXXXXXXXXXXXXXXXXXXXXXXXXXXXXXXXXXXXXXXX
XXXXXXXXXXXXXXXXXXXXXX-XXXXXXXXXXXXX--XX--XXX-XXXXXXXX-XXXXXXX-XXXXXXXXXXXXX-XX-XXXXXXXXXX-XXXXX-XXXXXXXXXXXXXXXXXXXXXXXXXXXXXXXXXXXXXXX-XXXXXXXXXXXX-XXXXXXX-XXXXXXXXXXXXXXXXXXXXXXXXXXXXXXXXXXXXXXXXXX
