--------------------------------------------------------------------------------------------------------------------------------------------------------------------------------------------------------
--------------------------------------------------------------------------------------------------------------------------------------------------------------------------------------------------------
--------------------------------------------------------------------------------------------------------------------------------------------------------------------------------------------------------
--------------------------------------------------------------------------------------------------------------------------------------------------------------------------------------------------------
--------------------------------------------------------------------------------------------------------------------------------------------------------------------------------------------------------
--------------------SS--US-------SS-S--------------S---SS--S------SS-S---SSSS----U------U-SS------------------------S--S-U--S--SS-----------------S----------S----SSS-SSSSSSS-SSSSSSSSSSSSSSSSSSSSSSSSSS
-----------------------C--------------C------------------C--C----------------------------------------------C----------------------C---CC--------------C----C--------------------------------------------
--------------------------------------------------------------------------------------------------------------------------------------------------------------------------------------------------------
--------------------------------------------------------------------------------------------------------------------------------------------------------------------------------------------------------
--------------------------------------------------------------------------------------------------------------------------------------------------------------------------------------------------------
tt-S--Stt----tt----S--#SC-tt----C--#--Stt--#-UC--tt------S--S----S------------S--C------C------------------S----S-C--##--C--------S---SS--------C--U--SUU--S--tt----------------------------------------
tt#----tt----tt-#-----#---tt-------#-#-tt-##---tttt--tt---------------------------tt--tt--------------------tt-#-----##--------------------------#------------tttt--------------------------------------
tt#-tt-tt----tt-##----#---tt-#-----#-#-tt###---tttt--tt---------------tt----------tt--tt--------------------tt-#-#---##----#---------#-------#---#------------tttt--------------------------------------
tt#-tt-ttgk-gtt-###---#--gtt-#k--g-#g#-tt###---tttt-gtt-------------ggtt--g--k----ttk-tt-g-g----------------tt-#-#---##-#--#--g-gg-#-#--gg-#-#---#--k--------gttttggg-ggggggg-gggggggggggggggggggggggggF
|||%||%||||%|||-|||%%%|%%|||-||-%|%|||%|||||-%%||||%|||%-%--%%%%%%%%||||--|%-|%-%%|||%||%|%|%-%%%-%%-%%-%%%%||%|%|%%-||-|%%|-%|-||%|-|%%||%|-|%%%|%%|%%%%%-%%||||||||%|||||||%|||||||||||||||||||||||||%
|||||||||||||||-||||||||||||-||-||||||||||||-|||||||||||-|--||||||||||||--||-||-|||||||||||||-|||-||-||-||||||||||||-||-||||-||-||||-|||||||-|||||||||||||-|||||||||||||||||||||||||||||||||||||||||||||
