--------------------------------------------------------------------------------------------------------------------------------------------------------------------------------------------------------
--------------------------------------------------------------------------------------------------------------------------------------------------------------------------------------------------------
--------------------------------------------------------------------------------------------------------------------------------------------------------------------------------------------------------
--------------------------------------------------------------------------------------------------------------------------------------------------------------------------------------------------------
--------------------------------------------------------------------------------------------------------------------------------------------------------------------------------------------------------
U--------U-------B-BB-------B---------B-----------------B------------U------------B-----U-BB-----------------U--B--------------------U--------------------------------B---------------------------------
---------------------------C-------------------------------------C--------------C----------------------C---------------------C--------------------------------------------------------------------------
--------------------------------------------------------------------------------------------------------------------------------------------------------------------------------------------------------
--------------------------------------------------------------------------------------------------------------------------------------------------------------------------------------------------------
--------------------------------------------------------------------------------------------------------------------------------------------------------------------------------------------------------
C-U--U--#Ctttt-tt----------B-------------------U---#-----C--B--ttB---C-C---#----B--CBB-UCB--Utt---tt---B----#C-----#-B-------B------BC------------------#-----#--tt-------------------------------------
---#--tt#-tttt-tt-#-----------------------#-tt----##--tt-------tt-tt------##---#-------------tttt-tt-------##-tt---##-#tt####--#####---#############---###---##--tt###-#################################
---#--tt#-tttt-tt-#--tt--tt-------------#-#-tt---###--tt-------tt-tt-----###---#-------------tttt-tt-tt---###-tt---##-#tt####--#####---##############-#####-###tttt###-#################################
---#--tt#-ttttktt-#--tt-ktt-g#----------#-#-tt--####g-tt--k----tt-tt----####g-k#--g----------tttt-tt-tt-#-###-tt--g##-#tt####-k#####---########################tttt###g################################F
XXXX-XXXXXXXXXXXX-XX-XXXXXXXXXX-XX-XXXXXX-XXXXXXXXXXXXXXXXX-X-XXXXXXXXXXXXXXXXXXXXXXXXXXXXXXXXXXXXXXXXXXX-XXXXXXXXXXXXXXXXXXXXXXXXXXXXXXXXXXXXXXXXXXXXXXXXXXXXXXXXXXXXXXXXXXXXXXXXXXXXXXXXXXXXXXXXXXXXXX
XXXX-XXXXXXXXXXXX-XX-XXXXXXXXXX-XX-XXXXXX-XXXXXXXXXXXXXXXXX-X-XXXXXXXXXXXXXXXXXXXXXXXXXXXXXXXXXXXXXXXXXXX-XXXXXXXXXXXXXXXXXXXXXXXXXXXXXXXXXXXXXXXXXXXXXXXXXXXXXXXXXXXXXXXXXXXXXXXXXXXXXXXXXXXXXXXXXXXXXX
