--------------------------------------------------------------------------------------------------------------------------------------------------------------------------------------------------------
--------------------------------------------------------------------------------------------------------------------------------------------------------------------------------------------------------
--------------------------------------------------------------------------------------------------------------------------------------------------------------------------------------------------------
--------------------------------------------------------------------------------------------------------------------------------------------------------------------------------------------------------
--------------------------------------------------------------------------------------------------------------------------------------------------------------------------------------------------------
------S----S------------------U--S---S--------------------------U-S----------S----S--------------------U--S-US---SS--------S------S---------------U------SSS----------------S---U--S-------S------------
-------------------------------------------------C-------C----------------C------------------------------------------------------------------------------------C--C-------------------------------------
--------------------------------------------------------------------------------------------------------------------------------------------------------------------------------------------------------
--------------------------------------------------------------------------------------------------------------------------------------------------------------------------------------------------------
--------------------------------------------------------------------------------------------------------------------------------------------------------------------------------------------------------
-U---U-#U-------------#-#-----Ctt--#--tt---------SU--tt--S------C--U---CC-S---------S---C---------tt---C----C-ttS--C--S-----US---------U---------#C-C---S----S#S#-S---C--S----ttCCC-tt-------S-CSS-#####
--tt---#------#---tt#-#-#-##---tt--#--tttt-----------tt-----tt-------------------#------------tt--tt----tt----tt----tt--------tt------#----#tt-tt#----------#-#-#------tt-----tt----tttt-----------#####
--tt---#----#-#---tt#-#-#####--tt--#--tttt-tt--------tt-----tt--------------#----#-#------#---tttttt-tt-tt----tt----tt--------tt---tt-#--#-#tt-tt#----------#-#-#--tt--tt-----tt----tttt-----------#####
--ttk--#-g-g#-#k-gtt#-#k#####g-ttg-##-tttt-ttkk-#----tt#g--#ttk-------g--#--#----#g#--k---#---tttttt-tt-ttg---tt----tt---g#---tt#g-tt##--#-#tt#tt#-g---#----#-#-#g-tt--tt-g-ggtt----ttttkg-g-------####F
%%|||%-|%|-||-||%||||%||||||||%|||%||%||||%||||-|%%%%||||%%||||%%%-%%-|%%|%%|-%%%|||%%|-%%|-%%||||||%||%|||%%%||%%%%||%%-||-%%||||-||||%%|%|||||||%|%-%|%%--|%|%||%||%%||%|%||||%%%-||||||%|%%%%%%%||||%
||||||-|||-||-|||||||||||||||||||||||||||||||||-||||||||||||||||||-||-|||||||-|||||||||-|||-||||||||||||||||||||||||||||-||-||||||-||||||||||||||||||-||||--|||||||||||||||||||||||-||||||||||||||||||||
