--------------------------------------------------------------------------------------------------------------------------------------------------------------------------------------------------------
--------------------------------------------------------------------------------------------------------------------------------------------------------------------------------------------------------
--------------------------------------------------------------------------------------------------------------------------------------------------------------------------------------------------------
--------------------------------------------------------------------------------------------------------------------------------------------------------------------------------------------------------
--------------------------------------------------------------------------------------------------------------------------------------------------------------------------------------------------------
------B----------B------B------------U------BB-B------BB-U---------B--B----B--BB--B----------------------B-----------B----------U--U------BB----BB------B--B--U-------UUUUUUUUUUU--UUUUUUUUUUUUUUUUUUUUU
----------------------C------------C------------------------C-----------------------------------------------------C-------------------------------------------------------------------------------------
--------------------------------------------------------------------------------------------------------------------------------------------------------------------------------------------------------
--------------------------------------------------------------------------------------------------------------------------------------------------------------------------------------------------------
--------------------------------------------------------------------------------------------------------------------------------------------------------------------------------------------------------
B---------B---tt----B-B--UU#C----B-B-CttC-#B-----B--#----C--Btt--U---U---tt-tt-------------C------#--#---------#--B---#---##-CCBCBCC---U-#--UU-#-----#---#B---CU------CCCCCCCCCCC--CCCCCCCCCCCCCCCCCCCCC
----tt--#----#tt-----------#--#-------tt--#--------###-------tt-----#----tt-tt--------------------#--#--------##------#---##---------#---#-----#--tt-#tt-#--#-----tt-------------tt---------------------
----tt--#----#tt-----------#--##------tt--#-------####-------tt-----#----tt-tt--tt-tt-------tt--tt#--#-------###tt----#-tt##---------#---#-----#--tt-#tt-#--#-----tt-------------tt---------------------
--g-ttgg#----#tt---g---k---#-g###---g-tt--#-------####----#g-tt---kg#----tt-tt--tt-tt---k---tt--tt#--##g#--g####tt-#--##tt##--------##k--#g----#--tt-#ttg#--#g--k-tt-g-----------tt--------------------F
XXXXXXXXXXXXXXXXXXXXXXXXXXXXXXXXXXXXXXXXXXXX--X-XXXXXX-XXXXXXXXXXXXXXXX--XXXXX-XXX-XXXXXX-XXXXXXXXXXXXXXXXXXXXXXXXXXXXXXXXXXXXXXXXXXXXXXXXX-XXXXX-XXXXXXXXXXXXXXXXXXXXXXXXXXXXXXXXXXXXXXXXXXXXXXXXXXXXXX
XXXXXXXXXXXXXXXXXXXXXXXXXXXXXXXXXXXXXXXXXXXX--X-XXXXXX-XXXXXXXXXXXXXXXX--XXXXX-XXX-XXXXXX-XXXXXXXXXXXXXXXXXXXXXXXXXXXXXXXXXXXXXXXXXXXXXXXXX-XXXXX-XXXXXXXXXXXXXXXXXXXXXXXXXXXXXXXXXXXXXXXXXXXXXXXXXXXXXX
