--------------------------------------------------------------------------------------------------------------------------------------------------------------------------------------------------------
--------------------------------------------------------------------------------------------------------------------------------------------------------------------------------------------------------
--------------------------------------------------------------------------------------------------------------------------------------------------------------------------------------------------------
--------------------------------------------------------------------------------------------------------------------------------------------------------------------------------------------------------
--------------------------------------------------------------------------------------------------------------------------------------------------------------------------------------------------------
------BB---B------U-----------------------------------------BB------------B--B----BU-B--B--U--B----------BB---BB---BB-------B--BB----B-----U---UU---B---------------------------------------------------
------------------------------------------C---C------------------C------------------------------------------------------C-------------------------------------------------------------------------------
--------------------------------------------------------------------------------------------------------------------------------------------------------------------------------------------------------
--------------------------------------------------------------------------------------------------------------------------------------------------------------------------------------------------------
--------------------------------------------------------------------------------------------------------------------------------------------------------------------------------------------------------
-##-U----tt-------C---------#--#----ttC---B---B-U----------B-----B--#---#--tt------C-----C-C-C-ttCC-#---#-------C-B-----B------------------C---CC----#--CCCCUCCCCCUCCCCCUCCCCCCUCCCCUCCCCC-CCUCCCCUCCCCC
-##------tt------------#---##-##----tt-----tt---------#-----------tt#---#--tt-tt---------------tt---#---#---tt--------tt---------tt---tt-----------#-#tt------------------------------------------------
-##------tt-tttt-------##-######-tt-tt-----tt---------#tt-----tt#-tt#---##-tt-tt-#-------------tt---#tt-#---tt--------tt---------tt---tt-----------#-#tt------------------------------------------------
-##g-g-g-tt-tttt-----gk#########-tt#tt---k-ttg-#-k----#tt-k---tt#-tt#ggg##-ttgtt##---gg-g-----gtt---#tt-#g--ttgg-----gtt---#-----ttgg-tt-gg--gg----#-#tt-----------------------------------------------F
XXXXXXXXXXXXXXXXXXXXXXXXXXXXXXXXXXXXXXXXXXXXXXXXXXX-XXXXXXXXXXXXXXXXXXXXXXXXXXXXXXXXXXXXXXXXXXXXXXXXXXXXXX-XXXXXXXX--XXXXX-XXXX-XXXXX-XXXXXXXXXXXXXXXXXXXXXXXXXXXXXXXXXXXXXXXXXXXXXXXXXXXX-XXXXXXXXXXXXX
XXXXXXXXXXXXXXXXXXXXXXXXXXXXXXXXXXXXXXXXXXXXXXXXXXX-XXXXXXXXXXXXXXXXXXXXXXXXXXXXXXXXXXXXXXXXXXXXXXXXXXXXXX-XXXXXXXX--XXXXX-XXXX-XXXXX-XXXXXXXXXXXXXXXXXXXXXXXXXXXXXXXXXXXXXXXXXXXXXXXXXXXX-XXXXXXXXXXXXX
