--------------------------------------------------------------------------------------------------------------------------------------------------------------------------------------------------------
--------------------------------------------------------------------------------------------------------------------------------------------------------------------------------------------------------
--------------------------------------------------------------------------------------------------------------------------------------------------------------------------------------------------------
--------------------------------------------------------------------------------------------------------------------------------------------------------------------------------------------------------
--------------------------------------------------------------------------------------------------------------------------------------------------------------------------------------------------------
-S-U---SU---------S--S---------U--------S-U--------S--S----S-S--U----------------S-----------------------U-------S-------S---------SS-----SS----------SU-----U------------------------------------------
------------------------------------C------------------------------------C------------------------------------------------------------------------------------------------------------------------------
--------------------------------------------------------------------------------------------------------------------------------------------------------------------------------------------------------
--------------------------------------------------------------------------------------------------------------------------------------------------------------------------------------------------------
--------------------------------------------------------------------------------------------------------------------------------------------------------------------------------------------------------
U--C----C---#-CC----------tt-C-C-C--SC---UC--tt---#--#----U-----C---UU---Stt--------tt-S-UC-tt-----------C-------------C-------#--S-----------------tt-C-ttU-C------------------------------------------
--#-tt------#------#----#-tt-------#---------tt--##--#--#---#------#--#---tt----#--#tt------tt------------#-----#-#---#------tt#tt-----------------#tt--#tt---------------------------------------------
--#-tt-----##------#----#-tt-------#---------tt-###--#--#---#----#-#--#---tt-tt-#--#tt------tt-tt---------#---#-#-#-tt#---#--tt#tt-----------------#tt--#tt---------------------------------------------
-g#-ttk--k-##---g--#----#ktt-------#--k-g--k-tt####-k#gk#---#-k--#-#--##--tt-tt-#gg#tt--k--gtt-tt---------#--g#-#-#-tt#---#--tt#tt---##-gggg--k-#--#ttg-#tt-----gggggggggggg--ggggggkggggggggggggggggggF
%||%|||-%|%||%%%|%-|%%%%||||-%%%%%%|%%|%|%%|%||||||%|||||%%-|-|%%|-|%%||%%||%||%||||||-%|%%|||%||--%%-%%%%|%%||-|-|%|||%%-|%%|||||%--||%||||%%|%|%%||||%|||%-%%-||||||||||||%%|||||||||||||||||||||||||%
|||||||-||||||||||-|||||||||-||||||||||||||||||||||||||||||-|-||||-|||||||||||||||||||-||||||||||--||-|||||||||-|-|||||||-|||||||||--|||||||||||||||||||||||-||-||||||||||||||||||||||||||||||||||||||||
