--------------------------------------------------------------------------------------------------------------------------------------------------------------------------------------------------------
--------------------------------------------------------------------------------------------------------------------------------------------------------------------------------------------------------
--------------------------------------------------------------------------------------------------------------------------------------------------------------------------------------------------------
--------------------------------------------------------------------------------------------------------------------------------------------------------------------------------------------------------
--------------------------------------------------------------------------------------------------------------------------------------------------------------------------------------------------------
U--B-----------------BB---------U-U--B--------------B------B--------B------BU-------BBB---UB---------------U-------U------------------------------------------------------------------------------------
-----------------------------------C-----------------C-------------------C-------------------C----------------------------------------------------------------------------------------------------------
--------------------------------------------------------------------------------------------------------------------------------------------------------------------------------------------------------
--------------------------------------------------------------------------------------------------------------------------------------------------------------------------------------------------------
--------------------------------------------------------------------------------------------------------------------------------------------------------------------------------------------------------
C---CB--B--tt----U-------B------C-CB-----------------B-U-BB--------------B#-C-tt--UB------C-CB--##CBB-BCBB-C-CBB--BCBCBB---BBBCBB--B-BBCBB-CBB-BBBCBB-BBBBBBBBB-BBBCBB-ttBBCBB-BBBBBBBBBBBBBBBBCBB-BBBBB
------tt---tt------tt------#---------------------#----#-------------------#---tt-------#--------##---------------------------------------------------------------------tt-------------------------------
------tt-tttt-tt#--tt--tt--#--tt-------#--tttttt##----#------tt-tt-#------#---tt-------##-------##---------------------------------------------------------------------tt-------------------------------
-k----tt-tttt-tt#--tt--tt--#-gtt----#--#k-tttttt##-#--#-----gttgttk#gk#k--#---tt-g----g###-g--k-##-----------------------g--------#-g--------------------------#-------tt------------------------------F
XXX-XXXXXXXXXXXXXX-XXXXXXX-XXXXXXXXXXXXXXXXXXXXXXX-X-XXXXXX-XXXXXXXXXXXXXXX-XXXXXXXX--XXXXXXXXXXXXXXXXXXXXXXXXXXXXXXXXXXXX-XXXXXXXXXXXXXXXXXXXXXXXXXXXXXXXXXXXXXXXXXXXXXXXXXXXXXXXXXXXXXXXXXXXXXXXXXXXXX
XXX-XXXXXXXXXXXXXX-XXXXXXX-XXXXXXXXXXXXXXXXXXXXXXX-X-XXXXXX-XXXXXXXXXXXXXXX-XXXXXXXX--XXXXXXXXXXXXXXXXXXXXXXXXXXXXXXXXXXXX-XXXXXXXXXXXXXXXXXXXXXXXXXXXXXXXXXXXXXXXXXXXXXXXXXXXXXXXXXXXXXXXXXXXXXXXXXXXXX
