--------------------------------------------------------------------------------------------------------------------------------------------------------------------------------------------------------
--------------------------------------------------------------------------------------------------------------------------------------------------------------------------------------------------------
--------------------------------------------------------------------------------------------------------------------------------------------------------------------------------------------------------
--------------------------------------------------------------------------------------------------------------------------------------------------------------------------------------------------------
--------------------------------------------------------------------------------------------------------------------------------------------------------------------------------------------------------
--S-----SS--U---SS---SU----------S--S---S-S-S---U-U----U--S-----U---S------------SS-U---SU-U------------U-----U---U--------U---U-U--S---S---S-----------------------------------------------------------
-----------------------------------------------C-C-------------------------C---------------------------------------------CC-----C-C--C------------------------------------------------------------------
--------------------------------------------------------------------------------------------------------------------------------------------------------------------------------------------------------
--------------------------------------------------------------------------------------------------------------------------------------------------------------------------------------------------------
--------------------------------------------------------------------------------------------------------------------------------------------------------------------------------------------------------
S---------C-C-C-------C#----Ctt----------------SCSCU---CC--S----C-tt-------S--ttU---C----C-C-U-U--------C---C-C-C-C----C#SSC---CSCS--S-------------------------------------S-S--------------------------
----#------------------#-tt--tt##---------------------------------tt-#--------tt----------#-------------------------#---#--------------------------#----------------#-----------------------------------
----#----------#-------#-tt--tt##----#-#------#----------------#--tt-##-tt--tttt---#------#-------tt--tt------------#tt-#--------------#-tt--------#----------------#-----------------------------------
-gg-#---g------#g-g----#gtt--tt##g--g#-#-gg-gg#------k---gg--#-#--tt-###ttg-tttt---#--gg--#-g-k---tt--tt-k-g--------#tt-#---g-g----g---#gttg-gggggg#gggggggggggggggg#gggggg-g-gggggggggggggggggggggggggF
%||%|%--|-%%%%%||-|%%-%||||-%|||||%%||%|-||%|||%%%%%%|%%%||%%|-|%-||-||||||%||||%-%|%%||%%|%|%|%--||%%||%|%|%%%%%%%%|||%|%%%|%|%%%%|-%%|||||-||||||||||||||||||||||||||||||%|%|||||||||||||||||||||||||%
||||||--|-|||||||-|||-|||||-||||||||||||-|||||||||||||||||||||-||-||-||||||||||||-||||||||||||||--||||||||||||||||||||||||||||||||||-|||||||-|||||||||||||||||||||||||||||||||||||||||||||||||||||||||||
