--------------------------------------------------------------------------------------------------------------------------------------------------------------------------------------------------------
--------------------------------------------------------------------------------------------------------------------------------------------------------------------------------------------------------
--------------------------------------------------------------------------------------------------------------------------------------------------------------------------------------------------------
--------------------------------------------------------------------------------------------------------------------------------------------------------------------------------------------------------
--------------------------------------------------------------------------------------------------------------------------------------------------------------------------------------------------------
------------------------------S----------U---------------U-------------------S----------------------S---U-----------------------------------------------S-----------------------------------------------
------------C----------------------------------------------C----------------------------------C---------------------------------------------------------------------------------------------------------
--------------------------------------------------------------------------------------------------------------------------------------------------------------------------------------------------------
--------------------------------------------------------------------------------------------------------------------------------------------------------------------------------------------------------
--------------------------------------------------------------------------------------------------------------------------------------------------------------------------------------------------------
------------S--------#tt-----C--tt----#CSCSC--##---#-----C-S----------------#-------C----#----S-CSS---C-C-C------tttttttttttttttt-tttttttt-tt-Stttttt--#-tttttt#tttttttttttttt-tt-tttttttttttttttttttt--
--------#----tt-#---##tt--------tt---##------###--###--------#-----#---#--###-tt--------##--#--#-------------#---tttttttttttttttt-tttttttt-tt--tttttt-##-tttttt#tttttttttttttt#tt-tttttttttttttttttttt--
-tt#--#-##---tt-#--###tt-tt-----tt--###-----####-#####-tt----##--#-##-###-###-tt--tt---####-#--#-----------#-#-tttttttttttttttttt-tttttttt-tt--tttttt###-tttttt#tttttttttttttt#tt-tttttttttttttttttttt--
-tt##-#-####-tt-##-###tt-ttg#-g#tt#-###-----###########tt----###-#-######-###-tt--tt-g#####-#--#----gk-----#-#-tttttttttttttttttt-tttttttt#ttk-tttttt###-tttttt#tttttttttttttt#ttgttttttttttttttttttttkF
%||||-|-||||%||-||-|||||%||||%|||||-|||%%%%%|||||||||||||%%%%|||-|-||||||-|||%||%%||%||||||-|%%|%%%%||%%%%%|-|-||||||||||||||||||%||||||||||||%|||||||||%||||||||||||||||||||||||||||||||||||||||||||||%
|||||-|-|||||||-||-||||||||||||||||-||||||||||||||||||||||||||||-|-||||||-|||||||||||||||||-||||||||||||||||-|-|||||||||||||||||||||||||||||||||||||||||||||||||||||||||||||||||||||||||||||||||||||||||
