--------------------------------------------------------------------------------------------------------------------------------------------------------------------------------------------------------
--------------------------------------------------------------------------------------------------------------------------------------------------------------------------------------------------------
--------------------------------------------------------------------------------------------------------------------------------------------------------------------------------------------------------
--------------------------------------------------------------------------------------------------------------------------------------------------------------------------------------------------------
--------------------------------------------------------------------------------------------------------------------------------------------------------------------------------------------------------
-----------S-S--------SS---U-----------U-----SS---------------SS------U--S-------S---U-----------------S----------------------------------------------------------------------------S-------------------
-----C--------------------------------C-----------------------------C---C-------------------------------------------------------------------------------------------------------------------------------
--------------------------------------------------------------------------------------------------------------------------------------------------------------------------------------------------------
--------------------------------------------------------------------------------------------------------------------------------------------------------------------------------------------------------
--------------------------------------------------------------------------------------------------------------------------------------------------------------------------------------------------------
#U--#S---tt-------#--C-----C---S-----#SC-UC-S---tt---U-U#C---S----ttS-C-S-----#------C----#tt---#ttCSS--S--------------UCCCCC-UCCCCUCCCCCCCUCCCCUCCCCUCCCCUCCCCUCCCC------------------------------------
#--##----tt------##-------#-tt-------#----------tt------#-------tttt---------##tt-----tt-##tt--##tt-------------##-#-tt-----------------------------------------------#--###-#######-####tt-#tttttttttt-
#-###----tt-----###-----#-#-tt----#tt#----------tt-tt---#-------tttt--------###tt--tt-tt###tt-###tt-------tt--#-##-#-tt------#--------------------------------------#-##-###-#######-####tt-#tttttttttt-
#-###-gg-tt--gg####-#---#-#-ttg-#-#tt#---------#tt-tt-g-#-k-g---tttt-g-g-g#-###tt-#tt-tt###tt####tt----g--tt--#-##g##tt------#--------------------------------------#-##-###-#######-####tt-#ttttttttttF
|%|||%||%||%%||||||%|%-%|-|%|||%|-||||%%%%%%%%%|||%||%|%|%|%|%%%||||%|%|%||-|||||-|||%|||||||||||||%%%%|%%||%%|-|||||||%%%%%%|%%%%%%%%%%%%%%%%%%%%%%%%%%%%%%%%%%%%%%|-||-|||%|||||||-||||||-|||||||||||%
||||||||||||||||||||||-||-|||||||-|||||||||||||||||||||||||||||||||||||||||-|||||-|||||||||||||||||||||||||||||-|||||||||||||||||||||||||||||||||||||||||||||||||||||-||-|||||||||||-||||||-||||||||||||
