--------------------------------------------------------------------------------------------------------------------------------------------------------------------------------------------------------
--------------------------------------------------------------------------------------------------------------------------------------------------------------------------------------------------------
--------------------------------------------------------------------------------------------------------------------------------------------------------------------------------------------------------
--------------------------------------------------------------------------------------------------------------------------------------------------------------------------------------------------------
--------------------------------------------------------------------------------------------------------------------------------------------------------------------------------------------------------
U-----B-------------BB--B--------B--B--B-------------B--B--B-----BB----B-B-B-----------B----B-------------B-BU---B--------------B-----BB-BB-----B---B------------------------------------------B--------
-------------------------------------------C--C-C-------------------------------------------------------C-------C------------------------------------------C--------------------------------------------
--------------------------------------------------------------------------------------------------------------------------------------------------------------------------------------------------------
--------------------------------------------------------------------------------------------------------------------------------------------------------------------------------------------------------
--------------------------------------------------------------------------------------------------------------------------------------------------------------------------------------------------------
CCtt----tt---------B-----tt--------#------BBttB-B-----tt------------tt#-------#----tt---tt-------------BB--C-C-BB--ttB-----tt-#----ttB-----CUU---ttC---C---B---U------------U-------------C-------------
--tt-#--tttt-tt----------tt-#--tt--#----tt--tt---#-#--tt-tt----tt---tt#------##tt--tt-#-tt-----tttt----------------tt-tt---tt-#----tt------------tt--tt---#------------#--------------------------------
--tt-#--tttt-tt--tt------tt-#--tt--#----tt--tt---#-#--tt-tt----tt---tt#-----###tttttt-#-tttt---tttt--tt------------tt-tt-tttt-#----tt------------tt--tt-#-#----------#-#--------------------------------
--ttg#g-ttttgtt--tt---#g-tt-#k-tt-k#----tt--tt---#k##gtt-tt--ggttgg-tt#g----###tttttt-#-ttttg-gtttt--tt-----------ktt-tt#tttt##g--#tt---g-------gtt--tt-#-#--------#-#-#g-------------g----------------F
XXXXXXXXXXXXXXXXXXXXXXXX-XXXXXXXXXXXX-X-XXXXXXXXXXXXXXXXXXX-XXXXXXX-XXXX-XXXXXXXXXXXX-XXXXXXX-XXXXXXXXXXXXXXXXXXXXXXXXXXXXXXXXXXXXXXXX--X--XXXX-XXXXXXXXX-XX---X---X-X-XX---XXX-XX-XXXX---X----XX-------
XXXXXXXXXXXXXXXXXXXXXXXX-XXXXXXXXXXXX-X-XXXXXXXXXXXXXXXXXXX-XXXXXXX-XXXX-XXXXXXXXXXXX-XXXXXXX-XXXXXXXXXXXXXXXXXXXXXXXXXXXXXXXXXXXXXXXX--X--XXXX-XXXXXXXXX-XX---X---X-X-XX---XXX-XX-XXXX---X----XX-------
