--------------------------------------------------------------------------------------------------------------------------------------------------------------------------------------------------------
--------------------------------------------------------------------------------------------------------------------------------------------------------------------------------------------------------
--------------------------------------------------------------------------------------------------------------------------------------------------------------------------------------------------------
--------------------------------------------------------------------------------------------------------------------------------------------------------------------------------------------------------
--------------------------------------------------------------------------------------------------------------------------------------------------------------------------------------------------------
--------BU-BB-----U-B---------U---BB---------U--U-U-B-UB----------BU-------B-B---U----------------------U--------B-B--------UB--------------B------U--------B---------------------B---------------------
-----------------------------------------------------C------------------------------C-----------------------------------C----------------------------C--------------------------------------------------
--------------------------------------------------------------------------------------------------------------------------------------------------------------------------------------------------------
--------------------------------------------------------------------------------------------------------------------------------------------------------------------------------------------------------
--------------------------------------------------------------------------------------------------------------------------------------------------------------------------------------------------------
--U------CB--U-tt-CU----#--#--CttB--U---#B---C--C-C--BC-tt---------C------------CC#-BC----#-CU-#---tt---C----tt-------CBB---C----------------B----#C-B-------------ttC---#Utt---------B-----------------
-#---tt--------tt-------#--#---tt-------#--tt-----------tt-----tt----#------#-----#-------#----#tt-tt--------tt-----tt---------tt----#-tt-#----tt-#-------tt-------tt--tt#-tt####--###-#################
-#---tt--------tt----tt-#--#---tt-------#-#tt----#------tt-tt--tt----#-#----#-tt--#---tt#-#----#tt-tt-tt-#---tt-----tt---tt#---tt--#-#-tt-#----tt-#-------tt-----#-tt--tt#-tt####--###-#################
-#-g-ttg------gtt---gttk#--#---tt-----gk#-#tt-g--#-g----tt-tt-gttg--k#k#-g--#-tt--#---tt###k---#tt-tt-tt-#gg-tt--gk-tt---tt#-g-tt#-#-#gtt-#g---ttg#----#-#ttg---g#-tt--tt#-tt####k-###-################F
XXXXXXXXXXX--XXXXXXXXXXXXXXX--XXXX--XXXXXXXXXXXXXXXXXXX-XXXXXXXXXXXXXXXXXXX-XXXXXXXXXXXXXXXXXX-XXXXXXXXXXXXXXXX-XXXXXXXXXXXXXXXXXX-X-XXXX-XX-XXXXXXXXXXXXXXXXXXXXXXXXXXXXXXXXXXXXXXXXXXXXXXXXXXXXXXXXXXX
XXXXXXXXXXX--XXXXXXXXXXXXXXX--XXXX--XXXXXXXXXXXXXXXXXXX-XXXXXXXXXXXXXXXXXXX-XXXXXXXXXXXXXXXXXX-XXXXXXXXXXXXXXXX-XXXXXXXXXXXXXXXXXX-X-XXXX-XX-XXXXXXXXXXXXXXXXXXXXXXXXXXXXXXXXXXXXXXXXXXXXXXXXXXXXXXXXXXX
