--------------------------------------------------------------------------------------------------------------------------------------------------------------------------------------------------------
--------------------------------------------------------------------------------------------------------------------------------------------------------------------------------------------------------
--------------------------------------------------------------------------------------------------------------------------------------------------------------------------------------------------------
--------------------------------------------------------------------------------------------------------------------------------------------------------------------------------------------------------
--------------------------------------------------------------------------------------------------------------------------------------------------------------------------------------------------------
S-----------------S-U------SU-------S---------S------------------------SS----S--U-----------S----------------S---S--------------US--------U-SS--S------S------------S-----------------------------------
----C------------------------------C--------------------------------C------------------------------------------------------------------------------------------------C----------------------------------
--------------------------------------------------------------------------------------------------------------------------------------------------------------------------------------------------------
--------------------------------------------------------------------------------------------------------------------------------------------------------------------------------------------------------
--------------------------------------------------------------------------------------------------------------------------------------------------------------------------------------------------------
-tt-S-#tt--U-#---#--C--tt---C-----CS-----------tt------tt--C---tt--#S-S---------C-#U--U--------U--tt----C---#-tt#------#-S-#--U-C-#-----ttCS---#------U-----------tt-S----------------------------------
-tt---#tttt--#-tt#-----tt#---#-----------------tt------tt----tttttt#----------tt--#----------tt---tt--------#-tt#------#---#tt----#---tttt-----#-#-#-#--#---------tt---######-###-################--####
-tt---#tttt--#-tt#-----tt#---#--#------#-------tt------tttt--tttttt#-#------#-tt--#------#-#-tt---tt-tt---tt#-tt#------##--#tt----#tt-tttt-----#-#-#-#--##--#-tt--tt---######-###-#################-####
-ttg--#tttt--#-tt#---g-tt#k--#kk#----#-#-#---ggtt------tttt--tttttt#-#---##-#gtt--#--g-#-#g#gtt--gtt-tt#-ktt#gtt#-----g##-k#tt----#tt-tttt-----#-#-#-#-g###-#gtt#ktt--g######-###k#####################F
-|||%%|||||%%|%|||-%%|-||||-%||||%%%-|-|%|%%%||||%-%%--||||%%|||||||%|%%%||-||||%-|%%|%|-||||||%%|||%|||%||||||||-%-%%|||%||||%%%%|||%||||%%---|%|%|%|%||||-||||||||%%|||||||%|||||||||||||||||||||||||%
-|||||||||||||||||-|||-||||-||||||||-|-|||||||||||-||--||||||||||||||||||||-|||||-||||||-||||||||||||||||||||||||-|-||||||||||||||||||||||||---||||||||||||-||||||||||||||||||||||||||||||||||||||||||||
