--------------------------------------------------------------------------------------------------------------------------------------------------------------------------------------------------------
--------------------------------------------------------------------------------------------------------------------------------------------------------------------------------------------------------
--------------------------------------------------------------------------------------------------------------------------------------------------------------------------------------------------------
--------------------------------------------------------------------------------------------------------------------------------------------------------------------------------------------------------
--------------------------------------------------------------------------------------------------------------------------------------------------------------------------------------------------------
--------BU-B----------B--------------------U----BB---------------------BB---------------U---BB-B-------------B---------B---U--------------------BU-------B----------------B-----U-----------------------
--C----------------------CC------------C-------------------------------------------C--------------------------------------------CC----------------------C----------------C-----------C------------------
--------------------------------------------------------------------------------------------------------------------------------------------------------------------------------------------------------
--------------------------------------------------------------------------------------------------------------------------------------------------------------------------------------------------------
--------------------------------------------------------------------------------------------------------------------------------------------------------------------------------------------------------
--B-CBtt-C-----Ctt-------BB-#-BC-U---BBBC--C-U------------CC-#B---U---B------U---UBB----C-----B---Utt-------#------B------#C--ttBB-------BUB-----CttB---B----B-#-tt-BB--BB------C----B------------------
------tt--------tt----------#------------tt----------#-------#--tt-------tt----------------#-------tt----#--#-------------#---tt-------tt----#----tt-----------#-tt---#-----------tt#-------------------
------tt-----tt-tt-tt#------#------tt----tt----#--tt-#tt-----#--tt--#----tt--------------#-#-------tt-tt##--#--------tt---#---tt--tt#tttt----##---tt--------#-##-tt---#-----------tt#-------------------
kg----tt--gggtt-tt-tt#-gk--k#------tt----tt-k--#g-ttg#tt-----#-gtt--#k---tt#--kg------#--#-#---g---tt-tt##--#g-g-----ttggk#--gtt--tt#tttt---g###--tt-#kg--g-#-##-tt---#----gg--#-gtt#------------------F
XXXXXXXX-XXXXXXXXXXXXXXXXXXXXXXX-XXXXXXXXXXXXXXXXXXXXXXXXXXXXXXXXXX-XXXXXXXX-XXXXXXXX-X-XX-XXXXXXXXXXXXXXXXXXXXXXXXXXXXXXXXXXXXXXXXXXXXXXXXXXXXX-XXXXXXXX-XXXXXXXXXXXXXXXX-XXXXXXXXXXXXXXXXXXXXXXXXXXXXX
XXXXXXXX-XXXXXXXXXXXXXXXXXXXXXXX-XXXXXXXXXXXXXXXXXXXXXXXXXXXXXXXXXX-XXXXXXXX-XXXXXXXX-X-XX-XXXXXXXXXXXXXXXXXXXXXXXXXXXXXXXXXXXXXXXXXXXXXXXXXXXXX-XXXXXXXX-XXXXXXXXXXXXXXXX-XXXXXXXXXXXXXXXXXXXXXXXXXXXXX
