--------------------------------------------------------------------------------------------------------------------------------------------------------------------------------------------------------
--------------------------------------------------------------------------------------------------------------------------------------------------------------------------------------------------------
--------------------------------------------------------------------------------------------------------------------------------------------------------------------------------------------------------
--------------------------------------------------------------------------------------------------------------------------------------------------------------------------------------------------------
--------------------------------------------------------------------------------------------------------------------------------------------------------------------------------------------------------
---------------------U----U-----U------B-------B--------U---------B-U----B--------BB-------BBB------------------UU-B---------BU-----------------U-BBBBB-BBBBBB-BB-BB-BB-B-BB-BB----BBB-BBBBB-B--BBBBBBBB
-----------------------------------------C------------------C-------------C---------C-------------------------------------------------------C-----------------C-----------------------------------------
--------------------------------------------------------------------------------------------------------------------------------------------------------------------------------------------------------
--------------------------------------------------------------------------------------------------------------------------------------------------------------------------------------------------------
--------------------------------------------------------------------------------------------------------------------------------------------------------------------------------------------------------
----------tt-ttBB--C-C-CC-C-CC-#C-------#B----C-------CBCBCCBBCBB---C-----B-CC---B--B-#C-U----ttU-#--#---tt-C---CCU----C--tt--C--C----------B---CB-----B------B--B--B----B--B---------B-------tt--------
--------tttt-tt----------------#-----tt-#-#-------tt--------------------------tt#-----#-#-----tt--#--#---tt--------------#tt#-------#-----tt-#-------------------------#-------tttt---------#-tt--------
--------tttt-tt----------------#-----tt-#-#-----tttt--------------------------tt#-----#-#-----tt-##--#---tt--------------#tt#-----#-##-tt-tt-#-------------------------#-------tttt---------#-tt--------
-k-----gttttktt---g------------#----kttg#-##g---tttt##-------------k----gg-g--tt#----k#-#---g-tt-##--#-k#tt---gg------g--#tt#--g--#-##-tt-tt-#gk-----------------------#-------tttt---------#-tt-------F
-XX-XXXXXXXXXXXXX-XXXXXXXXXXXXXXXXXXXXXXXXXXXXX-XXXXXXXXXXXXXXXXXXXXX-XXXXXXXXXXXXXXXXXXXXXXXXXXXXXXXXXXXXXXXXXXXXX-XXXXXXXXX-XXXXX-XXXXX-XXXXXXXX-----X------X--X--X--X-X--X--XXXX---X-----X-XX--------
-XX-XXXXXXXXXXXXX-XXXXXXXXXXXXXXXXXXXXXXXXXXXXX-XXXXXXXXXXXXXXXXXXXXX-XXXXXXXXXXXXXXXXXXXXXXXXXXXXXXXXXXXXXXXXXXXXX-XXXXXXXXX-XXXXX-XXXXX-XXXXXXXX-----X------X--X--X--X-X--X--XXXX---X-----X-XX--------
