--------------------------------------------------------------------------------------------------------------------------------------------------------------------------------------------------------
--------------------------------------------------------------------------------------------------------------------------------------------------------------------------------------------------------
--------------------------------------------------------------------------------------------------------------------------------------------------------------------------------------------------------
--------------------------------------------------------------------------------------------------------------------------------------------------------------------------------------------------------
--------------------------------------------------------------------------------------------------------------------------------------------------------------------------------------------------------
---------------U-U-------B---U---------B-------------------U---------B------BBUB-B-------U------------------U--B---------B--B-----BB------------B-------------------------------------------------------
----C-----C---------------------------C-----------------------------------------------------------------------------------------------------------------------------------------------------------------
--------------------------------------------------------------------------------------------------------------------------------------------------------------------------------------------------------
--------------------------------------------------------------------------------------------------------------------------------------------------------------------------------------------------------
--------------------------------------------------------------------------------------------------------------------------------------------------------------------------------------------------------
----B----#B#-CCC-C----------BCBC--C-B-B--tttt-B--------#---C------#B-------B--C-#--U#----CB-------------B-#-CU--#-#--tt---tt-----B-----------BC--tt------------------------B----------#-----------------
-----tt-##-#----------#------------------tttt----tt---##---------##-------------#---#--#--------tt---#-#--#-----#-#--tt---tt--#-----#----#-------tt-----------------------------------#-----------------
#----tt###-#----------##--tt-------------tttt#---tt#-###tt------###-------#-----#---#--#------#-tt---#-#--#-----#-#--tt-#-tt--##----##--###------tt-----------------------------------#-----------------
##-k-tt###-#----------###gtt----g#-------tttt#-ggtt#####tt---#-####-gg----#-----#-#-#-k#---k#-#gttkg-#-#--#g---g#g#g-tt-#-tt--###---###-####---#-ttgggggggggggggggggggggggg-gggggggggg#ggggggggggggggggF
XXXXXXXXXXXXXXXXXXX-XXXXXXXXXXXXXXX-X-X-XXXXXXXXXXXXXXXXXXXX-XXXXXXXXXX-XXXX--XXX-XXXXXXXXXXX-XXXXXXXXXXXXXXXXXXXXXX-XXXXXXXX-XXXX--XXX-XXXXXXXXXXXXXXXXXXXXXXXXXXXXXXXXXXXXXXXXXXXXXXXXXXXXXXXXXXXXXXXX
XXXXXXXXXXXXXXXXXXX-XXXXXXXXXXXXXXX-X-X-XXXXXXXXXXXXXXXXXXXX-XXXXXXXXXX-XXXX--XXX-XXXXXXXXXXX-XXXXXXXXXXXXXXXXXXXXXX-XXXXXXXX-XXXX--XXX-XXXXXXXXXXXXXXXXXXXXXXXXXXXXXXXXXXXXXXXXXXXXXXXXXXXXXXXXXXXXXXXX
