--------------------------------------------------------------------------------------------------------------------------------------------------------------------------------------------------------
--------------------------------------------------------------------------------------------------------------------------------------------------------------------------------------------------------
--------------------------------------------------------------------------------------------------------------------------------------------------------------------------------------------------------
--------------------------------------------------------------------------------------------------------------------------------------------------------------------------------------------------------
--------------------------------------------------------------------------------------------------------------------------------------------------------------------------------------------------------
--------B---BU-------------B--------B-------B-------------------------------B-----U-B------B--B----------------B---BB---------B-----------U--U--B-----B-------------------------------------------------
---------------------------------------C--------------------------C-------------------------C----C-C-C-C-C----------------C------------C--------------------------C-------------------------------------
--------------------------------------------------------------------------------------------------------------------------------------------------------------------------------------------------------
--------------------------------------------------------------------------------------------------------------------------------------------------------------------------------------------------------
--------------------------------------------------------------------------------------------------------------------------------------------------------------------------------------------------------
---------BC--C---------#B-----CC-B---B-Btt---#-U--tt-#------UC----Btt---B--------#C-------#-BU-C-BBBBBBBBBtt----C-B-------B--#--ttB----BttC--C#------------C-C----B---U---------------------------#-----
----#-tt-------tt-----##----------------tt---##---tt-#----#---#----tt-----------##-------##-----#---------tt#---------------##--tt------tt-#--#---------------------------------------------------#-----
---##-tt-------tt----###----------------tt---##-tttt-#--#-#---#----tt----------###------###-----#---------tt#--------------###--tt------tt-#--##-----#--------------------------------------------#-----
-g###-ttg--k--gttg--####--#-g------gg-#-tt-k-##-ttttg#--#-#---#-k--ttk------g#-###-----####---g-#---------tt#-g------------###--tt-kg#k-tt-#--##-#g#-#ggggg-g-gggg-ggg-ggggggggggggggggggggggggggg#ggggF
XXXXXXXXXXXXXXXXXXXXXXXXXXX-XXXXXXXXXXXXXXXXXXXXXXXXXXXXX-XXXXXXXXXXXXXXXXXXXX-XXXXXX-XXXXXXXXXXXXXXXXXXXXXXX-XXX-X---X-XXXXXXXXXXXXXXXXXXXX-XXX-XXX-XXXXXXXXXXXXXXXXXXXXXXXXXXXXXXXXXXXXXXXXXXXXXXXXXXX
XXXXXXXXXXXXXXXXXXXXXXXXXXX-XXXXXXXXXXXXXXXXXXXXXXXXXXXXX-XXXXXXXXXXXXXXXXXXXX-XXXXXX-XXXXXXXXXXXXXXXXXXXXXXX-XXX-X---X-XXXXXXXXXXXXXXXXXXXX-XXX-XXX-XXXXXXXXXXXXXXXXXXXXXXXXXXXXXXXXXXXXXXXXXXXXXXXXXXX
