--------------------------------------------------------------------------------------------------------------------------------------------------------------------------------------------------------
--------------------------------------------------------------------------------------------------------------------------------------------------------------------------------------------------------
--------------------------------------------------------------------------------------------------------------------------------------------------------------------------------------------------------
--------------------------------------------------------------------------------------------------------------------------------------------------------------------------------------------------------
--------------------------------------------------------------------------------------------------------------------------------------------------------------------------------------------------------
-----------U-----SS------U--S-S----U--------S-------------S----------UU---S------U-------S-S---------------U----------U---------------S-----------------------------------------------------------------
C---------------------C---------------------------------C---------C------C--C---------------------------------------------------------------------------------------------------------------------------
--------------------------------------------------------------------------------------------------------------------------------------------------------------------------------------------------------
--------------------------------------------------------------------------------------------------------------------------------------------------------------------------------------------------------
--------------------------------------------------------------------------------------------------------------------------------------------------------------------------------------------------------
S-----S----C--S-S--tt-S-#C---------C-----ttU----#S-#--S-SU-------#S--CCttS--S----CUtt--##---tt---------S---CSS------U-C----C---#-ttCU------U-ttU#U#----------#--------------#---------------------------
---------##----#---tt---#------tt--------tt-----#--#tt-----#-----#-----tt----------tt--##---tt#-----------------tt-----#------##-tt--#-------tt-#-#####--##-############---##########-########-#########
-tt--#---##----#---tt---#------tt------#-tt-----#--#tt-----#--#tt#-----tt----------tt--##-#-tt#--#------tt#-----tt#----##----###-tt--#-------tt-#-######-################-###########-########-#########
-tt#-#-g-##----#---ttk--#-g----ttk---#-#-tt-g#g-#--#tt----g#--#tt#-----tt--g-kg#---ttgg##g#-tt##-#----g-tt#---#-tt##---###--####-tt--#--k-#--tt-#-###################################g########g########F
%|||-|%|%||%--%|%%%|||%%|%|%%-%|||%%%|-|%||%|||%|%%|||%%%%||-%||||%%%%%||%-|%|||%%%||||||||-||||-|%-%%|%|||%%%|%||||%%%|||%%||||%||%%|--|%|%%||%|%|||||||||||||||||||||||||||||||||||||||||||||||||||||%
||||-|||||||--|||||||||||||||-||||||||-|||||||||||||||||||||-|||||||||||||-||||||||||||||||-||||-||-||||||||||||||||||||||||||||||||||--||||||||||||||||||||||||||||||||||||||||||||||||||||||||||||||||
