--------------------------------------------------------------------------------------------------------------------------------------------------------------------------------------------------------
--------------------------------------------------------------------------------------------------------------------------------------------------------------------------------------------------------
--------------------------------------------------------------------------------------------------------------------------------------------------------------------------------------------------------
--------------------------------------------------------------------------------------------------------------------------------------------------------------------------------------------------------
--------------------------------------------------------------------------------------------------------------------------------------------------------------------------------------------------------
--S------S---S-S-------S---------------------------S-U-------S---SS----------S------------------S-------------------------------------------------------------------------------------------------------
----------------------------C-------------------------------------------------C-------------------------------------------------------------------------------------------------------------------------
--------------------------------------------------------------------------------------------------------------------------------------------------------------------------------------------------------
--------------------------------------------------------------------------------------------------------------------------------------------------------------------------------------------------------
--------------------------------------------------------------------------------------------------------------------------------------------------------------------------------------------------------
CU--------------tt--SS--S--CS---U-------------------UC------C-#-S--ttCtt------S----C---tt---------tt---------------#---------#-----S-----------------S------------------tt------------------------------
----------------tttt------------------------------------------#----tt-tt-#-------------tt---------tt---------------#---------#------------------------------------------tt------------------------------
-----tt---------tttt-----------#-----------------tt----#------#----tt-tt-##---------#--tt-tt---#--tt-tttt--tt--tttt#-tttt-tt-#tttt--tttttttt#tttttttt-tttttt--tttttttttttt-tttttttttttttttttttttttttttt-
--gg-tt-gg----ggtttt-----g#--g-#-g#------------gktt---g#gg-g--##---tt-ttg###-g-k##--#ggtt-ttk-g#--tt-tttt--tt--tttt#-tttt#ttg#tttt--tttttttt#tttttttt-tttttt--tttttttttttt-ttttttttttttttttttttttttttttF
%%||%||%||-%-%||||||%%%-%||%%|%|%||%-%%-%%%-%%%||||%%%||||-|%-||%%%||%||||||%|%|||%%|||||%|||%||-%||%||||%%||%%|||||%|||||||||||||-%|||||||||||||||||%||||||%%||||||||||||-||||||||||||||||||||||||||||%
||||||||||-|-||||||||||-||||||||||||-||-|||-||||||||||||||-||-||||||||||||||||||||||||||||||||||-|||||||||||||||||||||||||||||||||-|||||||||||||||||||||||||||||||||||||||-|||||||||||||||||||||||||||||
