--------------------------------------------------------------------------------------------------------------------------------------------------------------------------------------------------------
--------------------------------------------------------------------------------------------------------------------------------------------------------------------------------------------------------
--------------------------------------------------------------------------------------------------------------------------------------------------------------------------------------------------------
--------------------------------------------------------------------------------------------------------------------------------------------------------------------------------------------------------
--------------------------------------------------------------------------------------------------------------------------------------------------------------------------------------------------------
----B-------B-----------------------B----------------B--B-----------BB--B---------------U---------------------------------------------------------------------------------------------------------------
--------------C------------------------------------------C-------------------------------------------------------------------C-C-C-C-C-C-C-C-C-C-CC-C-C-C--CCCCCCCCCCCCCCCCCCCCC--CCCCCCC---------------
--------------------------------------------------------------------------------------------------------------------------------------------------------------------------------------------------------
--------------------------------------------------------------------------------------------------------------------------------------------------------------------------------------------------------
--------------------------------------------------------------------------------------------------------------------------------------------------------------------------------------------------------
--------UB#---BU-----tt-#---------#---------tt----U-U-UU-Btt-------B--C-------tt--------C------U--#tt-----C--U--------------BBBBBBBBBBBBBBBBBBBBBBBBBBBBBB-BBBBBBBBBBBBBBBBBBBBBUUBBBBBBBU-UUUUUUUUUUUUU
----------#----------tt-#---#tt--##--##-----tt------------tt---#---------##---tt-----#-----------##tt---tt------------------------------------------------#---------------------------------------------
----------##------#--tt-#-#-#tt-###--###--#-tt-#tt--------tt---#--#------##-tttt-#-#-#-#---#----###tt-tttt------#-tt-#-----#------------------------------#---------------------------------------------
--ggg-----##----#-#g-tt-#g#-#tt####--####-##tt-#tt---g----ttg--##-#------##ktttt-#-#-#-#-#-#g-#-###tt-tttt-##-#-#-ttg#ggggg#------------------------------#--------------------------------------------F
XXXXXXXXXXXX-XXXX-XX-XXXXXX-XXXXXXX-XXXXX-XXXX-XXXX-XXXX-XXXXXXXX-XXXXXX-XXXXXXX-XXX-XXXXX-XXXXXXXXXXXXXXXXXXXX-XXXXXXXXXXXXXXXXXXXXXXXXXXXXXXXXXXXXXXXXXXXXXXXXXXXXXXXXXXXXXXXXXXXXXXXXXXXXXXXXXXXXXXXX
XXXXXXXXXXXX-XXXX-XX-XXXXXX-XXXXXXX-XXXXX-XXXX-XXXX-XXXX-XXXXXXXX-XXXXXX-XXXXXXX-XXX-XXXXX-XXXXXXXXXXXXXXXXXXXX-XXXXXXXXXXXXXXXXXXXXXXXXXXXXXXXXXXXXXXXXXXXXXXXXXXXXXXXXXXXXXXXXXXXXXXXXXXXXXXXXXXXXXXXX
