--------------------------------------------------------------------------------------------------------------------------------------------------------------------------------------------------------
--------------------------------------------------------------------------------------------------------------------------------------------------------------------------------------------------------
--------------------------------------------------------------------------------------------------------------------------------------------------------------------------------------------------------
--------------------------------------------------------------------------------------------------------------------------------------------------------------------------------------------------------
--------------------------------------------------------------------------------------------------------------------------------------------------------------------------------------------------------
B-----BB------------------B--B-------------U--------------B-------------------U-----B-----BB-------------U-------U--B----------B----------------U-------B---------------B-----B--B-----------------U--UU
------------------C-----------------------------------C--C-----------------------------------C---------------C------------C-------------C-----------C---------------------C----C-----------C------------
--------------------------------------------------------------------------------------------------------------------------------------------------------------------------------------------------------
--------------------------------------------------------------------------------------------------------------------------------------------------------------------------------------------------------
--------------------------------------------------------------------------------------------------------------------------------------------------------------------------------------------------------
---U-------#------B--C----------Utt#CC---BUC----C-----B--B---#--------tt-tt---CC-#----C------B-tt---BB---C---BU--C##------B-C---U-------B------BCttBB------#---tt------B--B----B----C------B#-B--ttCB#CC
-----------#---tt-------tt-#-----tt#-----------------#-----#-#tt---tt-tt-tt------#-----#tt-----tt--------------tt-##--tt-----tt----#--tt---tt----tt----#-#-##--tt-----------tt-----------tt-#----tt--#--
-----------#-tttt-------tt-#-----tt#--------#-tt-----#-----#-#tt---tt-tt-tt------#-----#tt-----tt-tt-----------tt-##--tt-----tt--#-#--tt-tttt----tt----#-#-##tttt--#--------tt--------##-tt-#----tt--#--
---------k-#gttttk-g----tt-#-g---tt#---#g---#-tt-----#-----#-#tt-g-tt-tt-ttg----g#-#g--#ttg----tt-tt------gg---tt-##ggtt---#-tt--#-#--tt-tttt#g--tt---##-#g##tttt--#gk#-----tt---g-g-###ktt-#----tt--#-F
-XXXX-XXXXXXXXXXXXXXXXXXXX-XXXXXXXXXXXXXXXXXXXXXXXX--XXXXXXXXXXXXXXXXXXXXXXXXXXXXXXXXXXXXXXXXXXXXXXXXXXXXXXXXXXXXXXXXXXX-XXXXXXXXX-X--XXXXXXXXXXXXXXX-XX-XXXXXXXXXXXXXXX-XXXXX-XXXXXXXXXXXXXXXXXXXXXXXXX
-XXXX-XXXXXXXXXXXXXXXXXXXX-XXXXXXXXXXXXXXXXXXXXXXXX--XXXXXXXXXXXXXXXXXXXXXXXXXXXXXXXXXXXXXXXXXXXXXXXXXXXXXXXXXXXXXXXXXXX-XXXXXXXXX-X--XXXXXXXXXXXXXXX-XX-XXXXXXXXXXXXXXX-XXXXX-XXXXXXXXXXXXXXXXXXXXXXXXX
