--------------------------------------------------------------------------------------------------------------------------------------------------------------------------------------------------------
--------------------------------------------------------------------------------------------------------------------------------------------------------------------------------------------------------
--------------------------------------------------------------------------------------------------------------------------------------------------------------------------------------------------------
--------------------------------------------------------------------------------------------------------------------------------------------------------------------------------------------------------
--------------------------------------------------------------------------------------------------------------------------------------------------------------------------------------------------------
-S----U--------S--SS----S--S-------SS--------S-S----------------S-S--S------U-U----------S---------S-------SS-----S--SSS---U-S---------U-S-U----------S-------------USSSSSSSSSS-SSSSSSSS--SSSS--SSSSSSSS
-------------------------------C-------C--------C--------------------------------------------------------------------------------------------C----------------------------------------------------------
--------------------------------------------------------------------------------------------------------------------------------------------------------------------------------------------------------
--------------------------------------------------------------------------------------------------------------------------------------------------------------------------------------------------------
--------------------------------------------------------------------------------------------------------------------------------------------------------------------------------------------------------
--#---C-----#----S--------U----S--#----S--------S-------S-----------U-------C-CU-U-S---#U---#U-U-----#---tt--UCU-#--S---U--C---S--U----C---C-Stt----UU--------------C-------------------tt--------------
--#---------#-------#-------------#--tt-------------tt--------------------------------##----#---#----#---tt------#----------------------#-----tt-------#--------------------------------tt--------------
--#-#-------#-------#----#--------#--tt-tt-#--#----#tt----tt--tt------#---#----------###----#---##---#tt-tt------#---------------#------#-----tttttt---#--------------------------------tt----tt--------
#g####-k-g-g#g#-g---#g-g-#-------g#g-tt-tt-#--#g-kg#tt-k-#tt--tt-k-g--#-#-#k-g--g---####-g--#---###--#tt#tt-----##-#--------ggg-k#-#kgg-#-----tttttt---#-gk-k------------------#--------tt----tt-------F
||||||%|%|%||||-|%--||%|-|%-%%%%%|||%||%||%|%-||%|||||%|%|||%%||-|-|%-|%|-||%|%%|%%%||||%|%%|%-%|||-%||||||%%%%%||%|%%%-%%%%|||%||%||||%|--%%%||||||%%-|-||%|%%%--%%%----------|--------||----||-------%
|||||||||||||||-||--||||-||-|||||||||||||||||-||||||||||||||||||-|-||-|||-||||||||||||||||||||-||||-|||||||||||||||||||-|||||||||||||||||--|||||||||||-|-|||||||--|||----------|--------||----||-------|
