--------------------------------------------------------------------------------------------------------------------------------------------------------------------------------------------------------
--------------------------------------------------------------------------------------------------------------------------------------------------------------------------------------------------------
--------------------------------------------------------------------------------------------------------------------------------------------------------------------------------------------------------
--------------------------------------------------------------------------------------------------------------------------------------------------------------------------------------------------------
--------------------------------------------------------------------------------------------------------------------------------------------------------------------------------------------------------
--BUB---B----U----U-------------------B----B---------------------BBU------U----B----UB------B--------B-------U---U-------------------------B-B------B---------------B-U-U-----UU-UUUUUUUUUUUUU-UUUUUUUUU
------------------------------------C-----C----C--------C-------------------------------------------------------------------------------------------------------C-C-------------------------------------
--------------------------------------------------------------------------------------------------------------------------------------------------------------------------------------------------------
--------------------------------------------------------------------------------------------------------------------------------------------------------------------------------------------------------
--------------------------------------------------------------------------------------------------------------------------------------------------------------------------------------------------------
tt-C-U-------Ctt--C-#---tt--------#-BB----B----B--------BCB---B----C-B---UC-B----tt-C------#-B-#B------------C--#C-tt-C---UC--UB----------C-B-tt---U------#U-UttBBBB--C-C-----CCCCCCCCCCCCCCCC-CCCCCCCCC
tt------------tt----#---tt--------##---------------tt------tt---------#----------tt-----#tt#---#-tt-------tt#---#--tt-------------------------tt---------##---tt------------#---------------------------
tt----#-----#-tt----#-tttt--------##---------------tt------tt---------##-----tt--tt---tt#tt#---#-tt----tt-tt#-#-#--tt----------------#tttt----tttt------###---tt----------#-##----------------#---------
tt----#g-g--#-ttg--g#gttttg-g----g##--g----g#g--k-gtt#g----ttg----g---###----tt--ttg--tt#tt#---#-tt-k--tt-tt#-#-#--ttk--#g--g---k-k--#tttt---gtttt-----####---tt----------#-##----------------#--------F
XX-XXXXX-X-XXXXXXXXXXXXXXXXXXXXXXXXXXXX-XXXXXXXXXXXXXXXXXXXXXXXX--XXXXXXXXXXXXX-XXXXXXXXXXXX-X-XXXXXX-XXXXXXXXXXXXXXXXXXXXXXX-XXXXXXXXXXXXX-XXXXXXXXXXXXXXXXXXXXXXXXXXXXXXX-XXXXXXXXXXXXXXXXXXXXXXXXXXXX
XX-XXXXX-X-XXXXXXXXXXXXXXXXXXXXXXXXXXXX-XXXXXXXXXXXXXXXXXXXXXXXX--XXXXXXXXXXXXX-XXXXXXXXXXXX-X-XXXXXX-XXXXXXXXXXXXXXXXXXXXXXX-XXXXXXXXXXXXX-XXXXXXXXXXXXXXXXXXXXXXXXXXXXXXX-XXXXXXXXXXXXXXXXXXXXXXXXXXXX
