--------------------------------------------------------------------------------------------------------------------------------------------------------------------------------------------------------
--------------------------------------------------------------------------------------------------------------------------------------------------------------------------------------------------------
--------------------------------------------------------------------------------------------------------------------------------------------------------------------------------------------------------
--------------------------------------------------------------------------------------------------------------------------------------------------------------------------------------------------------
--------------------------------------------------------------------------------------------------------------------------------------------------------------------------------------------------------
US----U-S-------S-S---S-----U--U-------U-----S--S---------------SS---------------------------S--UU----SS-U----S----SU---S----------------U---U----------------------------------------------------------
-------------------------C-------------------------C-------C--C---C-------------------------------------------------------------------------------------------------------------------------------------
--------------------------------------------------------------------------------------------------------------------------------------------------------------------------------------------------------
--------------------------------------------------------------------------------------------------------------------------------------------------------------------------------------------------------
--------------------------------------------------------------------------------------------------------------------------------------------------------------------------------------------------------
C-----CU---------------U-SCSCSCC-----#-C#--tt-C--#USS-#U-ttS--SS--S------------tt----U#U----#-C-CCC--S---C----------C----------SC--------C-C-C----------------------------------------------------#--#-#
--tttt------##---#-tt---------------###-#--tt--#-#---##--tt--------------------tt-----#-----#------#--------tt-tt-#---tt--#--tt-------------------------------------------------------------------#--#-#
--tttt----#-###--#-tt#-------------####-#tttt--#-#---##--tt--------------------tt-----#----##------#--------tt-tt-#--#tt--#-#tt-------------------------------------------------------------------#--#-#
--tttt----#-####-#-tt#-----------g#####-#tttt--#g#---##-gtt--#--------#k--#k-gktt-k-k-#----##g-#---#g-----##tt-ttg#g-#ttg-#-#tt--g-gg-k-----------------------------------g-----------------------#--#-F
%%||||%%-%|-||||%|-|||-%-%%%%%%%-||||||%|||||%%|||%%%||%|||%%|%%--%%%-||%%||%||||-|%|%|%%%%|||%|%%%||%%%%%||||%|||||%||||-|%|||%%|%||%|%%%%%%%%--%%%%%%%%%%%%%--%%%%%%%%%%|%%%%%%%%%-%%%%%%%%%%%%%|%%|%%
||||||||-||-||||||-|||-|-|||||||-|||||||||||||||||||||||||||||||--|||-|||||||||||-|||||||||||||||||||||||||||||||||||||||-|||||||||||||||||||||--|||||||||||||--||||||||||||||||||||-|||||||||||||||||||
