--------------------------------------------------------------------------------------------------------------------------------------------------------------------------------------------------------
--------------------------------------------------------------------------------------------------------------------------------------------------------------------------------------------------------
--------------------------------------------------------------------------------------------------------------------------------------------------------------------------------------------------------
--------------------------------------------------------------------------------------------------------------------------------------------------------------------------------------------------------
--------------------------------------------------------------------------------------------------------------------------------------------------------------------------------------------------------
---------U-BB----------B---U---B----U----BB------BB--------------B------B--BB------B---B-------BB--------B------------------------B---U----B--B------BB------BUUBU--------------------------------------
------------------------C-------------C---------------------C---------------------------------------------------------------------------C-------------------------------C-------------------------------
--------------------------------------------------------------------------------------------------------------------------------------------------------------------------------------------------------
--------------------------------------------------------------------------------------------------------------------------------------------------------------------------------------------------------
--------------------------------------------------------------------------------------------------------------------------------------------------------------------------------------------------------
---tt----CB--#-CC---#CB-BttC------U-C#B-B-----------C-------B--B----------B-----C-------Utt------------BC-CC-U----------------------#-C-BC---------U----------CC-C------B-------------------------------
---tt--#-----#-----##----tt----------#--------#--------#-----tt--------------tt---#------tt-----------------------------------------#-----#-tt-tttt------tt---------------------------------------------
#--tt#-#-----#----###----tt--tt------#--------#--------##--#-tt-----#tt------tt---#-#tt--tt-------tt-tt---------------tttt----------#-----#-tt-tttt------tttt-----------------tt------------------------
#--tt#-#-----#---####----tt--tt------#--------#kg----g-###-#-tt----g#tt#-----tt---#g#tt--tt#--k-g-tt-tt---------------ttttk-k-g-kgg-#-----#-tt-tttt-g-gg-ttttg--g-gggggg-gggggttgggggggggggggggggggggggF
XXXXXX-XXXXXXXXXXXXXXXX-XXXXXXXXXXXXXXX-X--XXXXXXX--XX-XXX-XXXXXX-XXXXXXX-X--XXXXXXXXXX-XXXXXXX-XXXX-XXXX-XX-XXXXX--XXXXXXXXXXXXXXX-X-XXXXXXXX-XXXXXXXXXXXXXXXXXXXXXXXXXXXXXXXXXXXXXXXXXXXXXXXXXXXXXXXXX
XXXXXX-XXXXXXXXXXXXXXXX-XXXXXXXXXXXXXXX-X--XXXXXXX--XX-XXX-XXXXXX-XXXXXXX-X--XXXXXXXXXX-XXXXXXX-XXXX-XXXX-XX-XXXXX--XXXXXXXXXXXXXXX-X-XXXXXXXX-XXXXXXXXXXXXXXXXXXXXXXXXXXXXXXXXXXXXXXXXXXXXXXXXXXXXXXXXX
