--------------------------------------------------------------------------------------------------------------------------------------------------------------------------------------------------------
--------------------------------------------------------------------------------------------------------------------------------------------------------------------------------------------------------
--------------------------------------------------------------------------------------------------------------------------------------------------------------------------------------------------------
--------------------------------------------------------------------------------------------------------------------------------------------------------------------------------------------------------
--------------------------------------------------------------------------------------------------------------------------------------------------------------------------------------------------------
-------S-------------US--S----S------------------------------------S-------------SUS---------------S------S---------U-------S------S-----S-----------------S---------U----------------------------------
------------------------------------------------------------------------------------------------C---C--------C---------C----------------------------------C---------------------------------------------
--------------------------------------------------------------------------------------------------------------------------------------------------------------------------------------------------------
--------------------------------------------------------------------------------------------------------------------------------------------------------------------------------------------------------
--------------------------------------------------------------------------------------------------------------------------------------------------------------------------------------------------------
---C#----C-##----U---C------U----------U------------------U-------C-tt------#-U-U-C----#--C----SSU--S---CC---S--CC-CC--S--C--#--tt-----#----S-------U---ttS--------C-C-C--------------------------------
----#tt----##----------tt-tt---#--tt----tttt------#-----------------tt------#-------tt-#----------#--tt----tt----------------#--tt#---##--tt---tt-tt----tt----#----------#---#-tttttttttt-tttttttttttttt
----#tt----##-tt-------tt-tt---#tttt-#--tttt-tt--###-------#--------tt-#----#-------tt-#----#-----#--tt----tt-tt-------------##-tt#-tt###-tt-#-tt-tt----tt----#----------#tt-#-tttttttttt-tttttttttttttt
----#tt-#-g##-tt--k-g--tt-tt-kg#ttttk#--ttttgttk#####g-k-k-#-g-g-#-gtt-##---#k------tt-#----#-----#g-tt---gtt-tt--#-----k----##-tt#-tt###-tt-#-tt-tt---ktt---g#gg-#-----k#tt-#-ttttttttttktttttttttttttF
%%%%|||%|%|||-||%%|%|%-||-||%|||||||||-%||||||||||||||%|%|%|%|%|%|%|||-||%%%||%%%-%%||%|%%%%|%%%%%||%||-%%|||%||%%|%%%%%|%%-%||%|||-|||||%||%|-||%||%%%|||%-%||||-|%%%%%||||-|%||||||||||||||||||||||||%
|||||||||||||-||||||||-||-||||||||||||-|||||||||||||||||||||||||||||||-||||||||||-|||||||||||||||||||||-|||||||||||||||||||-|||||||-||||||||||-||||||||||||-|||||-||||||||||-|||||||||||||||||||||||||||
