--------------------------------------------------------------------------------------------------------------------------------------------------------------------------------------------------------
--------------------------------------------------------------------------------------------------------------------------------------------------------------------------------------------------------
--------------------------------------------------------------------------------------------------------------------------------------------------------------------------------------------------------
--------------------------------------------------------------------------------------------------------------------------------------------------------------------------------------------------------
--------------------------------------------------------------------------------------------------------------------------------------------------------------------------------------------------------
----------U--------------B--BU-------B---B---------------B----B---B---------UB------------U---------------BBB-----------B--U-B-------B----U--------------U-B---B---BUU----------------------------------
------------------------------------------------------------------------------CC---------C----------------------------------------------------C---------------C----------C------------CC-CCCCCCCCCCCCCCC
--------------------------------------------------------------------------------------------------------------------------------------------------------------------------------------------------------
--------------------------------------------------------------------------------------------------------------------------------------------------------------------------------------------------------
--------------------------------------------------------------------------------------------------------------------------------------------------------------------------------------------------------
-BC--tttt-C-C--U--B---B------CCB----U--tt----##-----tt--C----#-tt------#----C-BB---------BC-ttC---------tt---------#-----U-C#-----#-C-----C-C-B---C---C--C----B---#-CC---BC-B---#C-#B-BBCBBBBBBBBBBBBBBB
-----tttt-------------------------#----tt-tt-##-----tt------##-tt-----##tttt----tt----------tt----------tt---------#-tt---#-#-----#----#-#------tt-----tt---------#---#----#----#--#--------------------
-----tttt-------tt-tt---#-------#-#----tt-tt-##--tt-tt#-----##-tt--#-###tttt----tt----------tt----tt----tt----tt---#-tt#--#-#----###---#-#------tt-----tt-#-tt--tt#---##---#-tt-#-##--------------------
#---#tttt-----g-tt-tt---#-gk----#-#k-gktt-tt###-#tt#tt#--g#-##gtt-g#####tttt-g--ttgk-g-g#---tt----ttk---tt--g-ttggg#gtt#--#-#g-g-###-g-#k#------tt---g-tt-#gtt-gtt#g--###--#-tt-#-##-------------------F
XXXXXXXXXXXXXXXXXXXXXXXXX-XX-XXXX-XXXXXXXXXXXXX-XXXXXXXXXXXXXXXXXXXXXXXXXXXXXXXXXXXXXXXXXXXXXXXXX-XXXXXXXX--XXXXXXXXXXXXXXXXXXXXXXXXXXXXXXXXXXXXXXXXXXXXXXXXXXXXXXXXXXXXXXXXXXXXXXXXXXXXXXXXXXXXXXXXXXXX
XXXXXXXXXXXXXXXXXXXXXXXXX-XX-XXXX-XXXXXXXXXXXXX-XXXXXXXXXXXXXXXXXXXXXXXXXXXXXXXXXXXXXXXXXXXXXXXXX-XXXXXXXX--XXXXXXXXXXXXXXXXXXXXXXXXXXXXXXXXXXXXXXXXXXXXXXXXXXXXXXXXXXXXXXXXXXXXXXXXXXXXXXXXXXXXXXXXXXXX
