--------------------------------------------------------------------------------------------------------------------------------------------------------------------------------------------------------
--------------------------------------------------------------------------------------------------------------------------------------------------------------------------------------------------------
--------------------------------------------------------------------------------------------------------------------------------------------------------------------------------------------------------
--------------------------------------------------------------------------------------------------------------------------------------------------------------------------------------------------------
--------------------------------------------------------------------------------------------------------------------------------------------------------------------------------------------------------
------------B-------------B---BB----U----B-----------BB-------U---------UB------B---B--B------U-------U-----------B-B-B--B----------B-B------U---------BB-U-----------B-----U--U---U-----U--U-----------
----C--------------------------------------------------------------------------------------------C-------------------C--C---------------------C----------C----------------------------------------------
--------------------------------------------------------------------------------------------------------------------------------------------------------------------------------------------------------
--------------------------------------------------------------------------------------------------------------------------------------------------------------------------------------------------------
--------------------------------------------------------------------------------------------------------------------------------------------------------------------------------------------------------
--C-B-----------CC#-----------------CUU---B---tt----B--#------C--B##B---C------C-----U--------CttB--C-C-C----#B------B--B-----tt-U------U----CB----------BC-U-Utt-U----#U---C--C---C-----C--C-----------
-------------tt---#---------##----tt-------tt-tt---#---#----------##--tt---------------------#-tt-----------##---#--------tt#-tt---------------tt----tt--------tt------#-tt-----------------------------
-------------tt---#-----tt--##----tt-------tt-tt---#---#--------#-##--tt---#tt---tt-------##-#-tt--------tt###--##--------tt#-tt---------tt----tt#tt#tt--------tt----#-#-tt-----------------------------
-g---g-g-----tt---#g-k-ktt-g##-gg-tt---g---tt-ttg--#---#k-k-g---#-##--tt-gg#tt#-gtt#--g-g###-#-tt-k------tt###-###--g--#--tt#-tt--gkg#-g-tt----tt#tt#tt--------ttg-#-#-#-tt----------------------------F
XXXXXXXXXXXXXXXXXXXXXXXXXX-XXXXXXXXXXXXXX-XXXXXXXXXXX--XXXXXXXXXXXXXXXXXXXXXXXXXXXXXXXX-XXXX-XXXXXXXXXXXXXXXXXXXXX-XXX-XX-XXXXXXXXXXXX-XXXXXXXXXXXXXXXXXXXXXX-XXXXXX-X-XXXXXXXXXXXXXXXXXXXXXXXXXXXXXXXXX
XXXXXXXXXXXXXXXXXXXXXXXXXX-XXXXXXXXXXXXXX-XXXXXXXXXXX--XXXXXXXXXXXXXXXXXXXXXXXXXXXXXXXX-XXXX-XXXXXXXXXXXXXXXXXXXXX-XXX-XX-XXXXXXXXXXXX-XXXXXXXXXXXXXXXXXXXXXX-XXXXXX-X-XXXXXXXXXXXXXXXXXXXXXXXXXXXXXXXXX
