--------------------------------------------------------------------------------------------------------------------------------------------------------------------------------------------------------
--------------------------------------------------------------------------------------------------------------------------------------------------------------------------------------------------------
--------------------------------------------------------------------------------------------------------------------------------------------------------------------------------------------------------
--------------------------------------------------------------------------------------------------------------------------------------------------------------------------------------------------------
--------------------------------------------------------------------------------------------------------------------------------------------------------------------------------------------------------
-----S----SS------------U--S----------S--S--------S----S-----------------------S-------S--U---S--------------------------------------------SS-----------SU------------------------------------U---U-----
----------------C-------------------------------------------------------------------------------------------------------------------------------------------C-C-----------------------------------------
--------------------------------------------------------------------------------------------------------------------------------------------------------------------------------------------------------
--------------------------------------------------------------------------------------------------------------------------------------------------------------------------------------------------------
--------------------------------------------------------------------------------------------------------------------------------------------------------------------------------------------------------
U-#------C--SC--SS------C---S----------------S---U-----------#Utt-#U--------#-------C-C-C-C--------------U##---------#-----#----C------------U--------tt-C-SSSSS---S-S-S-S-SSUS-SSSSS-SSSSSSSSCSCSCSSSSS
--#----------------------------#-------tt--tt-tt---------#---#-tt-#----#--tt#-----tt---------------tt-----##--#-----##-----#-#---tt-----#tt------tt---tt------------------------------------------------
--#tt-tt#-----#---#--tt------#-##------tt-#tt-tt-----##--##--#-tt-#----#--tt#tt---tt-----#---------tt-----##--#----###tt--##-#---tttt-tt#tt-----#tt---tt------------------------------------------------
-g#tt-tt#-g---#---#--tt--k-g-#-##-g---gtt-#tt-tt---#-##-g###-#-tt##--g###-tt#ttg-#tt-----#---#-k-g-tt-k-k-##--#g-g####ttg-##g#---tttt-tt#tt----g#tt#--tt--k-----kkk-k-k-k-k----k-----------------------F
%||||-|||%|%%%|%%%|%%||%%|%|%|-||%|%%%|||-|||%||%%%|-||%||||%|%||||%%||||%||||||%|||%%%-%|%%%|%|%|%||%|%|%||%%||%||||||||%||||-%%||||%|||||%%%%|||||%-||%%|%%%%%|||%|%|%|%|%%%%|%%%%%%%%%%%%%%%%%%%%%%%%
|||||-||||||||||||||||||||||||-||||||||||-||||||||||-||||||||||||||||||||||||||||||||||-||||||||||||||||||||||||||||||||||||||-||||||||||||||||||||||-||||||||||||||||||||||||||||||||||||||||||||||||||
