--------------------------------------------------------------------------------------------------------------------------------------------------------------------------------------------------------
--------------------------------------------------------------------------------------------------------------------------------------------------------------------------------------------------------
--------------------------------------------------------------------------------------------------------------------------------------------------------------------------------------------------------
--------------------------------------------------------------------------------------------------------------------------------------------------------------------------------------------------------
--------------------------------------------------------------------------------------------------------------------------------------------------------------------------------------------------------
-SSS---S--S--S---------U---------U--SSS--------SS-----S-----U--S--S--U---SU-----------------S--S--S------S------S---SS------S--S------------S----------------SS-----------------------------------------
----CCC----------------------------------------------------C--------------------------------------------------------------------C---------C---C---------------------------------------------------------
--------------------------------------------------------------------------------------------------------------------------------------------------------------------------------------------------------
--------------------------------------------------------------------------------------------------------------------------------------------------------------------------------------------------------
--------------------------------------------------------------------------------------------------------------------------------------------------------------------------------------------------------
S---SSS----U#-tt-USU---C#--------C-S-----------------------SC------C-C-CS-C---------------#-------------U------S--U--------C----S-------ttS---S-------tt-#------tt#-------------------------------------
------------#-tt--------#-----#---------------------------------tt----------#-tt---#-tt--###----------##----tt--------tt----------------tt-#---#------tt-#-#----tt#---------------tt--------------------
------------#-tt-----tt-#--#--##-------------------------#------tt----------#-tt-tt#-tt-####--------#-##--#-tt---#----tt-#--------------tt-#---#------tt-#-#----tt#---------------tt--------------------
------------#-tt-----tt-##-#--###------k-g-k-gg-g----kg--#g---ggtt---------##-ttgtt#gtt#####-#g----g#-##-g#gtt---#---gttg#---g-----#---gtt-#g--#g-g---ttg#-#g--gtt#g--------------tt-------------------F
%%%%%%%%%%-%|-||%%%%%||%||-|%%|||%%%--%|%|%|%||-|%-%%||%%||%%%||||-%%%%%%%%||%||||||||||||||%||%%%-||-||%|||||%%%|%%-|||||%%%|%-%-%|%-%|||%||%%||%|%%%||||%||%-|||||%%%%%%%%%%%%%%||%%%%%%%%%%%%%%%%%%%%
||||||||||-||-||||||||||||-|||||||||--|||||||||-||-|||||||||||||||-|||||||||||||||||||||||||||||||-||-||||||||||||||-||||||||||-|-|||-||||||||||||||||||||||||-|||||||||||||||||||||||||||||||||||||||||
