--------------------------------------------------------------------------------------------------------------------------------------------------------------------------------------------------------
--------------------------------------------------------------------------------------------------------------------------------------------------------------------------------------------------------
--------------------------------------------------------------------------------------------------------------------------------------------------------------------------------------------------------
--------------------------------------------------------------------------------------------------------------------------------------------------------------------------------------------------------
--------------------------------------------------------------------------------------------------------------------------------------------------------------------------------------------------------
S-SSU------------U---S----S----S--------U--------------U-------S----------S---S-----------------SS-------S--S----U----S----S-S-S------------------US-----------------U----------------------------------
------------C-------------------C-------------C---C-----------C---------------------------C-C--------C-----------------------------C--------------------------------------------------------------------
--------------------------------------------------------------------------------------------------------------------------------------------------------------------------------------------------------
--------------------------------------------------------------------------------------------------------------------------------------------------------------------------------------------------------
--------------------------------------------------------------------------------------------------------------------------------------------------------------------------------------------------------
-S--CCSS----S--#-C--------------S---U---C---S#S#C-S----C----USS----#-CC-#---#--S-U------C-S-S#tt-----S-----S-----Ctt---C----S-S----Stt------tt----C-tt-------------C-C-C--------------------------tt----
-----------#---#---------#-------tt------##--#-#-#-#--------------##----#---#---#------#-----#tt-------------#tt--tt------#-----#---tt-tt---tt------tt--------------------------------------------tt----
-----------#-tt#-------#-#-tt#---tt------##--#-#-#-##------------###----#---#---#------#-----#tt-------------#tt#-tttt--#-#-----#---tt-tt#--tt#-----tt--------------------------------------------tt----
-----------#-tt#k-g-kg##-#-tt#-g-ttg-gg--##--#-#-#-####-k------g####----#---##g-#-k-g-g#-----#tt--#---k-k----#tt#-tttt--#-#----g#g--tt-tt#g-tt#----gtt--------k---g----------------------g--------tt---F
%%--%%%%%%-|%||||%|%||||-|%|||%|%|||%||%%||-%|%|%|%||||%|%%-%%%|||||%%%%|%%%|||%|%|%|%||%%%%%|||%%|%%%|%|-%%-||||%||||%%|%|-%-%|||%%||-||||-|||%%-%|||%%%%--%%|%%%|%%%%%%-%%%%%%%%%%%%%%%|%%%%%%%%||%%%%
||--||||||-|||||||||||||-||||||||||||||||||-|||||||||||||||-|||||||||||||||||||||||||||||||||||||||||||||-||-||||||||||||||-|-||||||||-||||-|||||-||||||||--|||||||||||||-||||||||||||||||||||||||||||||
