--------------------------------------------------------------------------------------------------------------------------------------------------------------------------------------------------------
--------------------------------------------------------------------------------------------------------------------------------------------------------------------------------------------------------
--------------------------------------------------------------------------------------------------------------------------------------------------------------------------------------------------------
--------------------------------------------------------------------------------------------------------------------------------------------------------------------------------------------------------
--------------------------------------------------------------------------------------------------------------------------------------------------------------------------------------------------------
U----S--------S--S--S---S--------U-----S--------------------------------SS-US--------------UU-S---S-----S---------S---S-S---------------------S-----SS---S--U---------------SS-SS-S---------------------
----------------------C-----------------------------C---------------C-C-------C-------------------------------------------------------------------------C--------------------------------------CCCCCCCCC
--------------------------------------------------------------------------------------------------------------------------------------------------------------------------------------------------------
--------------------------------------------------------------------------------------------------------------------------------------------------------------------------------------------------------
--------------------------------------------------------------------------------------------------------------------------------------------------------------------------------------------------------
CUU----------C-U--C--CS-------S-CC------------U---U-S-Utt--##-------SSSS---C--SC-tt----#--#CC--#C---S#-----SSC---S-----S-CC-ttUCtt---------SS----#----S-S--UC---tt----tt------S--U-UUUUUUUUUUUUSSSSSSSSS
----#----tt--------#---#---#-------------tt-tt---------tt--##--------------------tt----#--#----#-----#----------------------tt--tt------tt-------#--------------tt----tt--------------------------------
----#----tttt------#---#--###------------tt-tt---------tt--##-----tt-------------tt----#--#----#-----#tt--#----tt---tt------tt--tt------tt-----tt#--------------tt----tt--------------------------------
---g#-g-gtttt-g-#--#g--#-#####-g--#k-k#--tt#tt---k-----tt#-##k-g--tt--------gg---ttg---#--#--g-#-g---#ttg-#----tt-ggtt------tt--tt--k-k-tt-----tt##-gg-g--g--g-ktt---ktt-k-----------------------------F
%%%||%|%|||||%|%|-%||%%|%|||||%|%%||%||%%|||||%%-|%%%%%|||%|||%|%%||%%%%%%%%||%%%|||%%%|%%|%%|%|%|%%%||||%|%%%%||%||||%%%%%%||%%||%%|%|%||%%%--||||%||%|%%|%%|%|||%%%|||%|%%-%%--%%%%%%%%%%%%%%%%%%%%%%%
|||||||||||||||||-||||||||||||||||||||||||||||||-||||||||||||||||||||||||||||||||||||||||||||||||||||||||||||||||||||||||||||||||||||||||||||--|||||||||||||||||||||||||||||-||--|||||||||||||||||||||||
