--------------------------------------------------------------------------------------------------------------------------------------------------------------------------------------------------------
--------------------------------------------------------------------------------------------------------------------------------------------------------------------------------------------------------
--------------------------------------------------------------------------------------------------------------------------------------------------------------------------------------------------------
--------------------------------------------------------------------------------------------------------------------------------------------------------------------------------------------------------
--------------------------------------------------------------------------------------------------------------------------------------------------------------------------------------------------------
--U-------U------------U---S-S-----------------S-SS------------------------S--US------U-S--SU--------U------SSS-S-S--------------------SS--U--S---------------U--S-----------------------S--------------
C---------------------------------------------C----------------------------------------------------------C------------------------------------------C---------------------------------------------------
--------------------------------------------------------------------------------------------------------------------------------------------------------------------------------------------------------
--------------------------------------------------------------------------------------------------------------------------------------------------------------------------------------------------------
--------------------------------------------------------------------------------------------------------------------------------------------------------------------------------------------------------
S-CU----##CSttS---U-U--C------#----C----CSS---S---------U----U---------C------C-------C#--C-C--S-S-C-C-C-S-------------USUtt-------#-----ttC----#-U-SttCCtt-USCSC---------------------------------------
-----#--##--tt--#-------------#--------#--------------------------------tt-------------#----------------#-----------tt----tt--#---##-----tt-----#----tt--tt---------------------------------------------
-----#--##--tt--#----tt--tt---#tt----tt#----#---#-----##--------------#-tt--#---#------#------#---------#------#----tt----tt#-##-###-----tt-----#----tt--tt-------##------------------------------------
-----##-##--tt-g#k-#-tt-gtt-#-#tt##-gtt#----#--g#-----##-g-kg--#-g----#-tt--#---#k-k-g-#-g----#-#-#-----#---ggg#ggg-tt----tt#-######kg---tt----k#----tt--tt-------###-----g--k------g----g-------------F
%%%%-||%||%%||%|||%|%||%|||%|%|||||%||||%%%%|%%||-%%%%||%|%||%%|%|%%%%|%||%%|%%-||%|%|%|-|%-%%|%|%|%%%%%|%-%|||||||%||%%%%|||-||||||||-%%||%%%%||%%-%||%%||-%%%%%-|||%%-%%|%%|%%%%%%|%%%%|%%%%%%%%%%%%%%
||||-||||||||||||||||||||||||||||||||||||||||||||-|||||||||||||||||||||||||||||-||||||||-||-||||||||||||||-||||||||||||||||||-||||||||-||||||||||||-|||||||-|||||-|||||-||||||||||||||||||||||||||||||||
