--------------------------------------------------------------------------------------------------------------------------------------------------------------------------------------------------------
--------------------------------------------------------------------------------------------------------------------------------------------------------------------------------------------------------
--------------------------------------------------------------------------------------------------------------------------------------------------------------------------------------------------------
--------------------------------------------------------------------------------------------------------------------------------------------------------------------------------------------------------
--------------------------------------------------------------------------------------------------------------------------------------------------------------------------------------------------------
-U-------S--S----U--S----U-------S-------SS------------SS-----SS--U-----S---------S--------------S---------US-------------------US-S----------S---S-----S-S-SSSS-SSS--S-SSSSS-SSSS-SSSSSSSSSSSSSSSSSSSSS
----------C------------------------------------C-----------C-----C-----------------------------------C--------------------------------------------------------------------------------------------------
--------------------------------------------------------------------------------------------------------------------------------------------------------------------------------------------------------
--------------------------------------------------------------------------------------------------------------------------------------------------------------------------------------------------------
--------------------------------------------------------------------------------------------------------------------------------------------------------------------------------------------------------
-C-C---C--S--#-C-C-C---ttC--------tt--##S--C-ttS------S----S-----SCS-------------#-U--------tt-----SSS-----C-CS----------U--#-CCC---#--C--tt-U-------------U--------##----------------------------------
-------------#---------tt-tt------tttt##-----tt-----#----------------#----------##---------#tt-tt-----#---#-----------#tt-tt#-------##----tt--------------------#---##----------------------------------
-------------#-------tttt-tt-tt---tttt##-----tt-----#----------------##--------###----#--#-#tt-tt-----#--##-----------#tt-tt#-------##--tttt----tt--------------#---##----------------------------------
----g#-------#g------tttt-tt-tt-ggtttt##----gtt----g#-----g-#-g-g----###-gg-k-k###--#-#g-#-#tt-tt-g---#-###-----------#tt-tt#-------##--ttttg-gkttgk-g-g-g------#---##---------------------------------F
%%-%||%%%-%--||%%%%%-||||%||%||%||||||||%%%%|||%%%%||%%--%|%|%|%|%%%%|||-||%|%||||-%|-||%|-|||-||-|%%%|-|||%%%%%%%--%%|||%|||%%%%%%%||-%|||||%||||||%|%|-|-%----|---||-------%-------------------------%
||-||||||-|--|||||||-||||||||||||||||||||||||||||||||||--|||||||||||||||-|||||||||-||-||||-|||-||-|||||-||||||||||--||||||||||||||||||-|||||||||||||||||-|-|----|---||-------|-------------------------|
