--------------------------------------------------------------------------------------------------------------------------------------------------------------------------------------------------------
--------------------------------------------------------------------------------------------------------------------------------------------------------------------------------------------------------
--------------------------------------------------------------------------------------------------------------------------------------------------------------------------------------------------------
--------------------------------------------------------------------------------------------------------------------------------------------------------------------------------------------------------
--------------------------------------------------------------------------------------------------------------------------------------------------------------------------------------------------------
---------U---U-------------S----U-S--------SU-------------------S------SS--S--U------------S-S----SU-SS-----------S------S----SS-----------S-----S--S-------S-SS---------U------------------------------
-------------------------------------------------------------------C-----C---------------C---------------------------------------C---------------------------------------------------C------------------
--------------------------------------------------------------------------------------------------------------------------------------------------------------------------------------------------------
--------------------------------------------------------------------------------------------------------------------------------------------------------------------------------------------------------
--------------------------------------------------------------------------------------------------------------------------------------------------------------------------------------------------------
-U------#CS-#CU-tt--U-U--U------CC-------tt-Ctttt---#------------UCS--U--SC-S-CUC--------S------tt-CS--UUU#-tt-----S-------C-----S------------#-U---------tt----U---tt-C-C-Ctt-------S------------------
--------#---#---tt-----tt----------------tt--tttt--##--tt---------------------------------------tt--------#-tt--tt---tt-#-#-tt--------#-------#-----------tt------tttt------tt--------------------------
--tt--tt#---#---tt-#---tt----------tt----tt--tttt-###--tt-------------------------tt------------tt--------#-tttttt---tt-#-#-tt------#-#-------#-----------tt------tttt------tt--------------------------
g-tt-gtt#--k#---ttg#---tt----gg----tt-k-ktt--tttt####--ttg-k---------g-------#---ktt-g--g-k-----tt--------#-tttttt--gttg#-#-tt-g--#-#-#-kkk-g-#g-gk----gg-tt-g---gtttt#-----ttggggg-g-gggggggggggggggggF
|%||%||||%%||%%%||||%-%||%--%||%%%-||%|%|||-%||||||||%%|||%|%%%%-%%%-|%%-%%%%|%%%|||%|%%|%|-%-%%||%%%%%%%%|%||||||-%|||||-|%||%|-%|-|-|%|||-|%||%||%-%%||%||%|%-%||||||%%%%%|||||||%|%|||||||||||||||||%
|||||||||||||||||||||-||||--||||||-||||||||-||||||||||||||||||||-|||-|||-||||||||||||||||||-|-||||||||||||||||||||-||||||-||||||-||-|-|||||-||||||||-||||||||||-||||||||||||||||||||||||||||||||||||||||
