--------------------------------------------------------------------------------------------------------------------------------------------------------------------------------------------------------
--------------------------------------------------------------------------------------------------------------------------------------------------------------------------------------------------------
--------------------------------------------------------------------------------------------------------------------------------------------------------------------------------------------------------
--------------------------------------------------------------------------------------------------------------------------------------------------------------------------------------------------------
--------------------------------------------------------------------------------------------------------------------------------------------------------------------------------------------------------
------------------S----U----------SS---S---------SS----------U-U----S------U--S------UU-U----S------------SU----U-----------------------U---------------U--------------------S-SSSSSSSSSSSSSSSSSSSSSSSSS
-----------------------------------------------C------C--------------------------------C--------C------------------------------------C-----------------C---C---C----------------------------------------
--------------------------------------------------------------------------------------------------------------------------------------------------------------------------------------------------------
--------------------------------------------------------------------------------------------------------------------------------------------------------------------------------------------------------
--------------------------------------------------------------------------------------------------------------------------------------------------------------------------------------------------------
-Utt--tt---C----tt-----C---tt--tt---S---------#SS-----S------C-C---#-#--##-C-C------CCCSC#--U---S-#--------C-tt-C--C--tt--S-----U-tt-S--C------#-------SC--S-#-S---------S------------------------------
--tt--tt-tt-----tt---------tt--tt-----------#-#--------#--#--------#-#--##--#------------#--------#tt--tt----tt------#tt#--##-----tt------#---##tttt---------#-------------tt---------------------------
--tt--tt-tt---#-tt-------tttttttt---------#-#-#--------#tt#------tt#-#-###--#------------##-------#tt--tt----tt------#tt#--##-----tt--tt--##-###tttttt---tt--#------------#tt---------------------------
k-ttg-tt-tt-g-#gtt-------tttttttt-----g-#-#-#-#-----gg-#tt#gg----tt#g#-###g-#--g-k-k-----##g------#tt-gttkg-gttk----k#tt##-##-g--gttk-tt--######tttttt---tt-##g--#k-g---k-#ttg-g-ggggggggggggggggggggggF
|%|||-||%||%|%||||-%%-%%%||||||||%%-%%|-|-|-|-|%%%%%||%||||||%%%%|||||%||||%|%-|%|%|%%%%%|||%-%%%%|||%|||||%||||%%%%||||||%||%|%%||||%||%-||||||||||||-%%||%|||%%||%|%%%|%||||%|-||||||||||||||||||||||%
|||||-||||||||||||-||-|||||||||||||-|||-|-|-|-||||||||||||||||||||||||||||||||-||||||||||||||-|||||||||||||||||||||||||||||||||||||||||||-||||||||||||-|||||||||||||||||||||||||-|||||||||||||||||||||||
