--------------------------------------------------------------------------------------------------------------------------------------------------------------------------------------------------------
--------------------------------------------------------------------------------------------------------------------------------------------------------------------------------------------------------
--------------------------------------------------------------------------------------------------------------------------------------------------------------------------------------------------------
--------------------------------------------------------------------------------------------------------------------------------------------------------------------------------------------------------
--------------------------------------------------------------------------------------------------------------------------------------------------------------------------------------------------------
-----------U-U--U------------S--------------S-SS-S---U---------------------U-U---S-U---S------U---SS----------------U-----------------U------S-----SU-----------------S---------------------------------
--------------------------------------C---------------------------------------C------------------------------------------------------------C------C-----------------------------------------------------
--------------------------------------------------------------------------------------------------------------------------------------------------------------------------------------------------------
--------------------------------------------------------------------------------------------------------------------------------------------------------------------------------------------------------
--------------------------------------------------------------------------------------------------------------------------------------------------------------------------------------------------------
UU------#UUC-C--C------C--------------S---U#--------SC-------------#--#S#-#CSCS-C-UC----tt--ttC-----U----------UC--#CS--US--#---Stt--UCCU--S---UC-S-CU-----#--------tt-----------C------#-U-------------
-------##---------------tttt#--------------#-#-----------#---------#--#-#-#-------------tt--tt----------#----#----##---#----#----tt-------#----------------#-tt-----tt------------------#---------------
---tt-###-----#---------tttt#----#--tt-----#-#--#-tt-----##--#-----#--#-#-#---------#---tt--tt--tt----#-#----#----##---#--tt#tt--tttt-----#----------------#-tt--tt-tt-tt---------------#---------------
--gtt####---#-#--k-k-gg-tttt#g-#-#--tt-k-g-#-#-g#-tt-----###-#-#---#--#-#-#------g--#-g-ttkktt--tt---g#-#gg-g##--k##---#--tt#ttk-tttt----g#---g--------g---##tt-#ttgtt-ttggg------------#--------------F
%%|||||||%%%|%|%%|%|%||%||||||-|-|%%||%|%|%|-|-||%||%%-%%|||%|%|%%%|%%|%|%|%%%%-%|%%|%|-||||||%%||%%%||-|||%|||%%|||%%%|%%||||||%||||%%%%||%%-|%%%%-%%%|%%%||||%||||||%|||||%%%%%%%%%%%%|%%%%%%%%%%%%%%%
||||||||||||||||||||||||||||||-|-|||||||||||-|-|||||||-||||||||||||||||||||||||-|||||||-|||||||||||||||-|||||||||||||||||||||||||||||||||||||-|||||-||||||||||||||||||||||||||||||||||||||||||||||||||||
