--------------------------------------------------------------------------------------------------------------------------------------------------------------------------------------------------------
--------------------------------------------------------------------------------------------------------------------------------------------------------------------------------------------------------
--------------------------------------------------------------------------------------------------------------------------------------------------------------------------------------------------------
--------------------------------------------------------------------------------------------------------------------------------------------------------------------------------------------------------
--------------------------------------------------------------------------------------------------------------------------------------------------------------------------------------------------------
----U----------------B-BB----------------B-B------------B------U-B--B--BB---------B--------------------U-------------------------U---------------B---------------------------U--UUUUUUUUUUUUU-UUUUUUUUU-
--------------C-------------------------------C---------------------------------------------------------C---------------------------------------------------CCCCC-C-C--CCCCCC-CC------------------------
--------------------------------------------------------------------------------------------------------------------------------------------------------------------------------------------------------
--------------------------------------------------------------------------------------------------------------------------------------------------------------------------------------------------------
--------------------------------------------------------------------------------------------------------------------------------------------------------------------------------------------------------
--ttC---------B-------B-----------B---#---C-ttBUU------B-------CU-----B--U-----#---#ttU-------tt---B##-CB--tt-U---U-tt------#--#BC#-------#tt-B-C-#--#------BBBBBBBBBttBBBBBBCBBCCCCCCCCCCCCCBCCCCCCCCC-
--tt-------#--------------------------#-#---tt-----------------------------tt--#---#tt-tt-----tt----##---tttt-------tt-----##--#--#---tttt#tt-----#--#---------------tt---------------------------------
--tt-----#-#tt------#-----------------#-#---tt---tt------------------#-----tttt#tt-#tt-tt-----tt----##---tttt---tt--tt-tt-###--#--#---tttt#tt-----#--#---------------tt---------------------------------
g-tt---#-#-#tt-#gk--#-----g--------gg-#-#---tt---tt--k---k-k-----g-g-#-----tttt#tt-#tt-tt--k-#ttg---##---tttt---tt-gttgtt#######--#k-gtttt#ttg-g--####g-g-k----------tt--------------------------------F
XXXXXXXX-X-XXXXXXXXXXXX--XXXXX--XXXXXXXXX-X-XXXXXXXXXXXXXXXXXXXXXXXXXXXXXXXXXXXXXX-XXXXXXXXXXXXXXXXXXXXXXXXXX-XXXXXXXXXXXXXXXXXXXXXXXXXXXXXXXXXXX-XXXXXXXXXXXXXXXXXXXXXXXXXXXXXXXXXXXXXXXXXXXXXXXXXXXXXX
XXXXXXXX-X-XXXXXXXXXXXX--XXXXX--XXXXXXXXX-X-XXXXXXXXXXXXXXXXXXXXXXXXXXXXXXXXXXXXXX-XXXXXXXXXXXXXXXXXXXXXXXXXX-XXXXXXXXXXXXXXXXXXXXXXXXXXXXXXXXXXX-XXXXXXXXXXXXXXXXXXXXXXXXXXXXXXXXXXXXXXXXXXXXXXXXXXXXXX
