--------------------------------------------------------------------------------------------------------------------------------------------------------------------------------------------------------
--------------------------------------------------------------------------------------------------------------------------------------------------------------------------------------------------------
--------------------------------------------------------------------------------------------------------------------------------------------------------------------------------------------------------
--------------------------------------------------------------------------------------------------------------------------------------------------------------------------------------------------------
--------------------------------------------------------------------------------------------------------------------------------------------------------------------------------------------------------
-U----B-------------------U---------------B------B---------------------------------------BBB----------U------U------------------------B----U------------------------U-BBB-----U-------------------------
----------------------------------------------------------C------------------------C---C----------------------------------------------------C---------C-------------------------------------------------
--------------------------------------------------------------------------------------------------------------------------------------------------------------------------------------------------------
--------------------------------------------------------------------------------------------------------------------------------------------------------------------------------------------------------
--------------------------------------------------------------------------------------------------------------------------------------------------------------------------------------------------------
-C-U---U---------------C--C--------------C-tt#----B--C----B---C--C-U---BB--------#CB--CB------C--tt-ttC--U#--C------tt--C------------------CB-------B-B--ttB-B-UC-#-CB--------C-------------------------
-------------------------------------------tt#-tt-----tt------------------------##--#----------#-tt-tt----#-----tt--tt-------#--#-#----tt----------------tt-------#--------------#----------------------
---------#------------#------------#-tt----tt#-tt-----tt#--------------------tt###--#----------#-tt-tt----##---#tt--tt---#--###-#-##---tt---------tt-----tt-------#------------tt#tttttttttttttttttttttt
----gk--g#gkk-g---g-#-#----g-k-k#--#-tt---gtt#ktt---k-tt#--k--------ggk------tt###--#k--kggg#g-#ktt-tt-gg-##---#tt-#ttgk-#g####-#-###g-tt-k----g-gtt-#--#tt---g--g#-----g--gg--tt#tttttttttttttttttttttF
XXXXXXXXXXXXXXXXXXXXX-XXX-XXXXXXXXXXXXXXXXXXXXXXXXXXXXXXXXXX-XXX-XXXXXXXXXXXXXXXXXXXXXXXXXXXXXXXXXXXXXXXXXXXXXXXXXXXXXXXXXXXXXX-XXXXXXXXXXXXXXXXXXXXXXXXXXXXXXXXXXX-XXXXX-XXX-XXXXXXXXXXXXXXXXXXXXXXXXXX
XXXXXXXXXXXXXXXXXXXXX-XXX-XXXXXXXXXXXXXXXXXXXXXXXXXXXXXXXXXX-XXX-XXXXXXXXXXXXXXXXXXXXXXXXXXXXXXXXXXXXXXXXXXXXXXXXXXXXXXXXXXXXXX-XXXXXXXXXXXXXXXXXXXXXXXXXXXXXXXXXXX-XXXXX-XXX-XXXXXXXXXXXXXXXXXXXXXXXXXX
