--------------------------------------------------------------------------------------------------------------------------------------------------------------------------------------------------------
--------------------------------------------------------------------------------------------------------------------------------------------------------------------------------------------------------
--------------------------------------------------------------------------------------------------------------------------------------------------------------------------------------------------------
--------------------------------------------------------------------------------------------------------------------------------------------------------------------------------------------------------
--------------------------------------------------------------------------------------------------------------------------------------------------------------------------------------------------------
-BB-U-----B---B--U------U----B-----BB---U--------------------U---B------------------U-----------BB---------U------BB-B----U-------------BB------B-B-U---------------------------------------------------
-----------------------C-------C-C--------C----------------------------C--------------------------------------CC----C-----------------------------------------------------------------------------------
--------------------------------------------------------------------------------------------------------------------------------------------------------------------------------------------------------
--------------------------------------------------------------------------------------------------------------------------------------------------------------------------------------------------------
--------------------------------------------------------------------------------------------------------------------------------------------------------------------------------------------------------
----C--tt--B-----C-----BC-----BBBBB--C--C-Btt--C---#---tt----C---------B----C-------Ctt----B---B-----U---ttC--BB-U--B---C-C-C---------------U--#----C--------------------#------------------------------
-------tt---tt----#--------------------#-#-tttt---##tt-tt------------tt--------------tt------------------tt-------------------------tttt---#---#-----tt--#-------tt------#-----------#------------------
#------tt---tt----##-----#tt-----------#-#-tttt-####tt-tttt----------tt--------------tt--tt--------tt-tt-tt-#------------------tt-tttttt---#---#-----tt-###-#--##tt#######-#########-###################
#ggg---tt#--tt-gg-##--#--#tt-g--------k#-#-tttt-####tt-tttt-#--g----#tt-g-gg-k-k-g-k-tt--tt--g----ktt-tt#tt-#-----gg----------gttkttttttg--#--g#-k---tt#######-##tt#######-#########-##################F
XXXXXXXXXXXXXX-XXXXXXXXXXXXXXXXXXXXXXXXXXXXXXXXXXXXXXXXXXXXXXXXXX-X-XXXXXXXXXXXXXXXXXXXX-XXXXX-X--XXXXXXXXXXXXXXXXXXX-XXXXXXXXXXXXXXXXXXXXXXXXXX-XXXXXXXXXXXXX-XXXXXXXXXXXXXXXXXXXXX-XXXXXXXXXXXXXXXXXXX
XXXXXXXXXXXXXX-XXXXXXXXXXXXXXXXXXXXXXXXXXXXXXXXXXXXXXXXXXXXXXXXXX-X-XXXXXXXXXXXXXXXXXXXX-XXXXX-X--XXXXXXXXXXXXXXXXXXX-XXXXXXXXXXXXXXXXXXXXXXXXXX-XXXXXXXXXXXXX-XXXXXXXXXXXXXXXXXXXXX-XXXXXXXXXXXXXXXXXXX
