--------------------------------------------------------------------------------------------------------------------------------------------------------------------------------------------------------
--------------------------------------------------------------------------------------------------------------------------------------------------------------------------------------------------------
--------------------------------------------------------------------------------------------------------------------------------------------------------------------------------------------------------
--------------------------------------------------------------------------------------------------------------------------------------------------------------------------------------------------------
--------------------------------------------------------------------------------------------------------------------------------------------------------------------------------------------------------
----U------------B---B-------------B----B-U--------------B----BB----B-----------B------------B-B--U----------B---B-----B--U-B----------BB-B--BB---------------------------------------------------------
------------------------------------------------------------------------------C--------C--C---------------------------C-------------C----------C--------------------------------------------------------
--------------------------------------------------------------------------------------------------------------------------------------------------------------------------------------------------------
--------------------------------------------------------------------------------------------------------------------------------------------------------------------------------------------------------
--------------------------------------------------------------------------------------------------------------------------------------------------------------------------------------------------------
Btt-C------tt-----------BC----------------CC---Utt---------U-B--------------ttB---#B---BC-B-----CBCBC-----------#----#B-ttC---tt#---B------#B--B-Btt------------C---------------------------------------
-tt---tt--#tt-------------tt--------------------tt----------------#---------tt----#-tt--------------------#-----#---##--tt----tt#-#--------#------tt----------------------------------------------------
-tt---tt--#tttttt-#---tt--tt#--------tt---------tt--------------#-#---------tt----#-tt---#--#-------------##--tt#--###--tt----tt#-#--------#------tt-----------------------------------------#----------
-ttg-#ttk##tttttt-#-#gtt--tt#gk-kg--gttgg---g---tt###---kgg-g---#-#-gkg-g---tt----#-ttg--#-g#--g-----g-k-g###-tt#g####-gtt-#--tt#g#k-g-g-k-#----#-tt---------------------------------------#-#---------F
XXXXXXXXXXXXXXXXX-X-XXXXXXXXXXXXXXX-XXXXXXXXXXXXXXXXXX-XXXXXXX--X-XXXXXXXXXXXXXX-XXXXXXXXXXXXXXXXXXXXXXXXXXXXXXXXXXXXXXXXXXX-XXXXXXXXXXXXX-XXXXXXXXX--XX--X-----X-----X-X------------------X-X----------
XXXXXXXXXXXXXXXXX-X-XXXXXXXXXXXXXXX-XXXXXXXXXXXXXXXXXX-XXXXXXX--X-XXXXXXXXXXXXXX-XXXXXXXXXXXXXXXXXXXXXXXXXXXXXXXXXXXXXXXXXXX-XXXXXXXXXXXXX-XXXXXXXXX--XX--X-----X-----X-X------------------X-X----------
