--------------------------------------------------------------------------------------------------------------------------------------------------------------------------------------------------------
--------------------------------------------------------------------------------------------------------------------------------------------------------------------------------------------------------
--------------------------------------------------------------------------------------------------------------------------------------------------------------------------------------------------------
--------------------------------------------------------------------------------------------------------------------------------------------------------------------------------------------------------
--------------------------------------------------------------------------------------------------------------------------------------------------------------------------------------------------------
--------------B-----U---U-------------------B--B-BB-U---BBBB---------------B--------B-B--------------U-----------B----------U-B------------------B---------B------BB------------------------------------
-----------------------C-----------C---------C-------C----------------------C-------------------------------------------------------------------C-------------------------------------------------------
--------------------------------------------------------------------------------------------------------------------------------------------------------------------------------------------------------
--------------------------------------------------------------------------------------------------------------------------------------------------------------------------------------------------------
--------------------------------------------------------------------------------------------------------------------------------------------------------------------------------------------------------
U--U-tt-------------C-#BC---CC-----B-ttUtttt-B-----BCB-B----C---------tt-B--B-----B-----------U----#-C--------#----ttB--Btt-C#--#-B-------------B--B--B------U---B--------------------------------------
-----tt------------#--#-------tttt---tt-tttt-----------------#--------tt--------------------------##----------#----tt----tt--#--#-------tt----------tt---tt---------------------------------------------
-----tt#---------#-#--#-------tttt#--tt-tttt-----------------##-------tt---------------#-----#---###----------#----tt----tt--#--#----##-tt-tt-tt----tt---tt---------------------------------------------
----ktt#----g----#-#--#--k-k--tttt#--tt-tttt----kg-----------###kg#g-ktt#-gg-g-g-----g-#-#k-g#-k#####--k---g--#g#g#tt--g-tt#-#-k#k-#-##-ttgtt-tt--g-tt-#gtt-g---g---#-g-g################g#############F
X-XXXXXXXX-XXX--XX-XXXXXXXXXXXXXXXXXXXXXXXXX-XX-XXXXXX-X--X-XXXXXXXXXXXXXXXXXXXXXXXXXX-XXXXXXXXXXXXXXXXXXXXXXXXXXXXXXX-XXXXXXX-XXXXX-XXXXXXXX-XXXXXXXXXXXXXXXXXXXXXXXXXXXXXXXXXXXXXXXXXXXXXXXXXXXXXXXXXX
X-XXXXXXXX-XXX--XX-XXXXXXXXXXXXXXXXXXXXXXXXX-XX-XXXXXX-X--X-XXXXXXXXXXXXXXXXXXXXXXXXXX-XXXXXXXXXXXXXXXXXXXXXXXXXXXXXXX-XXXXXXX-XXXXX-XXXXXXXX-XXXXXXXXXXXXXXXXXXXXXXXXXXXXXXXXXXXXXXXXXXXXXXXXXXXXXXXXXX
