--------------------------------------------------------------------------------------------------------------------------------------------------------------------------------------------------------
--------------------------------------------------------------------------------------------------------------------------------------------------------------------------------------------------------
--------------------------------------------------------------------------------------------------------------------------------------------------------------------------------------------------------
--------------------------------------------------------------------------------------------------------------------------------------------------------------------------------------------------------
--------------------------------------------------------------------------------------------------------------------------------------------------------------------------------------------------------
--S-------U-S-S--SS----SU-----S-----U----SS-S---------US---S---------S-----SUS--S----S------SSS--S--------------------U-S-----------S-S------------U-----------S----U-----------------------------------
---------------C------------------------------------C-------------------C-----------------------C-------------------------------------------------------------------------------------------------------
--------------------------------------------------------------------------------------------------------------------------------------------------------------------------------------------------------
--------------------------------------------------------------------------------------------------------------------------------------------------------------------------------------------------------
--------------------------------------------------------------------------------------------------------------------------------------------------------------------------------------------------------
---tt----CC----S--------C-----------C---S---------U-S-C--------S---U---US-#-C--------------S----S-----tt--------------C------tt----S---Ctt-ttU#-U##C-U-----------CCSCSSS-SSSSSS----S-SSSSS--------------
---tt---#------------tt---tt--------------------------------#-------------#-------------#-------------tt--tt-----------------tt---------tt-tt-#--##------tttt##-#---------------------------------------
---tt-#-#-----------#tt---tt-------------------tt#------#---#-------------#-------------##--------tt-#tt--tt-------------#-tttt---------tt-tt-#--##----tttttt##-#---------------------------------------
---tt-#-#-----g-gg--#tt---tt-------#-k-g-------tt#------#--g#---g---g-----#-------------###------gtt-#tt--tt-k-------g-gg#gtttt-g---g-g-tt-tt-#--##----tttttt##-#--------------gggg-g-----gggggggggggggF
-%%||%|-|%%%-%|%||-%|||%%%||%%-%%%%|%|%|%%%--%%|||%%%%%-|%%||-%%|%%%|%%%%%|-%%%--%-%%-%%|||%--%%%|||-|||-%||%|%%%--%%|%||||||||%|%%%|-|%||-||%|-%||%-%%||||||||%|%%%%%%%%%%%%%%||||%|%%%%%|||||||||||||%
-||||||-||||-|||||-|||||||||||-||||||||||||--||||||||||-|||||-|||||||||||||-|||--|-||-||||||--||||||-|||-||||||||--||||||||||||||||||-||||-||||-||||-|||||||||||||||||||||||||||||||||||||||||||||||||||
