--------------------------------------------------------------------------------------------------------------------------------------------------------------------------------------------------------
--------------------------------------------------------------------------------------------------------------------------------------------------------------------------------------------------------
--------------------------------------------------------------------------------------------------------------------------------------------------------------------------------------------------------
--------------------------------------------------------------------------------------------------------------------------------------------------------------------------------------------------------
--------------------------------------------------------------------------------------------------------------------------------------------------------------------------------------------------------
BB---------B--U-------------B---B---------------B--BBB-------------BB-----BB-----UB---------------B------B-----B--B----------------B------U-----------------B---------B-BBB-----------------------------
-------------------------C-------------------C-C-----------------------------------------------------------------------------------------------C-----------------C--------------------------------------
--------------------------------------------------------------------------------------------------------------------------------------------------------------------------------------------------------
--------------------------------------------------------------------------------------------------------------------------------------------------------------------------------------------------------
--------------------------------------------------------------------------------------------------------------------------------------------------------------------------------------------------------
--B-----#-----C----------B---C--------------UB-B--B------CB-tt---tt---tt-B-----ttC-C-----U--Utt------------U#-#-#--UC----#--B--#tt--U-CC-#C----B--#------U-B-----B-C------------------------------------
-----#tt#-------tt--#-----tt-------#--tt-tt-----------------tt#--tt---tt-------tt----------#-tt-tt----------#-#-#-------##-----#tt-------#---tt---#-----------------------------------------------------
---#-#tt##--tt--tt--#-----tt-------#tttt-tt-----------------tt#--tt---tt-------tt----------#-tt-tt----------#-#-#----tt###-----#tt-------#-tttt-tt#---tt--#---------------------------------------------
g--#-#tt##ggtt-gtt#-#g-g--ttg-k---##tttt#tt------#----kg----tt#--ttgg-ttg---g--tt---k-k----#-ttgtt-k-g---gg-#-#-##---tt###g---g#tt-g-----#-tttt-tt#g-gtt--#---g-k---k#---------------------------------F
XXXX-XXXXXXXXXXXXXXXXXXXXXXXXXX--XXXXXXXXXXXXX-XXXX---XXXXXXXXXXXXXXXXXXXXXXXX-XXX-XXXXXXXXXXXXXXXXXXXXXXXXXXXXXXXXXXXXXXXX-XXXXXXXXXXXX-XXXXXXXXXXXXXXXXXXXXXXXXXXXXXX-XXX-----------------------------
XXXX-XXXXXXXXXXXXXXXXXXXXXXXXXX--XXXXXXXXXXXXX-XXXX---XXXXXXXXXXXXXXXXXXXXXXXX-XXX-XXXXXXXXXXXXXXXXXXXXXXXXXXXXXXXXXXXXXXXX-XXXXXXXXXXXX-XXXXXXXXXXXXXXXXXXXXXXXXXXXXXX-XXX-----------------------------
