--------------------------------------------------------------------------------------------------------------------------------------------------------------------------------------------------------
--------------------------------------------------------------------------------------------------------------------------------------------------------------------------------------------------------
--------------------------------------------------------------------------------------------------------------------------------------------------------------------------------------------------------
--------------------------------------------------------------------------------------------------------------------------------------------------------------------------------------------------------
--------------------------------------------------------------------------------------------------------------------------------------------------------------------------------------------------------
-----------U-U--U------------B--------------B-BB-B---U---------------------U-U---B-U---B------U---BB----------------U-----------------U------B-----BU-----------------B---------------------------------
--------------------------------------C---------------------------------------C------------------------------------------------------------C------C-----------------------------------------------------
--------------------------------------------------------------------------------------------------------------------------------------------------------------------------------------------------------
--------------------------------------------------------------------------------------------------------------------------------------------------------------------------------------------------------
--------------------------------------------------------------------------------------------------------------------------------------------------------------------------------------------------------
UU------#UUC-C--C------C--------------B---U#--------BC-------------#--#B#-#CBCB-C-UC----tt--ttC-----U----------UC--#CB--UB--#---Btt--UCCU--B---UC-B-CU-----#--------tt-----------C------#-U-------------
-------##---------------tttt#--------------#-#-----------#---------#--#-#-#-------------tt--tt----------#----#----##---#----#----tt-------#----------------#-tt-----tt------------------#---------------
---tt-###-----#---------tttt#----#--tt-----#-#--#-tt-----##--#-----#--#-#-#---------#---tt--tt--tt----#-#----#----##---#--tt#tt--tttt-----#----------------#-tt--tt-tt-tt---------------#---------------
--gtt####---#-#--k-k-gg-tttt#g-#-#--tt-k-g-#-#-g#-tt-----###-#-#---#--#-#-#------g--#-g-ttkktt--tt---g#-#gg-g##--k##---#--tt#ttk-tttt----g#---g--------g---##tt-#ttgtt-ttggg------------#--------------F
XXXXXXXXXXXXXXXXXXXXXXXXXXXXXX-X-XXXXXXXXXXX-X-XXXXXXX-XXXXXXXXXXXXXXXXXXXXXXXX-XXXXXXX-XXXXXXXXXXXXXXX-XXXXXXXXXXXXXXXXXXXXXXXXXXXXXXXXXXXXX-XXXXX-XXXXXXXXXXXXXXXXXXXXXXXXXXXXXXXXXXXXXXXXXXXXXXXXXXXX
XXXXXXXXXXXXXXXXXXXXXXXXXXXXXX-X-XXXXXXXXXXX-X-XXXXXXX-XXXXXXXXXXXXXXXXXXXXXXXX-XXXXXXX-XXXXXXXXXXXXXXX-XXXXXXXXXXXXXXXXXXXXXXXXXXXXXXXXXXXXX-XXXXX-XXXXXXXXXXXXXXXXXXXXXXXXXXXXXXXXXXXXXXXXXXXXXXXXXXXX
