--------------------------------------------------------------------------------------------------------------------------------------------------------------------------------------------------------
--------------------------------------------------------------------------------------------------------------------------------------------------------------------------------------------------------
--------------------------------------------------------------------------------------------------------------------------------------------------------------------------------------------------------
--------------------------------------------------------------------------------------------------------------------------------------------------------------------------------------------------------
--------------------------------------------------------------------------------------------------------------------------------------------------------------------------------------------------------
----------U------------------------U------B------B-------B------BB------U---B---------U---U--U---------BB-----------------------B----------------B-----U------BBBB---BBBBBBBB-B--BBBBBBBBBBBBBBBBBBBBBBB
----------------------------C----------------------------------------------------------------------------------------------------C----------------------------------------------------------------------
--------------------------------------------------------------------------------------------------------------------------------------------------------------------------------------------------------
--------------------------------------------------------------------------------------------------------------------------------------------------------------------------------------------------------
--------------------------------------------------------------------------------------------------------------------------------------------------------------------------------------------------------
----------C-B#-#-----C#CU#--B----U-C-tt--------CB---C--UC----------B#B--C----------#BBCBCBCB-CBB-B--tt-----CU--------------------B---------U--U-----CB-C---C-B------------------------------------------
-------------#-#------#--#-----------tt----#------#----------#------#---------tt--##----------------tt---------tt----#-tt---------tt#------------------------------#-----------tt-----------------------
------#------#-##-tt--#--#tt-tt------tt----##-----#--------#-#tt----#------#--tt-###----------------tt#--------tt--tt#-tt---------tt##----#----tt-tt--------#------#-----------tt-----------------------
-g--#-##k--g-#-##gttg-#--#tt-tt-g-g-#tt----###g--g#--k-----#-#tt----#--#-#-#--tt####--------------k-tt#-gkg---#tt--tt#gttgk-k-----tt##g-k-#----ttgtt----k-g-#------##----------tt----------------------F
XXXXX-XXXXXXXXXXXXXXXXXXXXXXXXXXXXXXXXXXXX-XXXXXXXXXXX-XXXXX-XXXXXXXXXXXXXXX-XXXXXXXXXXXXXXXXXXXXXXXXXX-XXXXXXXXXX-XXXXXXXXXXXXX-XXXXXXXXXXXXXXXXXXXXXXXXXXXXX---XXXX--------X-XX-----------------------
XXXXX-XXXXXXXXXXXXXXXXXXXXXXXXXXXXXXXXXXXX-XXXXXXXXXXX-XXXXX-XXXXXXXXXXXXXXX-XXXXXXXXXXXXXXXXXXXXXXXXXX-XXXXXXXXXX-XXXXXXXXXXXXX-XXXXXXXXXXXXXXXXXXXXXXXXXXXXX---XXXX--------X-XX-----------------------
