--------------------------------------------------------------------------------------------------------------------------------------------------------------------------------------------------------
--------------------------------------------------------------------------------------------------------------------------------------------------------------------------------------------------------
--------------------------------------------------------------------------------------------------------------------------------------------------------------------------------------------------------
--------------------------------------------------------------------------------------------------------------------------------------------------------------------------------------------------------
--------------------------------------------------------------------------------------------------------------------------------------------------------------------------------------------------------
-B------U--------------U---------------B------------B-----------B--------B----B----B-B-------B--B--------B-----B----------B-----U-B------B---------BB-----B-B-------------------------------------------
----------------------------------------------------------------------------C---------------------------------------------------------------------------------------------------------------------------
--------------------------------------------------------------------------------------------------------------------------------------------------------------------------------------------------------
--------------------------------------------------------------------------------------------------------------------------------------------------------------------------------------------------------
--------------------------------------------------------------------------------------------------------------------------------------------------------------------------------------------------------
--------C-----C---ttUC-C-CU--tt---#--------B------U--UttC----Utt---#C-#-----B--------------C--B---B----------#C-----------------C--tt------U-B----B------B-C----------------------------------------####
------tt-#------tttt---------tt---#-tt-------------#--tt---tt-tt--##--#tt----------------------------#------##-----------#---------tt---------------------------------------------------------------####
------tt-#--tt--tttt---------tt#--#-tt----#-tt-----#--tt---tt-tt-###--#tt-----------#--------------#-##----###-----------#---tt----tt----------#-------tt----tttt-tttttttttt--tttttttttttttttttttttt####
kg#g-gtt-#--tt--tttt--------gtt#gg#-tt-g#-#-tt---k-#--tt--ktt-tt-###-g#tt-------gk-g#--gg-k-#--g-g-#-###kg####----k-g-k-k#-g#tt--#-tt#k-------g#-------tt-g-gtttt-tttttttttt--tttttttttttttttttttttt###F
XXXXXXXXXXXXXXXXXXXXXXXXXXX-XXXXXXXXXXXXX-XXXXXXXXXXXXXXXXXXXXXXXXXXXXXXXXXXXXXXXXXXX--XXXXXX-XX-XXX-XXXXXXXXXX---XXXXXXXX-XXXXXXX-XXXXXX-XXXXXXXXX--XXXXXXXXXXXXXXXXXXXXXXXX-XXXXXXXXXXXXXXXXXXXXXXXXXX
XXXXXXXXXXXXXXXXXXXXXXXXXXX-XXXXXXXXXXXXX-XXXXXXXXXXXXXXXXXXXXXXXXXXXXXXXXXXXXXXXXXXX--XXXXXX-XX-XXX-XXXXXXXXXX---XXXXXXXX-XXXXXXX-XXXXXX-XXXXXXXXX--XXXXXXXXXXXXXXXXXXXXXXXX-XXXXXXXXXXXXXXXXXXXXXXXXXX
