--------------------------------------------------------------------------------------------------------------------------------------------------------------------------------------------------------
--------------------------------------------------------------------------------------------------------------------------------------------------------------------------------------------------------
--------------------------------------------------------------------------------------------------------------------------------------------------------------------------------------------------------
--------------------------------------------------------------------------------------------------------------------------------------------------------------------------------------------------------
--------------------------------------------------------------------------------------------------------------------------------------------------------------------------------------------------------
--SS---S---------------------S----SU-----U----S--SS------S----U-S------------------------------S--------U----S---S--------S-------S--SS---U---------U-----S-S--SU---------------------------------------
--------------C------------------------------------------------------------------------------------------------C--C----C------------------------------C-------C-------C---------------------------------
--------------------------------------------------------------------------------------------------------------------------------------------------------------------------------------------------------
--------------------------------------------------------------------------------------------------------------------------------------------------------------------------------------------------------
--------------------------------------------------------------------------------------------------------------------------------------------------------------------------------------------------------
-C------------S-------------C----S-C----SC--------------------CU-------tttt--#--------------------------C-----CS--SCtt-S-----------tt---CSCSC-----C-C-S-CC----S-C-S---S---------------------------------
#--------#------tttttttt------tt------tt--tt-#-tt----------------------tttt-##--------------#--------------#--------tt--tt---------tt----------------#--------------------------------------------------
#----tt--#------tttttttt------tt----tttt--tt-#-tt--tt-----------------#tttt###-----tt----tt-##--------tt-tt#--------tt--tt---#-----tt------------#---#-#------------#-----------------------------------
#-g--tt--#--g#--tttttttt-#-k-gtt#-g-tttt--tt##gtt-gttgggg-g#-#-----g--#tttt###g-g--tt----tt-###g---gg-tt-tt#--------ttg-tt-#-#---#-tt---------k-g#---#-#---------k--#g-g-ggggggggggggggggggggggggggggggF
|%|%%||%-|%%||%%||||||||%|-|%||||%|%||||%%|||||||%|||||||%||%|%%%-%|-%|||||||||%|%%||%%%%||-||||%%%||%||%|||%-%%-%%%|||%||-|-|%%%|%||%%%%%%%%%|%||%%%|%|%%%%-%%%%|%%||%|-||||||||||||||||||||||||||||||%
||||||||-|||||||||||||||||-||||||||||||||||||||||||||||||||||||||-||-||||||||||||||||||||||-|||||||||||||||||-||-|||||||||-|-|||||||||||||||||||||||||||||||-|||||||||||-|||||||||||||||||||||||||||||||
