--------------------------------------------------------------------------------------------------------------------------------------------------------------------------------------------------------
--------------------------------------------------------------------------------------------------------------------------------------------------------------------------------------------------------
--------------------------------------------------------------------------------------------------------------------------------------------------------------------------------------------------------
--------------------------------------------------------------------------------------------------------------------------------------------------------------------------------------------------------
--------------------------------------------------------------------------------------------------------------------------------------------------------------------------------------------------------
--U-SS-----U--S--------------S------------------S----S-S-------------------------------------------------------S-------S----------------------U------US-----------SS--S---S------SS---------------------
------C-C-C-------------C--------------------------------C------------C--------------------C-------------------------------------------------------C-------------------C--------------------------------
--------------------------------------------------------------------------------------------------------------------------------------------------------------------------------------------------------
--------------------------------------------------------------------------------------------------------------------------------------------------------------------------------------------------------
--------------------------------------------------------------------------------------------------------------------------------------------------------------------------------------------------------
-#CS--SSSSSC-------ttC--Stt---------tt-------UCC-#-------S--tt---C--#-S-#C-CC-#S-----SC--#-S----S---tt---ttCtt----C---U--tt-----------C----C--CCS--S-C-C-#--ttU-CS--#C-Stt----S-------------------------
-#-----------------tt----tt---------tt-----#-----#----------tt------#---#-----#--------#-#--#------#tt---tt-tt-----------tt------------------------------#--tt------#---tt-tt---------------------------
-#-----------------tt-#--tt------tt-tt-----#-----#--------tttt----tt#---#-----#--tt----#-#--##---#-#tt-tttt-tt------tt---tt---------#---tt-------tt------#--tt------#---tt-tt--#------------------------
k#----------#-g-k-ktt-#k-ttg--g-ktt#ttg-gg##----g#--k-#g#-tttt#gk-tt#--k#-#---#--tt----#k#--###k-#-#tt-tttt-tt--g---tt-ggtt-k-g-----##--ttg-#----tt---g--#g-tt------#---tt-tt--#-----------------------F
||%%%%%%%%%%|%|%|%|||%||%|||%%|%|||||||%||||%%%%||%-|-|||%|||||||%|||-%||%|%%%|%%||%%%%|||%%||||%|-|||-||||%||%-|-%%||%||||%|%|%%%%%||%%|||%|%%%%||%%%|%-||%||%%%%--|%%%||-||%%|%%%%%%%%%%%%%%%%%%%%%%%%
|||||||||||||||||||||||||||||||||||||||||||||||||||-|-|||||||||||||||-||||||||||||||||||||||||||||-|||-||||||||-|-||||||||||||||||||||||||||||||||||||||-|||||||||--||||||-|||||||||||||||||||||||||||||
