--------------------------------------------------------------------------------------------------------------------------------------------------------------------------------------------------------
--------------------------------------------------------------------------------------------------------------------------------------------------------------------------------------------------------
--------------------------------------------------------------------------------------------------------------------------------------------------------------------------------------------------------
--------------------------------------------------------------------------------------------------------------------------------------------------------------------------------------------------------
--------------------------------------------------------------------------------------------------------------------------------------------------------------------------------------------------------
-----------------------S---S---------------SS------------S----U-----------S----S-------U--SS------S-S---------SS---------S---------S------------U---U--------------U--------SS--S-----------------------
------------------------------------CC--------------------------C-----------------------C----------C----------------------C----------------------C-----------------------------C-----CCCCCCCCCCCCCCCCCCC
--------------------------------------------------------------------------------------------------------------------------------------------------------------------------------------------------------
--------------------------------------------------------------------------------------------------------------------------------------------------------------------------------------------------------
--------------------------------------------------------------------------------------------------------------------------------------------------------------------------------------------------------
---------C#-U-------------#-#tt-S---SS-------ttttC-----#---U-#C-S-----------S-#-ttC----CSS---------S---tt-C----------#tt--S-US-U-------C--C-----CS#-C---SS---U-----C---tt-##--CS-----SSSSSSSSSSSSSSSSSSS
----------#-------------tt#-#tt#-------tt----tttt-----##--#--#---tt---#-------#-tt---tt-------#--------tt------------#tt------------#------tt-----#--------------tt----tt-##-----tt---------------------
--tt--tt--#-------------tt#-#tt#-#tt---tt#---tttt----###--#--#---tt---#-tt----#-tt-#-tt-----#-#--------tt#-tt-----#tt#tt------------#---#--tt-tt--#--------tt--#-tt----tt-##-----tt---------------------
--ttggttg-#---g-g--k-k#gtt#-#tt#-#tt---tt#--gtttt--#####--#--#-g-tt--g#-ttgg-g#gtt-#ktt-----#-#k-gg-gg#tt#-ttk--#-#tt#tt------k-g-k-#-k-#--ttgtt--#---g---ktt--#-tt-kg-tt###-g---tt--------------------F
%-|||||||%|%%%|%|%%|%||||||-||||%|||%%%|||%%|||||%%|||||-%|%%|%|%||%-||%||||%|||||%||||%%%--|-||%||%||||||%|||-%|-||||||%%%-%%|%|%|-|-|%|-%|||||%%|%%-|-%%|||%-|%||%||%|||||-|%%-||%%%%%%%%%%%%%%%%%%%%%
|-|||||||||||||||||||||||||-||||||||||||||||||||||||||||-|||||||||||-|||||||||||||||||||||--|-||||||||||||||||-||-|||||||||-|||||||-|-|||-|||||||||||-|-||||||-|||||||||||||-|||-|||||||||||||||||||||||
