--------------------------------------------------------------------------------------------------------------------------------------------------------------------------------------------------------
--------------------------------------------------------------------------------------------------------------------------------------------------------------------------------------------------------
--------------------------------------------------------------------------------------------------------------------------------------------------------------------------------------------------------
--------------------------------------------------------------------------------------------------------------------------------------------------------------------------------------------------------
--------------------------------------------------------------------------------------------------------------------------------------------------------------------------------------------------------
--------U--S------------S--------S----------------S-SS-------------SS-U--US---SU------US---SS-------U--------------------S-U---S------S----------S-S-----SU---------------S-----------------------------
---C----------------------------------------------------------C-----------------------------------------------------------------------------------------C-------C----C----------------------------------
--------------------------------------------------------------------------------------------------------------------------------------------------------------------------------------------------------
--------------------------------------------------------------------------------------------------------------------------------------------------------------------------------------------------------
--------------------------------------------------------------------------------------------------------------------------------------------------------------------------------------------------------
-U#S-C#-CC----U-C-----#---------U------S----S------S--------ttS---#---C#-C-----C-U----C------tt---CSCSC-CC--------U-tt----SC--U----------------tt-------S-CU----SU#--S--S-------------------------------
--#---#-----------tt--#-------------#-----------------------tt----#----#-------------#-------tt--------#-----#------tt-tt---tt---tt-------##-tttt-----------------#tt-----------------------------------
--#---#------#-#--tt--#---tttt----#-##----------------------tt----#----#---tt--------#--#----tt-tt-----#-----#---#--tt-tt---tt---tt-------##-tttt----#tt----tt-#--#tt-tt--------------------------------
--#-g-#g--k-g#-#--tt--#-gkttttk---#-###-#----gk--g-----g-k-gtt---##--#-#---ttgg---k--#-g#g#--tt-tt-----#---g-#-gg#--tt-tt---tt-ggttk-k--g-##-ttttgg--#tt-g--tt-#--#tt-tt-k--k--g-g---------------------F
%%|%|%||%%|-||%|%%||%-|%|||||||%%%|-|||%|%%%%||%-|-%--%|%|%|||%%%||%-|%|-%%||||%-%|%%|%||||-%||-||%%%%%|%%%|%|%|||%%||%||-%%||%|||||%|%%|%||%||||||%%|||%|%%||-|%%|||%||%|-%|%%|%|%%%%--%%%%%%%-%%%%%%%%
|||||||||||-|||||||||-|||||||||||||-||||||||||||-|-|--||||||||||||||-|||-|||||||-||||||||||-|||-|||||||||||||||||||||||||-||||||||||||||||||||||||||||||||||||-|||||||||||-|||||||||||--|||||||-||||||||
