--------------------------------------------------------------------------------------------------------------------------------------------------------------------------------------------------------
--------------------------------------------------------------------------------------------------------------------------------------------------------------------------------------------------------
--------------------------------------------------------------------------------------------------------------------------------------------------------------------------------------------------------
--------------------------------------------------------------------------------------------------------------------------------------------------------------------------------------------------------
--------------------------------------------------------------------------------------------------------------------------------------------------------------------------------------------------------
B-U--------------U-----------------U------B--B----------B----BB---UU-------------------U--U---B-U-------B----------------------B---------BB---------------------B--B--B--------------B------------------
-------------------------------------------C-----------------------------------------------------------------------------------------------C--C---------------------------------------------------------
--------------------------------------------------------------------------------------------------------------------------------------------------------------------------------------------------------
--------------------------------------------------------------------------------------------------------------------------------------------------------------------------------------------------------
--------------------------------------------------------------------------------------------------------------------------------------------------------------------------------------------------------
--C------tt--C---C---------#B-C----C-B-tt--B#-tt-U-------B-#B---U-CC----------tt-----U-CC-C-C--UC------#--C-----CBB-tt-#-----tt-#--#-#-----B--B------------C--tt----C-----------------------------------
----tt---tt----tt---------##------#----tt---#-tt--#--------#------------#-----tt-----------------------#------------tt-#-----tt-#--#-#--#---------------------tt--#-------#tttt-------------------------
----tt---tttt--tt--------###------#----tt---#-tt--#tt#tt--##------------##----tt--##-------------------#---tt-##----tt-###-#-tt-##-#-#--#---------#---tt--#---tt--#-----#-#tttt-------------------------
g--gtt-k-tttt--tt-k-g---####-g-gkg#---gtt---#-tt--#tt#tt--##---------gk-###-#-tt#-##--g------g---k-k-gk#g--ttg##----tt-###-##tt-##g#g#g-#gg----ggg#kk-tt#-#--#tt-##g--g-#-#tttt######g#-###############F
XXXXXXXX-XXXXXXXXXXXXXXXXXXXXXXXXXXXXXXXXXXXX-XXXXXXXXXX-XXXX--XX-XX-XXXXXXXXXXXXXXXXXXXXXXXXXXXXXXXXXXXX-XXXXXXXXXXXXXXXXXXXXX-XXXXXXXXXXXXX-XXXXXXXXXXX-XXXXXX-XXXXXX-X-XXXXXXXXXXXXXXXXXXXXXXXXXXXXXX
XXXXXXXX-XXXXXXXXXXXXXXXXXXXXXXXXXXXXXXXXXXXX-XXXXXXXXXX-XXXX--XX-XX-XXXXXXXXXXXXXXXXXXXXXXXXXXXXXXXXXXXX-XXXXXXXXXXXXXXXXXXXXX-XXXXXXXXXXXXX-XXXXXXXXXXX-XXXXXX-XXXXXX-X-XXXXXXXXXXXXXXXXXXXXXXXXXXXXXX
