--------------------------------------------------------------------------------------------------------------------------------------------------------------------------------------------------------
--------------------------------------------------------------------------------------------------------------------------------------------------------------------------------------------------------
--------------------------------------------------------------------------------------------------------------------------------------------------------------------------------------------------------
--------------------------------------------------------------------------------------------------------------------------------------------------------------------------------------------------------
--------------------------------------------------------------------------------------------------------------------------------------------------------------------------------------------------------
--U-BB-----U--B--------------B------------------B----B-B-------------------------------------------------------B-------B----------------------U------UB-----------BB--B---B------BB---------------------
------C-C-C-------------C--------------------------------C------------C--------------------C-------------------------------------------------------C-------------------C--------------------------------
--------------------------------------------------------------------------------------------------------------------------------------------------------------------------------------------------------
--------------------------------------------------------------------------------------------------------------------------------------------------------------------------------------------------------
--------------------------------------------------------------------------------------------------------------------------------------------------------------------------------------------------------
-#CB--BBBBBC-------ttC--Btt---------tt-------UCC-#-------B--tt---C--#-B-#C-CC-#B-----BC--#-B----B---tt---ttCtt----C---U--tt-----------C----C--CCB--B-C-C-#--ttU-CB--#C-Btt----B-------------------------
-#-----------------tt----tt---------tt-----#-----#----------tt------#---#-----#--------#-#--#------#tt---tt-tt-----------tt------------------------------#--tt------#---tt-tt---------------------------
-#-----------------tt-#--tt------tt-tt-----#-----#--------tttt----tt#---#-----#--tt----#-#--##---#-#tt-tttt-tt------tt---tt---------#---tt-------tt------#--tt------#---tt-tt--#------------------------
k#----------#-g-k-ktt-#k-ttg--g-ktt#ttg-gg##----g#--k-#g#-tttt#gk-tt#--k#-#---#--tt----#k#--###k-#-#tt-tttt-tt--g---tt-ggtt-k-g-----##--ttg-#----tt---g--#g-tt------#---tt-tt--#-----------------------F
XXXXXXXXXXXXXXXXXXXXXXXXXXXXXXXXXXXXXXXXXXXXXXXXXXX-X-XXXXXXXXXXXXXXX-XXXXXXXXXXXXXXXXXXXXXXXXXXXX-XXX-XXXXXXXX-X-XXXXXXXXXXXXXXXXXXXXXXXXXXXXXXXXXXXXXX-XXXXXXXXX--XXXXXX-XXXXXXXXXXXXXXXXXXXXXXXXXXXXX
XXXXXXXXXXXXXXXXXXXXXXXXXXXXXXXXXXXXXXXXXXXXXXXXXXX-X-XXXXXXXXXXXXXXX-XXXXXXXXXXXXXXXXXXXXXXXXXXXX-XXX-XXXXXXXX-X-XXXXXXXXXXXXXXXXXXXXXXXXXXXXXXXXXXXXXX-XXXXXXXXX--XXXXXX-XXXXXXXXXXXXXXXXXXXXXXXXXXXXX
