--------------------------------------------------------------------------------------------------------------------------------------------------------------------------------------------------------
--------------------------------------------------------------------------------------------------------------------------------------------------------------------------------------------------------
--------------------------------------------------------------------------------------------------------------------------------------------------------------------------------------------------------
--------------------------------------------------------------------------------------------------------------------------------------------------------------------------------------------------------
--------------------------------------------------------------------------------------------------------------------------------------------------------------------------------------------------------
B-------------B-------BB-B-------------UB------------------------------BB---B--B------BB--------------------------BB----B---U-------------------------B------------U-----UUUUUUUU-BBUB-UUUUUUUUUUUUUUUUU
-------------------C------------C--C------C--------------------------C------------------C------------------------------------------------------------------------CC-CC--C-------------------------------
--------------------------------------------------------------------------------------------------------------------------------------------------------------------------------------------------------
--------------------------------------------------------------------------------------------------------------------------------------------------------------------------------------------------------
--------------------------------------------------------------------------------------------------------------------------------------------------------------------------------------------------------
-Ctt-B--B-U--------B-B----UC----B-#Btt-C--B-------------CB--------U--B-----C--------UB--B-------B-----------B---------tt----C#--------#-#----U----B#-----------U-BBCBB--BCCCCCCCC---C--CCCCCCCCCCCCCCCCC
--tt--tt----------------------#---#-tt------------tt-----------------------------#----------------tt----------tt----tttt--tt-#-------##-##---------#---tt---#---#-----tt--------------------------------
--tt--tt---tt-----------------#---#-tt-----tt----#tttttt-----------------tt------#----------------tt--tttt----tt-#--tttt--tt-#------#######--------#---tt-#-#---#-----tt--------------------------------
--tt--tt-g-tt--#gg--#----g---g#---#-tt#----ttg-k-#tttttt--gk-g-g---#--k-gtt--kg--##------k-k-----ktt--ttttg--#tt-#g-tttt-gtt-##----##########------#-ggttk#-#kk-#-----tt----------g---g----------------F
XXXXXXXXXXXXXX-XXXXXXXXXXXXX-XXXXXXXXXXX-XXXXXXXXXXXXXXXXXXXXXXXXXXXXXX-XXXX-XX-XXXXXX--XXXXXXXXXXXXXXXXXXXXXXXX-XX-XXXX-XXXXXXXXXXXXXXXXXXXXX-XXXXX-XXXXXX-XXXXXXXXXXXXXXXXXXXXXXX-X-XXXXXXXXXXXXXXXXXX
XXXXXXXXXXXXXX-XXXXXXXXXXXXX-XXXXXXXXXXX-XXXXXXXXXXXXXXXXXXXXXXXXXXXXXX-XXXX-XX-XXXXXX--XXXXXXXXXXXXXXXXXXXXXXXX-XX-XXXX-XXXXXXXXXXXXXXXXXXXXX-XXXXX-XXXXXX-XXXXXXXXXXXXXXXXXXXXXXX-X-XXXXXXXXXXXXXXXXXX
