--------------------------------------------------------------------------------------------------------------------------------------------------------------------------------------------------------
--------------------------------------------------------------------------------------------------------------------------------------------------------------------------------------------------------
--------------------------------------------------------------------------------------------------------------------------------------------------------------------------------------------------------
--------------------------------------------------------------------------------------------------------------------------------------------------------------------------------------------------------
--------------------------------------------------------------------------------------------------------------------------------------------------------------------------------------------------------
-BU-----------------U----BBB---------U-------B----B-----------B-BB--B----------B--BBB---B-----B-----------UB--BB----------B---UU-----------UU--------------B-B-B-B-BBBB---------------------------------
----C---C-----C--------C--------C--------------C-------------------------------------C-------------------------------------------C------------------C-------------C-------------------------------------
--------------------------------------------------------------------------------------------------------------------------------------------------------------------------------------------------------
--------------------------------------------------------------------------------------------------------------------------------------------------------------------------------------------------------
--------------------------------------------------------------------------------------------------------------------------------------------------------------------------------------------------------
--CUB---B----BB---CBCBCBC-------B--C-C-C-B----#B---U------B-------B--U#----------#---B---U#B-----------B-BC-#B-------------tt-CC-BttB--#tt-CC--#----Btt-----------B--------U---#------------------------
----------#tt---#-----------------#-----#-#---#-tt-------#------------#--#----#--#--------#-tt-tt-----------#---tt---------tt-----tt---#tt----##-----tt------------------------#------------------------
#---------#tt---#-----------------#-----#-##--#-tt-------#-tt---------#-##--#-#--#--------#-tt-tt-tt--------#---tt---------tt-----tt--##tt---###-----tt------------------------#-#----------------------
#-----#---#tt--##g---------g#g-k-##-----#-###-#-ttg-g-g-##-ttkg----kg-####-k#-#--#ggg-----#-tt-tt-tt-------g#---tt-g--k----ttk--k-tt-g##tt---###k-kg-ttg-g-g-g-g-g-gggg--------#-#---------------------F
XXXXXXXXX-XXXXXXXXXXXXXXXX-XXXXXXXXXXXXXXXXXX-XXXXXXXXXXXXXXXXXXX-XXXXXXXXXXX-XXXXXXXXXXXXXXXXXXXXXX---X-XXXXXXXXXXXXXXXXX-XXXXXXXXXXXXXXXXXXXXXXXXXXXXXXXXXXXXXXXXXXXXXXXXXXXXXXXXXXXXXXXXXXXXXXXXXXXXX
XXXXXXXXX-XXXXXXXXXXXXXXXX-XXXXXXXXXXXXXXXXXX-XXXXXXXXXXXXXXXXXXX-XXXXXXXXXXX-XXXXXXXXXXXXXXXXXXXXXX---X-XXXXXXXXXXXXXXXXX-XXXXXXXXXXXXXXXXXXXXXXXXXXXXXXXXXXXXXXXXXXXXXXXXXXXXXXXXXXXXXXXXXXXXXXXXXXXXX
