--------------------------------------------------------------------------------------------------------------------------------------------------------------------------------------------------------
--------------------------------------------------------------------------------------------------------------------------------------------------------------------------------------------------------
--------------------------------------------------------------------------------------------------------------------------------------------------------------------------------------------------------
--------------------------------------------------------------------------------------------------------------------------------------------------------------------------------------------------------
--------------------------------------------------------------------------------------------------------------------------------------------------------------------------------------------------------
---------------S-------U-----------S-S---------SU-----S--SS------------S-------------------S--S--S---SS----------SS----S----U----S----------S-----S----S------------------------------------------------
-------------------------------------------------------------------------C-C-C-----C------------C-------C-------------------------------------------------C---------------------------------------------
--------------------------------------------------------------------------------------------------------------------------------------------------------------------------------------------------------
--------------------------------------------------------------------------------------------------------------------------------------------------------------------------------------------------------
--------------------------------------------------------------------------------------------------------------------------------------------------------------------------------------------------------
--------tt---#---------C---S--------------------CS------S------------tt--SSSSSU-S-SS-S---US-U---S-C-S--#S------C#----#C-----CU-----CSS-------------#--#--CS-----------------------------------UUUUUUUUUU
--------tt--##---------------tt----------tt---#---#------------------tt--------------------------------#-#----#-#----#----------#------------#-----#--#-------------------------------------------------
--------tt-###---------------tt----------tt-#-#---#------------------tt--------------------------------#-##---#-#----#----------#------------#-----#tt#-------------------------------------------------
g-gk-g--tt#####g----kg----#-kttg-k-g--gk-tt-#-#---#gg----------------ttg-------k-k--g-ggk--g---#-------#-###-g#-#-g-##-g-g-k---g#-g-----#k--g#gk---#tt#-g---k-kgkkk-k--kkkkk-k-------------------------F
|%||%|%%||||||||%%-%||%%%-|%||||%|%|%%||-||-|-|%%%|||--%%--%%%--%%-%%|||%%%%%%%|%|%%|%|||%%|%--|%-%-%%%|%|||%||%|-|-||%|%|%|%%%||-|%%%%%||%%||||-%-||||-|%%%|%|||||%|%%|||||%|%%%%%%%%%%%%%%%%%%%%%%%%%%
||||||||||||||||||-||||||-||||||||||||||-||-|-|||||||--||--|||--||-||||||||||||||||||||||||||--||-|-|||||||||||||-|-|||||||||||||-||||||||||||||-|-||||-||||||||||||||||||||||||||||||||||||||||||||||||
