--------------------------------------------------------------------------------------------------------------------------------------------------------------------------------------------------------
--------------------------------------------------------------------------------------------------------------------------------------------------------------------------------------------------------
--------------------------------------------------------------------------------------------------------------------------------------------------------------------------------------------------------
--------------------------------------------------------------------------------------------------------------------------------------------------------------------------------------------------------
--------------------------------------------------------------------------------------------------------------------------------------------------------------------------------------------------------
----------------B---------BB-------------------------BB---B------------BB----BB--------------B-----BB----B----B-------------------------------------------U----------U--------B-------------U--------B--
---C-------------------------------------------------------C-----------------------------------C-C----------------------------C---------C---------------------------------------------------------------
--------------------------------------------------------------------------------------------------------------------------------------------------------------------------------------------------------
--------------------------------------------------------------------------------------------------------------------------------------------------------------------------------------------------------
--------------------------------------------------------------------------------------------------------------------------------------------------------------------------------------------------------
---B-------C--U-----#--C--------------------------Utt------Btt---#-------C-------C#--B--------BBBBB---------C#---U-----B-tt-ttB--------CB-----#U--#-B-C-B-C-tt-------C----------------------C-----------
-tt----------------##-----------#-tt----#-------tt-tt-------tt-tt#----------------#----tt--------------#--tt-#-------tt--tt-tt--------#----tt-#-tt##-----#--tt-------------------#----------------------
-tt----------#-#--###---tt-----##-tt----#-------tt-tt-------tt-tt#tt-tt-----#-----#tt--tt#-------------#--tt-#--#----tt-#tt-tt------#-#----tt-#-tt##-----#--tt-tt----------------#----------------------
-tt---k-----g#-#-g###gg-ttggkk###-tt-g-g#g-k-kg-tt-tt-----g-ttgtt#tt#ttg--#-#g--g-#tt--tt#--g--------kg#--tt-#g-#---gtt-#tt-tt-k-g--#-#--g-tt-#-tt##-g---#--tt-tt-------------g--#---------------------F
XXXXXXXXXXXXXXXXXXXXXXXXXXXXXXXXX-XXXXXXXXXXXXXXXXXXX--X-XXXXXXXXXXXXXXX-XX-XX-XXXXXXXXXXX-XXXXXXXXXXXXXXXXXXXX-XX-XXXXXXXXXXXXXXXXXX-XXXXXXXXXXXXXXXXXXXXX-XX-XX----X--------X--XX--XX-----X-----------
XXXXXXXXXXXXXXXXXXXXXXXXXXXXXXXXX-XXXXXXXXXXXXXXXXXXX--X-XXXXXXXXXXXXXXX-XX-XX-XXXXXXXXXXX-XXXXXXXXXXXXXXXXXXXX-XX-XXXXXXXXXXXXXXXXXX-XXXXXXXXXXXXXXXXXXXXX-XX-XX----X--------X--XX--XX-----X-----------
