--------------------------------------------------------------------------------------------------------------------------------------------------------------------------------------------------------
--------------------------------------------------------------------------------------------------------------------------------------------------------------------------------------------------------
--------------------------------------------------------------------------------------------------------------------------------------------------------------------------------------------------------
--------------------------------------------------------------------------------------------------------------------------------------------------------------------------------------------------------
--------------------------------------------------------------------------------------------------------------------------------------------------------------------------------------------------------
-------S---S------S---------S-----S--S----S--------------S---SS-----------------------------------S------------------U-----S---S----S-----S-------S--U----S-----------------S---------------------------
C-------C----------C----C----------------------------------------------------C--------------------------------------------------------C--------C-C------------------------------------------------------
--------------------------------------------------------------------------------------------------------------------------------------------------------------------------------------------------------
--------------------------------------------------------------------------------------------------------------------------------------------------------------------------------------------------------
--------------------------------------------------------------------------------------------------------------------------------------------------------------------------------------------------------
S-------Stt-U-tttt-S----S-C-----#-----C--C----SS--ttS-UC----S----------------S---ttSC-----tt------------tt-----------C-----------tt#--S--------SSS-C-C--#S-SttU---tt-S----------S-----------------------
---------tt---tttt-------------##----------tt-----tt--------------------#--------tt-------tt------------tt--##----#----#---------tt#---#tt-tttt---------#---tt-tt-tt------------------------------------
-#----#--tt---tttt--tttt------###------#---tt---#-tt-#----------tt----#-#tt----tttt-------tt------------tt--###---#----#-##------tt#---#tt-tttt---------#---tt-tt-tt-----###-###-#######################
-#-g#-#g-tt---ttttg-tttt-----####------#---ttg--#gtt-#---g-g----tt----#-#tt----tttt--kkk-gttk-k----k-g-kttgg####--##g--#k##-g-gg-tt#---#tt-tttt---g-g---#-g-tt-ttktt--k-k###-###-######################F
%|%||-||%||%%%|||||%||||%%%%-||||-%%%%%|%%-|||%%||||%|%%%|%|%%%%||%--%|-|||%%%-||||%%|||%||||%|%%%%|%|%|||||||||-%|||%%||||-|%||%|||%-%|||%||||%%%|%|%%%|%|%||%|||||%%|%||||-|||%||||||||||||||||||||||%
|||||-||||||||||||||||||||||-||||-||||||||-||||||||||||||||||||||||--||-||||||-|||||||||||||||||||||||||||||||||-||||||||||-|||||||||-||||||||||||||||||||||||||||||||||||||-|||||||||||||||||||||||||||
