--------------------------------------------------------------------------------------------------------------------------------------------------------------------------------------------------------
--------------------------------------------------------------------------------------------------------------------------------------------------------------------------------------------------------
--------------------------------------------------------------------------------------------------------------------------------------------------------------------------------------------------------
--------------------------------------------------------------------------------------------------------------------------------------------------------------------------------------------------------
--------------------------------------------------------------------------------------------------------------------------------------------------------------------------------------------------------
--U--SS-U-----S-------S------------------S-----------------------S--S-U------------U-------S----S---SS-----SS---U------S------------S-S-S----U---------------------S------------------------------------
----------------C-------------C---------------------------------C----C----------------------------------C-----------------------------------------------------------------------------------------------
--------------------------------------------------------------------------------------------------------------------------------------------------------------------------------------------------------
--------------------------------------------------------------------------------------------------------------------------------------------------------------------------------------------------------
--------------------------------------------------------------------------------------------------------------------------------------------------------------------------------------------------------
--C-S---CS---U--S----------S--S--#---U-----------Ctt--#---#S#---S----SCCCS---------C--------------tt----S-#---ttC------------#-S-----------C-C----------S--CttttC---C-----tt####-####--###--############
-------------------------------tt#tt#-------------tt--#--##-#tt---------------------tt-#-----#----tt------#---tt---------#--##---tt------tt---tt------------tttt-----tt---tt####-####--###--############
-------#---tt----tt------tt-tt-tt#tt#-------------tt--##-##-#tt--------------#--#-#-tt-#-----##---tt------#---tt---------#-###---tt------tt---tt------------tttt-tt--tt---tt####-####--###tt############
-------#---tt-gk-ttg-kgg-tt-tt-tt#tt#--gggk-k-g-g-ttg-##-##-#tt--g--------gg-#kg#-#-ttg#g--gg###ggtt--#---#--gtt--g--g#--#####---ttk--gg-tt-k-tt-k-k--------tttt-tt--tt-g#tt#########--###tt###########F
%%%%%--|%%-||%||%|||%|||%||%||%||||||%%||||-|%|%|%|||%||-||%|||%%|-%%%%%%%||%||||%|%|||||%%|||||||||%%|%%-|-%|||%%|--||-%|||||%%%|||--||-||%|%||%|%|%%%%%-%%||||%||%%||%|||||||||||||%%||||||||||||||||%
|||||--|||-||||||||||||||||||||||||||||||||-||||||||||||-|||||||||-||||||||||||||||||||||||||||||||||||||-|-|||||||--||-||||||||||||--||-||||||||||||||||-||||||||||||||||||||||||||||||||||||||||||||||
