--------------------------------------------------------------------------------------------------------------------------------------------------------------------------------------------------------
--------------------------------------------------------------------------------------------------------------------------------------------------------------------------------------------------------
--------------------------------------------------------------------------------------------------------------------------------------------------------------------------------------------------------
--------------------------------------------------------------------------------------------------------------------------------------------------------------------------------------------------------
--------------------------------------------------------------------------------------------------------------------------------------------------------------------------------------------------------
-B--B---B--B-----------B-B------B---------------BB--------B--B--B-------B---B-----B-B-B--------U----BB---B------BB--------UU--BB--U-----------B---B-----U----U--U----------BB---------------------------
----------------------C-----------------------------------------------------------------C-C---------------------------C------------------------------C--------------------------------------------------
--------------------------------------------------------------------------------------------------------------------------------------------------------------------------------------------------------
--------------------------------------------------------------------------------------------------------------------------------------------------------------------------------------------------------
--------------------------------------------------------------------------------------------------------------------------------------------------------------------------------------------------------
U-U--#-C-C--B-B------CB---ttB--U------------#------------U-----C-------B---C--B--U------B-B#--BC---B--U-------U-----ttB-U-CCtt----C-B-#-tt----------CBC-C-C--C-BC------#-----UUUUUUBUUUUUUUUUUUUUUUUUUUU
-----#------------tt------tt------tt-------##--#-----tt-------------------#----------------#---------------tt-------tt------tt--------#-tt-------------------------tt--#--------------------------------
-----#-----------#tt------tt-----#tt------####-#---##tt#------------tt----#------------#---#---------------tt-----tttt------tt--------#-tt-tt------#----------#--#-tt--#-tt-----------------------------
-----#--g-k--g---#tt-----gtt--g-g#tt-k-g-#####-#-g-##tt##--------g-gtt---g#--g-k-------#-g-#gk--g-k-----#--tt---g-tttt-k-g--ttg----g--#-tt-tt-g-ggg#-------#--#--#-tt--#-tt----------------------------F
XXXXXXXXXXX-XXXXXXXX-XXXXXXXXXXXXXXXXXXXXXXXXX-X-XXXXXXXXX-XXXXXXXXXXXXXXXXX-XXX-X-XXX-XXXXXXXXXXXXX--XXXXXXX-X-X-XXXXXXXXXXXXX-X-XXXXXXXX-XXXXXXXXXXXXXXXXXXXXXXX-XXXXXXXXXXXXXXXXXXXXXXXXXXXXXXXXXXXXX
XXXXXXXXXXX-XXXXXXXX-XXXXXXXXXXXXXXXXXXXXXXXXX-X-XXXXXXXXX-XXXXXXXXXXXXXXXXX-XXX-X-XXX-XXXXXXXXXXXXX--XXXXXXX-X-X-XXXXXXXXXXXXX-X-XXXXXXXX-XXXXXXXXXXXXXXXXXXXXXXX-XXXXXXXXXXXXXXXXXXXXXXXXXXXXXXXXXXXXX
