--------------------------------------------------------------------------------------------------------------------------------------------------------------------------------------------------------
--------------------------------------------------------------------------------------------------------------------------------------------------------------------------------------------------------
--------------------------------------------------------------------------------------------------------------------------------------------------------------------------------------------------------
--------------------------------------------------------------------------------------------------------------------------------------------------------------------------------------------------------
--------------------------------------------------------------------------------------------------------------------------------------------------------------------------------------------------------
U-U-------------S-----S---------------------------------U------U---S---S------U-----------UUS------------------------------------------------U----U-S--S--------S-SS------------------------------------
--------------C----------------------------C-------------C----C----------------C----C-------------------------------------------------------C------C----------------------------------------------------
--------------------------------------------------------------------------------------------------------------------------------------------------------------------------------------------------------
--------------------------------------------------------------------------------------------------------------------------------------------------------------------------------------------------------
--------------------------------------------------------------------------------------------------------------------------------------------------------------------------------------------------------
C-CttU-U-#-#--S-------------S---#---#------S-----tt-----CS----SCS----U#-----U-CS----SUtt--CC--#-------ttC-C----------------U--#U-C----------SC--U-CS-tt--tt--------------------C----------#-------------
---tt----#-#-----##------#-----##---#------------tt-----------------#-#---------tt----tt------###-----tt---------#------------#----------------------tt--tttt--------tttttttttt-tttttttttt#tttttttttttt-
---tt----#-#-----###---#-#tt--###--##------------tt-------tt--------#-#---------tt-#--tt------###-----tt---------#------------#---#tttt--##----------tt--tttt--#-----tttttttttt-tttttttttt#tttttttttttt-
-g-tt----#-#----g####k-#-#tt-####-g##k-k-----#gkktt-k--g--tt#----k--#-#--g-k----tt-#--tt#g----###-----tt-g-k-g-g-#-g--------g-#---#tttt#-##----------ttggttttg-#-g-g#tttttttttt-tttttttttt#ttttttttttttF
%|%||%%%%|%|%-%%||||||%|-|||%||||%||||%|%%%%-||||||%|%%|%%|||%%%%|-%|%|-%|%|%%%%||%|%%||||%%-%|||%-%%%||%|%|%|%|%|%|%%--%%%%|%|%%%||||||-||%%%%-%%%%-|||||||||%|-|-||||||||||||%|||||||||||||||||||||||%
|||||||||||||-||||||||||-|||||||||||||||||||-|||||||||||||||||||||-||||-||||||||||||||||||||-|||||-|||||||||||||||||||--||||||||||||||||-||||||-||||-|||||||||||-|-|||||||||||||||||||||||||||||||||||||
