--------------------------------------------------------------------------------------------------------------------------------------------------------------------------------------------------------
--------------------------------------------------------------------------------------------------------------------------------------------------------------------------------------------------------
--------------------------------------------------------------------------------------------------------------------------------------------------------------------------------------------------------
--------------------------------------------------------------------------------------------------------------------------------------------------------------------------------------------------------
--------------------------------------------------------------------------------------------------------------------------------------------------------------------------------------------------------
S---S-----S----------U----------------S--SS----S--S--S--U-----S------------U---------------S---------U-S---------S-S----U------U---SS-SS----------S---SS----------S-----S----SS--SUUS-------------------
------------C----------------------------------------------------------C---------------C----------C---C------------------------------------------------------------------------------C------------------
--------------------------------------------------------------------------------------------------------------------------------------------------------------------------------------------------------
--------------------------------------------------------------------------------------------------------------------------------------------------------------------------------------------------------
--------------------------------------------------------------------------------------------------------------------------------------------------------------------------------------------------------
--tt----S#--S---#-S--C-----#---------------------#------C--S---#-------S-ttC-------U---S-----C----S--CS-----tt------tt--C-----#C-----S----Stttt--U-------C---tt----C-C------------CC-S--------#---------
--tt-tt--#------#----------#---------------------#-----#-tt-##-#----tt---tt---tt---------------#------------tt-tt---tt---#--tt#-tt---------tttttt----------tttt#-#----tt--tt---------------#-###########
--tt-tt--#----tt##------#tt#-----------tt--------#-----#-tt-##-#----tt---tt---tt---------tt----#------------tt-tt---tt---##-tt#-tt------tt-tttttt----------tttt#-#----tt--tt-------------#-#############
--tt-tt--#----tt##--g-#-#tt#kg---g-k-k-ttgg---k-g#-#---#-tt-##-#g--gtt---tt-k#tt-g---g---tt-g--#---#----kk-gttktt---tt---###tt#-tt------tt-tttttt-----g----tttt#k#----tt--tt-gg-------g-g#-############F
%%||-||%%|%%%%||||%%|%|-||||||%%%|%|%|-||||%-%|-||-|%-%|%||%||-||%-|||%%%||%||||%|%%-|%%-||-|%%|--%|%%%%||%||||||%-%||%%%||||||%||%-%%%%||%||||||%--%%|-%%%|||||||%%-%||%%||%||%%-%%%%|%||-||||||||||||%
||||-||||||||||||||||||-||||||||||||||-|||||-||-||-||-||||||||-|||-|||||||||||||||||-|||-||-||||--||||||||||||||||-||||||||||||||||-||||||||||||||--|||-||||||||||||-||||||||||||-||||||||-|||||||||||||
