--------------------------------------------------------------------------------------------------------------------------------------------------------------------------------------------------------
--------------------------------------------------------------------------------------------------------------------------------------------------------------------------------------------------------
--------------------------------------------------------------------------------------------------------------------------------------------------------------------------------------------------------
--------------------------------------------------------------------------------------------------------------------------------------------------------------------------------------------------------
--------------------------------------------------------------------------------------------------------------------------------------------------------------------------------------------------------
S----S----S-----------S-------U--U--U------------S------S-S---U-S--------SS-------------U------------------S---U--------S---------------S-----------S-------U---------------S----S-----------S----------
------C-------------CC-------------C-------------------------------C-----------C-C-C-------------C----------C-------------------------------------------------------------------------------------------
--------------------------------------------------------------------------------------------------------------------------------------------------------------------------------------------------------
--------------------------------------------------------------------------------------------------------------------------------------------------------------------------------------------------------
--------------------------------------------------------------------------------------------------------------------------------------------------------------------------------------------------------
-S----S-U----#------SS--tt----C--C-SC--tt-----#C---------#---SC----S-----------S-S-SC---CU----S-USC------#C-SC-C-#----------C-#C--S--Stt---------C----U-tt-SC-------tt-------tt-----------ttU-----------
--#--------#-#--tt------tt-tt--tt------tt----##--------#-#--#--------------------------------------------#-------#--------tt--#-#-----tt----------------tt----------tttt-----tt---tttt----tt------------
--##---#---#-#--tt------tt-tt--tt------tt---###------#-#-#--#----#---tt-----##--------tt-----------------#----#--####-----tt-##-#-----tt-tt-tt----------tt----------tttt-tt--tt---tttt#---tt--tttttttttt
--###g-#---#-#-gtt----gktt-ttg-tt----##ttg-g###--gggg#-#-#--#----#g-#tt-kg--##k-#----gtt--gk#k-----k-g---#----#-g####----#tt-##-#g----ttgtt-tt-g#---gg--ttg----kk--kttttgtt--tt-kgtttt#k--tt--tttttttttF
%%||||%|%%%|-|%|||%%%%||||%|||%||%%%%|||||%||||%%|||||-|-|-%|%%%-||%|||%||-%|||%|%%%%|||%%||||%%%%%|%|%%%|%%%%|%|||||%%--|||%||%||%%-%|||||-||-||%%-||%%|||%%%%||%%||||||||%-||%||||||||%%||%%|||||||||%
||||||||||||-|||||||||||||||||||||||||||||||||||||||||-|-|-|||||-|||||||||-||||||||||||||||||||||||||||||||||||||||||||--|||||||||||-||||||-||-||||-||||||||||||||||||||||||-|||||||||||||||||||||||||||
