--------------------------------------------------------------------------------------------------------------------------------------------------------------------------------------------------------
--------------------------------------------------------------------------------------------------------------------------------------------------------------------------------------------------------
--------------------------------------------------------------------------------------------------------------------------------------------------------------------------------------------------------
--------------------------------------------------------------------------------------------------------------------------------------------------------------------------------------------------------
--------------------------------------------------------------------------------------------------------------------------------------------------------------------------------------------------------
----BB----BB----BB-------------U-----B-------B-------B-------B----B-B--U-------U------BB------B------BB-----B-------------B---B---------------------B----B--------------------------------B-------------
----------------------C-------C--------------------C---------------------------------------------------------------C------------------------------------------------------------------------------------
--------------------------------------------------------------------------------------------------------------------------------------------------------------------------------------------------------
--------------------------------------------------------------------------------------------------------------------------------------------------------------------------------------------------------
--------------------------------------------------------------------------------------------------------------------------------------------------------------------------------------------------------
---------------------BB#B-----BC----#-------------#B-------#----tt---C-C-C-ttBCC-tt--B---B#C##--C---B--tt-------#-CB-B-----#-----------U--------------ttB-Btt----------####tt-tttttttttttt-tttttttttttt-
#tt----tt--------------#------------#-#tt#----#---#---#---##----tt---------tt---#tt-------#-##---#-----tt-tt----#----------#---------#--#------#------tt---tttt--------####tt-tttttttttttt-tttttttttttt-
#tt---#tt---tt---------#----tt------#-#tt#-#--#---#-#-#--###----tt---------tt---#tt-------#-##---##----tt#tt-tt-#----------#----tt##-#--#------#tttt--tt---tttt--------####tt-tttttttttttt-tttttttttttt-
#ttgg-#ttg--tt----k-k--#-g--tt----k##-#tt#g#--##gk#-#-#-####--#-tt-g-------tt---#tt-----g-#-##gk-###---tt#ttgttg#g--#--gk-g#g--#tt##-#g-#g-g---#ttttggtt---ttttggg-k-g-####tt-ttttttttttttgttttttttttttF
XXXXXXXXXX-XXX-X-XXXXXXXXXXXXXXXXXXXX-XXXXXXXXXXXXXXX-XXXXXXXXXXXX-X-XXXXXXXXXXXXXXXXXXXXXXXXXXXXXXXX--XXXXXXXXXXXXXXXXXXXXXX--XXXXX-XXXXXXXXXXXXXXXXXXXXXXXXXXXXXXXXXXXXXXXXXXXXXXXXXXXXXXXXXXXXXXXXXXX
XXXXXXXXXX-XXX-X-XXXXXXXXXXXXXXXXXXXX-XXXXXXXXXXXXXXX-XXXXXXXXXXXX-X-XXXXXXXXXXXXXXXXXXXXXXXXXXXXXXXX--XXXXXXXXXXXXXXXXXXXXXX--XXXXX-XXXXXXXXXXXXXXXXXXXXXXXXXXXXXXXXXXXXXXXXXXXXXXXXXXXXXXXXXXXXXXXXXXX
