--------------------------------------------------------------------------------------------------------------------------------------------------------------------------------------------------------
--------------------------------------------------------------------------------------------------------------------------------------------------------------------------------------------------------
--------------------------------------------------------------------------------------------------------------------------------------------------------------------------------------------------------
--------------------------------------------------------------------------------------------------------------------------------------------------------------------------------------------------------
--------------------------------------------------------------------------------------------------------------------------------------------------------------------------------------------------------
BB----------B-------B-BB---------------U---B------U-----B------B-----------------BU-BB-------B------U-U-B----------------B-------B-----------------B-UB----B--------------------------------------------
-----------------------------------------------------------------------------------------------------------------------------C-C---CC---------------C--------------------CCCCC-CCCCCCCCCCCCCCCCCCCCCCCCC
--------------------------------------------------------------------------------------------------------------------------------------------------------------------------------------------------------
--------------------------------------------------------------------------------------------------------------------------------------------------------------------------------------------------------
--------------------------------------------------------------------------------------------------------------------------------------------------------------------------------------------------------
--#-tt-Utt----C------B----------#-##---C-B--------C---B--U--------------tt#-UB----CB--#--#tt----#---CBCC-U-------#U-B--tt--U-B-B--CBB----BB---#-----BC-U#-#------------C-BBBBB-BBBBBBBBBBBBBBBBBBBBBBBBB
--#-tt--tt------#---------#-----#-##--------#-------------#tt-----------tt#-----------#--#tt----#----------tt---##---tttt---------------------##--#-----#-#-------------------#-------------------------
--#-tt--tttt-#--#-------#-#-----#-##-tt-----#tt-#---------#tt-------#---tt##--tt------#--#tt--tt#----------tt#-###---tttt------------#------tt##--#-----#-#--#------#---#-----#-------------------------
-g#-tt--ttttg#-##-g-g---#-#k-g-g#g##-tt-g--g#tt-#k-g-k----#tt-#----g#---tt##--tt------#--#tt--tt#g-k-------tt#####---ttttgk-#-k--g---#g----#tt##--#g----#-#gk#k-k---#-g-#-----#------------------------F
XXX-XXXXXXXXXXXXXXXXXX--X-XXXXXXXXXXXXXXXXXXXXX-XXXX-XXXXXXXXXXXXXXXXXXXXXXXXXXX--XXXXXXXXXXXXXXXXXXXXXXXXXXXXXXXXXXXXXXXXXXXXXXXXXXXXXXXXXXXXXX-XXXXXXXXXXXXXXXXXXXXXXXXXXXXXXXXXXXXXXXXXXXXXXXXXXXXXXX
XXX-XXXXXXXXXXXXXXXXXX--X-XXXXXXXXXXXXXXXXXXXXX-XXXX-XXXXXXXXXXXXXXXXXXXXXXXXXXX--XXXXXXXXXXXXXXXXXXXXXXXXXXXXXXXXXXXXXXXXXXXXXXXXXXXXXXXXXXXXXX-XXXXXXXXXXXXXXXXXXXXXXXXXXXXXXXXXXXXXXXXXXXXXXXXXXXXXXX
