--------------------------------------------------------------------------------------------------------------------------------------------------------------------------------------------------------
--------------------------------------------------------------------------------------------------------------------------------------------------------------------------------------------------------
--------------------------------------------------------------------------------------------------------------------------------------------------------------------------------------------------------
--------------------------------------------------------------------------------------------------------------------------------------------------------------------------------------------------------
--------------------------------------------------------------------------------------------------------------------------------------------------------------------------------------------------------
--------S--S----S---------SS--------------------------U----U--------S-------S----S--------------------------S-SS-USS-------------S----S------S-S--------------------------------------------------------
------------C--C-------CC-----------------------------------C---------C--------------------------------------------------------------------------------------C------------------------------------------
--------------------------------------------------------------------------------------------------------------------------------------------------------------------------------------------------------
--------------------------------------------------------------------------------------------------------------------------------------------------------------------------------------------------------
--------------------------------------------------------------------------------------------------------------------------------------------------------------------------------------------------------
------------S--S--tt---SSS--S#-----C-U-----#---tt-----C----CS-#Ctt---UStt----CU--------CU---ttttU-tt-------------C--tt----Utt-#---#-U-----------------US-----S-----#----tt-----U------------------------
-tt---tt----------tt---------#tt------#---##-#-tt-------------#-tttt---tt---------tt--#--##-tttt--tt----------------tt-----tt-#---#--#----tt---------------------tt#----tttt----------------------------
-tt---tt----------tt--#------#tt-tt---##-###-#-tt--------tt--##-tttt---tt------#--tttt#--##-tttt--tt----------------tt-----tt-##--#--#----tt-------------tt---tt-tt#tttttttt----------------------------
-tt--gtt-#----g---tt#-#------#tt-tt-g-######k#kttk-g-g--#tt--##-ttttg--tt-kgg--#--tttt#--##gtttt--ttg-------g-g-----tt-k-g-ttg##gg#--#g-kkttg--gg-k-k----tt-g-tt#tt#ttttttttggg-gggggggggggggggggggggggF
-||-%|||%|%%%-|%-%|||-|%%%%%%|||%||%|%||||||||||||%|%|%-|||%%||%|||||%%||%|||%%|%-|||||%%|||||||%%|||%%--%%%|%|-%%%-||%|%|%||||||||%%||%|||||--||%|%|-%%%||%|%|||||||||||||||||%|||||||||||||||||||||||%
-||-|||||||||-||-||||-|||||||||||||||||||||||||||||||||-|||||||||||||||||||||||||-|||||||||||||||||||||--||||||-|||-|||||||||||||||||||||||||--||||||-||||||||||||||||||||||||||||||||||||||||||||||||||
