--------------------------------------------------------------------------------------------------------------------------------------------------------------------------------------------------------
--------------------------------------------------------------------------------------------------------------------------------------------------------------------------------------------------------
--------------------------------------------------------------------------------------------------------------------------------------------------------------------------------------------------------
--------------------------------------------------------------------------------------------------------------------------------------------------------------------------------------------------------
--------------------------------------------------------------------------------------------------------------------------------------------------------------------------------------------------------
-------------------SSUU-SSSS-----------S----------------------U------SS------S-------------------U-S---------S--S---------------S----U----------------SS----SSS-----------------------------------------
-----------------------------------------------------------C---------------------------------------------C----C--C------------------------C-------------------------------------------------------------
--------------------------------------------------------------------------------------------------------------------------------------------------------------------------------------------------------
--------------------------------------------------------------------------------------------------------------------------------------------------------------------------------------------------------
--------------------------------------------------------------------------------------------------------------------------------------------------------------------------------------------------------
-C--------------#-S--CC-----SS--tt---#S---ttCS--C----------S#-C---U--------CU-------------tttt---C-------S--C-S--SC-U------CC-#----C-C----S--------------ttU----------------------------tt--------------
------tt--------#---------------tt--##----tt--------------#-#-------#---------------------tttt-------tt---tt-----------tttt---#-------------------tttt---tt-------#-----tttttttttttttttttttttttttttttttt
------tt--------#--------------#tt-###----tt--------------#-#-------#---tt----------------tttt-tt----tt---tt-----------tttt---#----------#--------tttt---tt----##-##-###tttttttttttttttttttttttttttttttt
k-#g-gtt#g-k-g--#------#-g-g---#tt####--gktt--#---k-k-----#-#----#-g#gg-ttg---g---------#-tttt#tt---gtt---tt----------gtttt---#gg------#-#--g#g#ggtttt---tt----##-######tttttttttttttttttttttttttttttttF
|%||%|||||%|%|%%|%%%%%%|%|-|%%%|||||||%%||||%%|%%%|%|%%-%%|%|%%%%|%||||%|||%%%|--%%%--%%|%|||||||%%-|||-%%||%-%%%%%%%%|||||%%%|||-%%%%%|-|%-||||||||||--%||%%%%||-|||||||||||||||||||||||||||||||||||||%
||||||||||||||||||||||||||-||||||||||||||||||||||||||||-|||||||||||||||||||||||--|||--|||||||||||||-|||-|||||-|||||||||||||||||||-||||||-||-||||||||||--|||||||||-||||||||||||||||||||||||||||||||||||||
