--------------------------------------------------------------------------------------------------------------------------------------------------------------------------------------------------------
--------------------------------------------------------------------------------------------------------------------------------------------------------------------------------------------------------
--------------------------------------------------------------------------------------------------------------------------------------------------------------------------------------------------------
--------------------------------------------------------------------------------------------------------------------------------------------------------------------------------------------------------
--------------------------------------------------------------------------------------------------------------------------------------------------------------------------------------------------------
----B--BU---B-------B-----------UB-------B---U-----------B----------U--BB-----------------U-----B------------BB------------B------------------B--B------------------------------------------------------
----------------C-----------------C---------C-----C--------------------------------------C----------------------------------C----C--------------C-------------------------------------------------------
--------------------------------------------------------------------------------------------------------------------------------------------------------------------------------------------------------
--------------------------------------------------------------------------------------------------------------------------------------------------------------------------------------------------------
--------------------------------------------------------------------------------------------------------------------------------------------------------------------------------------------------------
#-------CB---B--B-tt------------C-B#-#U---CUBC#--#B--#--#--U--------CU-----------C---BUU-BC----------B-----tt-----U------CU-B----B-C-C----------B-U------------------tt---------------------------------
#-tt-------#------tt---------------#-#--------#tt#--##--#--------------------tt#----#-----------------tt#--tt-------tt--------------#---tt---#------------------#-###tt#####---#########################
#-tt-------#--tt--tt----------tt---#-#--------#tt#-###--#------------------#-tt#--#-#---#--tttt-------tt#--tt---tt--tt--------------#---tt--##--------------tttt#-###tt#####-tt#########################
#-ttggk----#--tt-ktt-g-k------tt-g-#g#-#k-----#tt#-###--#g---g-g---#----g--#ktt#--#-#---#--ttttkg---g-tt#g-tt---tt--ttk#----------k-#-k#tt-###-k-----k-k-g--tttt#-###tt#####gtt########################F
X-XXXXXXXX-X-XXXXXXX-XXXXX--XXXXXXXXXXXXXXXXXXXXXXXXXXXXXXXXXXXXXXXXXXX-XXXXXXXXXXX-XXXXXXXXXXXXXXXXXXXXXXXXXX-XXXXXXXXXXXXXXX-XXXXXXXXXXXXXXXXXX-XXXXXXXXXXXXXXXXXXXXXXXXXXXXXXXXXXXXXXXXXXXXXXXXXXXXXX
X-XXXXXXXX-X-XXXXXXX-XXXXX--XXXXXXXXXXXXXXXXXXXXXXXXXXXXXXXXXXXXXXXXXXX-XXXXXXXXXXX-XXXXXXXXXXXXXXXXXXXXXXXXXX-XXXXXXXXXXXXXXX-XXXXXXXXXXXXXXXXXX-XXXXXXXXXXXXXXXXXXXXXXXXXXXXXXXXXXXXXXXXXXXXXXXXXXXXXX
