--------------------------------------------------------------------------------------------------------------------------------------------------------------------------------------------------------
--------------------------------------------------------------------------------------------------------------------------------------------------------------------------------------------------------
--------------------------------------------------------------------------------------------------------------------------------------------------------------------------------------------------------
--------------------------------------------------------------------------------------------------------------------------------------------------------------------------------------------------------
--------------------------------------------------------------------------------------------------------------------------------------------------------------------------------------------------------
UU--------B--B----------B-U-----B---------UB-----------B-------B------------------B----B--B-----BB---BB-B-B---U------B--BB----B--U-----UB-----------B----U---B-------------B-UB-------------------------
-------------------------------C------------------------C---C--------C-------------------------------------------------------C----C---------------------------------------------------------------------
--------------------------------------------------------------------------------------------------------------------------------------------------------------------------------------------------------
--------------------------------------------------------------------------------------------------------------------------------------------------------------------------------------------------------
--------------------------------------------------------------------------------------------------------------------------------------------------------------------------------------------------------
CC-----C---tt--C-UC-UCC---CUC--B-U-----B#-C--#------#---B---B#--UCC--B--------B--B--Ctt------B-C---#B---------C-------------UB-U-CB#-#-C-----U----UU-----C#-#----------------C--------------------------
-----------tt------------#--------#-##--#----#-----##------#-#-----------------------tt----#--#---##-------------------------------#-#-----------------tt-#-#----tt-------------------------------------
------#--#-tt------------#---##---#-##--#----#-#--###----#-#-#---------#-----#-------tt--#-#--#---##-----#-----#--#---tt-----------#-#-----------------tt-#-#--tttt---------#------------tttttttttttttt-
----#-#--#-ttg-----g-----#---##-g-#-##--#----#-#g####--g-#-#-#-g-------#g-gg-#-------ttg##g#g-#-gg##-----#-k-k-#--#-g-tt------g----#-#----k-g-ggg#---k-tt-#-#-gttttg-g-k-k#-#-g##########ttttttttttttttF
XXXXX-XXXXXXXXXXXXXXXXXX-XXXXXXXXXXXXXXXX-X--X-XXXXXXX-XXX-XXXXXXXXXXX-XXXXXXXX-XXXXXXXXXXXXXXXXXXXXXXXXXXXXXXXXX-XXXXXX--XXXXXXXXXXXXXXX-XXXXXXXXXXXXXXXXXXX-XXXXXXXXXXXXXXXXXXXXXXXXXXXXXXXXXXXXXXXXXX
XXXXX-XXXXXXXXXXXXXXXXXX-XXXXXXXXXXXXXXXX-X--X-XXXXXXX-XXX-XXXXXXXXXXX-XXXXXXXX-XXXXXXXXXXXXXXXXXXXXXXXXXXXXXXXXX-XXXXXX--XXXXXXXXXXXXXXX-XXXXXXXXXXXXXXXXXXX-XXXXXXXXXXXXXXXXXXXXXXXXXXXXXXXXXXXXXXXXXX
