--------------------------------------------------------------------------------------------------------------------------------------------------------------------------------------------------------
--------------------------------------------------------------------------------------------------------------------------------------------------------------------------------------------------------
--------------------------------------------------------------------------------------------------------------------------------------------------------------------------------------------------------
--------------------------------------------------------------------------------------------------------------------------------------------------------------------------------------------------------
--------------------------------------------------------------------------------------------------------------------------------------------------------------------------------------------------------
-----------S------------U---S-U-----------S----------------SSS---------------S-----------------------U-----S-S--------------S-------------------------S-------------------------------------------------
---------------------------------------C----C---C-------C-----C-----------------C------------------------------------------------C----------------------------------------------------------------------
--------------------------------------------------------------------------------------------------------------------------------------------------------------------------------------------------------
--------------------------------------------------------------------------------------------------------------------------------------------------------------------------------------------------------
--------------------------------------------------------------------------------------------------------------------------------------------------------------------------------------------------------
-#C----C----------#-----Ctt---CUtt----CSC--CS-U-SCtt----S-S---S------U----------S-------#----------CSCSC-------------S-U-#---U---S-tt----UU------------Ctt----S-----------------------------------------
-#-------tt-#-----##---#-tt-----tt----------------tt------------------------------------#---#----tt----------------------#---------tt-------------tt----tt----------------------------------------------
-#--tt---tt-##-tt-##-#-#-tt--#--tt----------------tt-----------#-#------------#-----#---#tt##--#-tt----------------------#tt--#----tt------#------tt----tttttt-tttttttttttttttt--tttttttttttttttttttttt-
##-#tt--gtt-###tt-##-#-#-ttk-#--tt-g-----------#--ttgg---------#k#g-g-k-------#k--k-#---#tt###-#ktt-----g---ggk-k--------#tt--#----ttg--g--#-g-g-ktt-gg-tttttt-tttttttttttttttt--ttttttttttttttttttttttF
||%|||%%|||%|||||%||%|-|%|||-|%%||%|%%%%%%%%%%%|%%||||%%%-%---%||||-|%|%%--%%%||%%|%|%%%||||||-||||%%%%%|-%%|||%|%%%%%%%%|||-%|-%%%|||%%|%%|%|%|%|||%||%||||||%||||||||||||||||%%||||||||||||||||||||||%
||||||||||||||||||||||-|||||-||||||||||||||||||||||||||||-|---|||||-|||||--|||||||||||||||||||-||||||||||-||||||||||||||||||-||-||||||||||||||||||||||||||||||||||||||||||||||||||||||||||||||||||||||||
