--------------------------------------------------------------------------------------------------------------------------------------------------------------------------------------------------------
--------------------------------------------------------------------------------------------------------------------------------------------------------------------------------------------------------
--------------------------------------------------------------------------------------------------------------------------------------------------------------------------------------------------------
--------------------------------------------------------------------------------------------------------------------------------------------------------------------------------------------------------
--------------------------------------------------------------------------------------------------------------------------------------------------------------------------------------------------------
B---BB-----------B-B--B--------------U--B---BB-----B--------U----B-----------------------------B--B------------U----------U-----------B----------BB----------B-----------------U-----BBU----------------
----------------------------------------------------------C---------------------------C----C------------------------------------------------------------------------------------------------------------
--------------------------------------------------------------------------------------------------------------------------------------------------------------------------------------------------------
--------------------------------------------------------------------------------------------------------------------------------------------------------------------------------------------------------
--------------------------------------------------------------------------------------------------------------------------------------------------------------------------------------------------------
------B#--B-------C--C------tt------UC-----B-----C--#----#B-CU#---tt---B------------U-BUU--B-----C-------------C----U-----C-----B----------B--U-B---C------tt-tt------BB--U-#-BC---U---C----------------
-tt----#----#---#-----------tt----tt----------------##tt-#----#---tt----tt#-------------------------------tt------------------#----------------------#-----tt-tt----tt------#-----#---------------------
-tt----#tt--#-#-#---------tttt----tt--tt--------#---##tt-#----#tt-tt#---tt#---------------------#------tt-tt------tt--#-------#----------tt----------##---#tt-tttt--tt-----##-----#--------#------------
gttkg--#tt-##-#-#g-----g-gttttg#k-tt--tt-------k#-g-##tt-#-g--#ttgtt#---tt#----g-k-g-#--------k-#--k-k#tt-ttkg--g-tt-g#ggk-g--#g-----k-ggtt--#-g-----###--#tt-tttt--tt--g--##k--g-#-g-g--#-#-----------F
XXXXXXXXXXXXX-X-XXXXXX-XXXXXXXXXXXXXXXXX-XXXXXXXXXXXXXXXXXXXXXXXXXXXXXXXXXXXXXXXXXXXXXXXX-XX-XX-XX-XXXXXXXXXXXXXX-XXXXXXXXXXXXXXXXX-XXXXXXXXXXXXX--XXXXXXXXXXXXXXXXXXXXXX-XXXXXXXXXXXXXX-X-XXXXXXXXXXXXX
XXXXXXXXXXXXX-X-XXXXXX-XXXXXXXXXXXXXXXXX-XXXXXXXXXXXXXXXXXXXXXXXXXXXXXXXXXXXXXXXXXXXXXXXX-XX-XX-XX-XXXXXXXXXXXXXX-XXXXXXXXXXXXXXXXX-XXXXXXXXXXXXX--XXXXXXXXXXXXXXXXXXXXXX-XXXXXXXXXXXXXX-X-XXXXXXXXXXXXX
