--------------------------------------------------------------------------------------------------------------------------------------------------------------------------------------------------------
--------------------------------------------------------------------------------------------------------------------------------------------------------------------------------------------------------
--------------------------------------------------------------------------------------------------------------------------------------------------------------------------------------------------------
--------------------------------------------------------------------------------------------------------------------------------------------------------------------------------------------------------
--------------------------------------------------------------------------------------------------------------------------------------------------------------------------------------------------------
----------B-BU--------BB-----B--------------------B-UB--B--------------BB---------BB----------------------BB-----B---------------------B-B--------U-----------------------------------------------------
----------------------------------------------------------C-C-----C-------------------------------------------------------------------------------------------------------------------------------------
--------------------------------------------------------------------------------------------------------------------------------------------------------------------------------------------------------
--------------------------------------------------------------------------------------------------------------------------------------------------------------------------------------------------------
--------------------------------------------------------------------------------------------------------------------------------------------------------------------------------------------------------
--------C----C---#-#tt-----C#------------U-#tt------C----CB#B---UBBU--B--#C---B-C---B-B--CC-tt--------------B-----C--------------------------UC-#-CB----------tt-ttttttUtttttttttttttttttttttttttttttttt
----------------##-#tt--#---#--------------#tt-------------#-------------#-----------------#tt------tttttt-----#----#-----#-----#-tt-tt-#-------#-------------tt-tttttt-tttttttttttttttttttttttttttttttt
#------#-------###-#tt--#tt-#----------tt--#tt-tt#---------#-------------#-------#------#--#tt------tttttt----##----#---tt##--#-#-tt-tt-#-------#---#---------tt-tttttt-tttttttttttttttttttttttttttttttt
#g--g-g#------####g#tt-g#tt-#g-#---g-kgtt--#tt-tt#gk-g-----#--g----------#-ggk-k-#g--g--#--#ttk-g---tttttt----##----#-gktt###-#-#-tt-tt-#---#--g#---#------k-kttgtttttt-tttttttttttttttttttttttttttttttF
XX-XXXXXXXXX-XXXXXXXXX-XXXXXXXXXXXXXXXXXXXXXXX-XXXXXXX-XXXXXX-XXXXXXX-XXXXXXXXXXXXX-XXXXXXXXXXXXXXX-XXXXXX--XXXXXXXXX-XXXXXXX-X-X-XXXXXXX--XXXXXXXXXXXX--XXXXXXXXXXXXXXXXXXXXXXXXXXXXXXXXXXXXXXXXXXXXXXX
XX-XXXXXXXXX-XXXXXXXXX-XXXXXXXXXXXXXXXXXXXXXXX-XXXXXXX-XXXXXX-XXXXXXX-XXXXXXXXXXXXX-XXXXXXXXXXXXXXX-XXXXXX--XXXXXXXXX-XXXXXXX-X-X-XXXXXXX--XXXXXXXXXXXX--XXXXXXXXXXXXXXXXXXXXXXXXXXXXXXXXXXXXXXXXXXXXXXX
