--------------------------------------------------------------------------------------------------------------------------------------------------------------------------------------------------------
--------------------------------------------------------------------------------------------------------------------------------------------------------------------------------------------------------
--------------------------------------------------------------------------------------------------------------------------------------------------------------------------------------------------------
--------------------------------------------------------------------------------------------------------------------------------------------------------------------------------------------------------
--------------------------------------------------------------------------------------------------------------------------------------------------------------------------------------------------------
-B---BB--------B------------------B--------B-B----------BBUU---BB--------------------------------------B---BU-----B---B--BB--------------U-----------------B----B---------------------------------------
---------------------------------C------------------------------------------------------CC-------------------------------------------------------------C---------C-C-C-CCCCC-C--C-C-C-------------------
--------------------------------------------------------------------------------------------------------------------------------------------------------------------------------------------------------
--------------------------------------------------------------------------------------------------------------------------------------------------------------------------------------------------------
--------------------------------------------------------------------------------------------------------------------------------------------------------------------------------------------------------
--Utt--#-----tt------#C------B---B--U---C---U---------tt--CC-tt------B----#------------BBB--------------B---Ctt------U-UB---#-----------UC---BC--------B#---B----B-BBBBBBBBB-B--B-B-B-------------------
---tt--#-----tt-----##---------------#----------------tt-----tt--------#--#tt---#---------------#------------tt-------------#--tt#----------------------#----tt-----------------------------------------
---tt--#-----tt----###--#------tt----##---#---tt-tt-tttt----#tt--#-----#--#tt-#-#-----------#tt-#-----#--tt--tt----tt-------#--tt##--------#------------#tt--tt-----------------------------------------
---tt--#g-k--tt-k-####-g#g-----tt--g-###--#g--tt-ttgtttt-g--#ttgg#gk---#-g#tt##-#----------g#ttg#-#-#-#--tt--ttk-k-tt------k#--tt##-g------#----g-k-g---#tt--ttk---------------------------------------F
XXXXX--XXXXXXXX-XXXXXXXXXXXXXXXXXXXXXXXXXXXXX-XX-XXXXXXX-XXXXXXXXXXXXXXXXXXXXXX-XX--XXXXXXXXXXXXXXXXX-X-XXX-XXXXXX-XXX-XXXXXXXXXXXXXXXXXXXXX-XX-X-XXXXXXXXXXXXXXXXXXXXXXXXXXXXXXXXXXXXXXXXXXXXXXXXXXXXXX
XXXXX--XXXXXXXX-XXXXXXXXXXXXXXXXXXXXXXXXXXXXX-XX-XXXXXXX-XXXXXXXXXXXXXXXXXXXXXX-XX--XXXXXXXXXXXXXXXXX-X-XXX-XXXXXX-XXX-XXXXXXXXXXXXXXXXXXXXX-XX-X-XXXXXXXXXXXXXXXXXXXXXXXXXXXXXXXXXXXXXXXXXXXXXXXXXXXXXX
