--------------------------------------------------------------------------------------------------------------------------------------------------------------------------------------------------------
--------------------------------------------------------------------------------------------------------------------------------------------------------------------------------------------------------
--------------------------------------------------------------------------------------------------------------------------------------------------------------------------------------------------------
--------------------------------------------------------------------------------------------------------------------------------------------------------------------------------------------------------
--------------------------------------------------------------------------------------------------------------------------------------------------------------------------------------------------------
------S--------S----S------SS-----------U---------------S----US------S---S-U-------------------------------S---U-----S--------S-----------S------------U-------------------U----------------------------
-----C-------------------C----C-----------------------------------------C-------------------------------------------------------------------------------------------------------------------------------
--------------------------------------------------------------------------------------------------------------------------------------------------------------------------------------------------------
--------------------------------------------------------------------------------------------------------------------------------------------------------------------------------------------------------
--------------------------------------------------------------------------------------------------------------------------------------------------------------------------------------------------------
-----S-------------C-----SS---S-----ttC-C-C-------#------#tt#C--S-----U-S-UC----------#-CC-#----------------tt-C----C----------U-C-tt--S---S----tt-----C-#U---tt-----------C--U-------------------------
--------#--------tt------------#----tt-----tt-tt--#------#tt#-----------------tt-----##----#----------------tt--------------------#tt---------tttt-tt----#-tt-tttt--------------------------------------
---tt---#---#tt--tt------------##---tt-----tt-tt--#------#tt#---------------tttt-----##----#--------------#-tt----------tt#-------#tt---tt----tttt-tt----#-tt-tttt--------------------------------------
---tt---#-#-#tt--tt-g-k-k------###--tt-----tt-tt--#g-g---#tt#-----g#-g-g----tttt#----##----#---------k-g-k#-tt----##-g#-tt#gg---g-#tt-g-tt----tttt-tt#---#-ttgtttt--g----------g-----------------------F
%-%||%-%|%|-|||-%||%|%|%|%%--%%|||--||%%%%%||%||%%||%|%%-||||%%%%%||%|%|%-%%|||||%%%%||%%%%|%%-%%--%%|%|%||%||%%%%||%||%|||||%%%|%|||%|%||-%%%||||%|||%%%|%|||||||%%|------%--%|%----------------------%
|-||||-||||-|||-|||||||||||--|||||--||||||||||||||||||||-||||||||||||||||-||||||||||||||||||||-||--|||||||||||||||||||||||||||||||||||||||-||||||||||||||||||||||||||------|--|||----------------------|
