--------------------------------------------------------------------------------------------------------------------------------------------------------------------------------------------------------
--------------------------------------------------------------------------------------------------------------------------------------------------------------------------------------------------------
--------------------------------------------------------------------------------------------------------------------------------------------------------------------------------------------------------
--------------------------------------------------------------------------------------------------------------------------------------------------------------------------------------------------------
--------------------------------------------------------------------------------------------------------------------------------------------------------------------------------------------------------
--SS-S---SS---S--------S--------------------S----------------S--SS------------------------U-SS--S--S-S-U---------------S---------S------------------UUUU--UUUUUU--U-UUUUUUUUUUUU--UUUUUUUUUUUUUUUUUUUUUU
------------------------C---------------------------C------------------------------C-------------C---------C--------------C-C-C---------C---------------------------------------------------------------
--------------------------------------------------------------------------------------------------------------------------------------------------------------------------------------------------------
--------------------------------------------------------------------------------------------------------------------------------------------------------------------------------------------------------
--------------------------------------------------------------------------------------------------------------------------------------------------------------------------------------------------------
----U------#---U--------S------------#--------tt----S--#-------S---#--tt----------CS------C---tt-S-----C---S-------------CSSSSS-----S---S-------tt--CCCC--CCCCCC--C-CCCCCCCCCCCC#-CCCCCCCCCCCCCCCCCCCCCC
-------tt--#------------------tt----##--------tt---#---#------#----#--tt----------------------tt------#-tt----------------------------------#---tt------------------------------##----------------------
tt-----tt--#-------tt----tttt-tt---###--------tt---#---#---tt-#---##--tt-tt-tt---#------------tt------#-tt#---#---------#---------tt--tt--#-##--tt------tt----------------------##----------------------
tt---g-tt--##----#-tt-k--tttt#tt##-###g-k-----tt--k#---#--#ttg#---##--tt-tt-tt---#--k-g-g--g-gtt--kg-g#-tt#-gk#---------#---------tt-#tt--#-###-tt-g----tt----------------------##---------------------F
||--%|-||%-||%-%%|%||%|%%|||||||||-||||%|%%%%%||%-||%%%|%-|||||%%%||%%||%||%||%%%|%%|%|%|%%|-|||-%||%||%|||%|||%%--%%%%%|%%%%%%%%-||%|||%%|-|||%||%|%%%%||%%%%%%%%%%%%%%%%%%%%%%||%%%%%%%%%%%%%%%%%%%%%%
||--||-|||-|||-|||||||||||||||||||-||||||||||||||-|||||||-||||||||||||||||||||||||||||||||||-|||-||||||||||||||||--||||||||||||||-|||||||||-||||||||||||||||||||||||||||||||||||||||||||||||||||||||||||
