--------------------------------------------------------------------------------------------------------------------------------------------------------------------------------------------------------
--------------------------------------------------------------------------------------------------------------------------------------------------------------------------------------------------------
--------------------------------------------------------------------------------------------------------------------------------------------------------------------------------------------------------
--------------------------------------------------------------------------------------------------------------------------------------------------------------------------------------------------------
--------------------------------------------------------------------------------------------------------------------------------------------------------------------------------------------------------
-S----S----------SS-------S--S-S---S---SSS-S----------------------S----------S--------SS----SSU----------S--S-U------S---------------S--------------------SSU--------------SS---------------------------
-----------------------------------------------------------C------------C-------------------------------------------------------------C-----------------------------------------------------------------
--------------------------------------------------------------------------------------------------------------------------------------------------------------------------------------------------------
--------------------------------------------------------------------------------------------------------------------------------------------------------------------------------------------------------
--------------------------------------------------------------------------------------------------------------------------------------------------------------------------------------------------------
U-tt----------#US---C-SU--------------------U#-ttS--------#SS------C-U--S--------#C-#------U--C-S-C----tt-----Ctt---------#------#----S----#----------C-C---C--C--SS------S--S----ttCCCCCCCCCCCCCCCCCCCC
--tt----#-tt--#---------tt-------tt---#------#-tt------#--#-------------------#tt#--#------------------tt-#----tt--tt----##----#-#---------#---------#-------tt------------------#tt--------------------
--tt#---#-tt--#---------tt-tt---#tt---#------#-tt------##-#---------#-----tt--#tt#--#------------------tt-#----tt--tt---###--#-#-#---------#--#------#-------tt-tt-----#---------#tt--------------------
--tt#--k#-tt#-#----g-g--tt-tt-kg#tt--g#g-g-g-#-tt-g-g-k####--k-k-gg-#-g#--tt-g#tt#--#k-g-g--g----------tt-#----tt-gtt-k####k-#-#-#--k---gg-#--#g#-kg-#----g--tt-tt--##-#gg-----g-#tt-------------------F
%-|||--||%|||%|%%%%|%|%%||%||-|||||%%|||%|%|%|-||%|%|%|||||%%|%|%||%|%||%%||-|||||%%||%|-|%%|-%-%%%%%%-||%|%-%%||%|||%||||||%|-|%|%%|-%%||%|%%|||%||%|%%%%|-%||%||%%||-|||%--%%|%|||%%%%%%%%%%%%%%%%%%%%
|-|||--||||||||||||||||||||||-||||||||||||||||-|||||||||||||||||||||||||||||-|||||||||||-||||-|-||||||-|||||-|||||||||||||||||-||||||-|||||||||||||||||||||-||||||||||-||||--|||||||||||||||||||||||||||
