--------------------------------------------------------------------------------------------------------------------------------------------------------------------------------------------------------
--------------------------------------------------------------------------------------------------------------------------------------------------------------------------------------------------------
--------------------------------------------------------------------------------------------------------------------------------------------------------------------------------------------------------
--------------------------------------------------------------------------------------------------------------------------------------------------------------------------------------------------------
--------------------------------------------------------------------------------------------------------------------------------------------------------------------------------------------------------
------B---------------------BB-BBB---------B--U-------B--BB--B---B--B--B--U-B----B-B---B-U--------U-U----B-B--B-----------BB------------B-U----B--------------------------------------------------------
C---C------------------------------C---------------------------------C---------------------------------------------------C-----C--CC--------------------------------------------------------------------
--------------------------------------------------------------------------------------------------------------------------------------------------------------------------------------------------------
--------------------------------------------------------------------------------------------------------------------------------------------------------------------------------------------------------
--------------------------------------------------------------------------------------------------------------------------------------------------------------------------------------------------------
B---B----tt-----B---------U---B----B-#--------C------------U--tt-----B--B-C----B--U------C--B-B---C-C#--#-----------tt#--B--tt-B-UBB#C----C-----------#-tt-tt#------------------------------------------
-tt----tttt--------------------------#------#----tt-tt--------tt-----------#----#--------------------#--#-----------tt#-----tt------#------tt--------##-tt-tt#-----------#------------------------------
-tt----tttt#tttt---------------------#------#----tt-tt--------tt--tt-------#-tt-#-----#--------------#--#-----------tt#-----tt------#-tt---tt-#-----###-tt-tt#---------#-#--------------#---------------
-tt----tttt#tttt-k-g--g-g---------#-##gg-g--##---ttgtt-k--g--gtt-gtt--kg-g-#gtt-#---#-#----#-#-g-k---#--#-------k---tt#----gttk-#---#-ttg--ttg#gk-k####gtt-tt#-gggggggg#-#ggggggggggggg-#gggggg--------F
XXXXXXXXXXXXXXXXXXXXXXXXXXXX-XX---XXXXXXXXX-XXXXXXXXXXXXX-XX-XXXXXXXXXXXXXXXXXXXX-XXX-XXXXXXXXXXXXXXXXXXX-X-XX-XXXXXXXXXXX-XXXXXXXXXXXXXX-XXXXXXXXXXXXXXXXXXXX-XXXXXXXXX-XXXXXXXXXXXXXXXXXXXXXXXXXXXXXXX
XXXXXXXXXXXXXXXXXXXXXXXXXXXX-XX---XXXXXXXXX-XXXXXXXXXXXXX-XX-XXXXXXXXXXXXXXXXXXXX-XXX-XXXXXXXXXXXXXXXXXXX-X-XX-XXXXXXXXXXX-XXXXXXXXXXXXXX-XXXXXXXXXXXXXXXXXXXX-XXXXXXXXX-XXXXXXXXXXXXXXXXXXXXXXXXXXXXXXX
