--------------------------------------------------------------------------------------------------------------------------------------------------------------------------------------------------------
--------------------------------------------------------------------------------------------------------------------------------------------------------------------------------------------------------
--------------------------------------------------------------------------------------------------------------------------------------------------------------------------------------------------------
--------------------------------------------------------------------------------------------------------------------------------------------------------------------------------------------------------
--------------------------------------------------------------------------------------------------------------------------------------------------------------------------------------------------------
----B-------------------U-----------------------------B-U-U-------B---B--------------B----U---------------------B-----------------------BU------------------------------B------------------U------------
--------------C-----------------------------------------------------------C------------C------------------------------C------------C------------------------C-CCCCC-CC-C-C--C-C-CC----------------------
--------------------------------------------------------------------------------------------------------------------------------------------------------------------------------------------------------
--------------------------------------------------------------------------------------------------------------------------------------------------------------------------------------------------------
--------------------------------------------------------------------------------------------------------------------------------------------------------------------------------------------------------
------tt------B#-C-ttBCBCBC--C--------------C--tt------BC-C----#--------C-B--tt-U------B--C-------U-tt--------#-------B-----U---C-UB-----C------B-----------B-BBBBBCBBCB-BCCBCBCBBUCCCCCCC-C-CCCCCCCCCCC
------tt-------#---tt---------#----------------tt-#--------#---#-----#-----tttt----------------tt---tttt-----##--------#--------------------------tt--tt------------------------------------------------
------tt-------#---tt---------#-#tt-----------#tt-#--------##--#----##-----tttt----#---------tttt---tttt----###--tt----#tttt-##-------tt----------tt--tt------------------------------------------------
---g--tt#----k-#--#tt------g--#g#tt------k-g-##tt-#------k-###g##k-###---#-tttt--#-#g---#----ttttk--ttttg-g-####-ttg-k-#tttt-##-------tt---kg##g-#ttk-ttk-k--#-----------------------------------------F
XXXXX-XXXXXXXXXX-XXXXXXXXXXX-XXXXXXX--XXXXXXXXXXXXXXX--XXXXXXXXXXX-XXX-XXXXXXXXXXX-XXXXXX-X-XXXXXXXXXXXXXXXXXXXX-XXXXXXXXXXXXXXXXXXXXXXX-XXXXXXXXXXXXXXXXXXXXXXXXXXXXXXXXXXXXXXXXXXXXXXXXXXXXXXXXXXXXXXX
XXXXX-XXXXXXXXXX-XXXXXXXXXXX-XXXXXXX--XXXXXXXXXXXXXXX--XXXXXXXXXXX-XXX-XXXXXXXXXXX-XXXXXX-X-XXXXXXXXXXXXXXXXXXXX-XXXXXXXXXXXXXXXXXXXXXXX-XXXXXXXXXXXXXXXXXXXXXXXXXXXXXXXXXXXXXXXXXXXXXXXXXXXXXXXXXXXXXXX
