--------------------------------------------------------------------------------------------------------------------------------------------------------------------------------------------------------
--------------------------------------------------------------------------------------------------------------------------------------------------------------------------------------------------------
--------------------------------------------------------------------------------------------------------------------------------------------------------------------------------------------------------
--------------------------------------------------------------------------------------------------------------------------------------------------------------------------------------------------------
--------------------------------------------------------------------------------------------------------------------------------------------------------------------------------------------------------
----------------S--U-SS---------U--------------------------S-S-S---SS-S----------U-------S--SS--S---SS---S-S------------------S-----------SU---------------------S--------------------------------------
-----------------------------------------------------------------------------------------------C----------------------------------C----------------------------------------------CC-C--------C----------
--------------------------------------------------------------------------------------------------------------------------------------------------------------------------------------------------------
--------------------------------------------------------------------------------------------------------------------------------------------------------------------------------------------------------
--------------------------------------------------------------------------------------------------------------------------------------------------------------------------------------------------------
C--------tt--------C---S--------Ctt--U--S--------C--U---#tt-U-----S--U-UU----#---C--------U#--#S--US--------tt-S-----------C------SS-------C-------tt--#S----C----C-S------------SS-S--------S----------
-tt---tt-tt----------------------tt---------------#-----#tt--------------tt-##-----tt--tt--#--#--#----------tt--------------------------tt----#tt--tt--#---tt-#-----------------------------------------
-tt-tttt-tt#------------------#--tt------------tt-#--tt-#tt--------------tt###-----tt-#tt--#--#--#----------tt--------------tt------tt--tt--#-#tttttt--#---tt-#-----------------------------------------
-tt-ttttgtt##g-k--#-k----k-g--#--ttg------k-k--tt-#--tt-#ttg-gkg------g--tt###----#tt-#ttg-#-g#-g#-------g--ttk-g---------k-ttg-g---tt--ttg-#-#ttttttkg#---tt-#------k-g-g-gg-gkg--g-gggggggg-gggggggggF
%||-||||||||||%|-%|%|%-%-|%|%%|%%|||%%%%%%|%|%%||%|%%||%||||%|||%%%%%%|%%|||||%%-%|||%||||%|%||%||%%---%%|%-|||%|%%%%--%%-|%|||%|%%%||%%|||%|-||||||||||%%-||%|-%-%%%|%|%|%||%|||%%|%||||||||%|||||||||%
|||-||||||||||||-|||||-|-|||||||||||||||||||||||||||||||||||||||||||||||||||||||-|||||||||||||||||||---||||-|||||||||--||-|||||||||||||||||||-||||||||||||-||||-|-||||||||||||||||||||||||||||||||||||||
