--------------------------------------------------------------------------------------------------------------------------------------------------------------------------------------------------------
--------------------------------------------------------------------------------------------------------------------------------------------------------------------------------------------------------
--------------------------------------------------------------------------------------------------------------------------------------------------------------------------------------------------------
--------------------------------------------------------------------------------------------------------------------------------------------------------------------------------------------------------
--------------------------------------------------------------------------------------------------------------------------------------------------------------------------------------------------------
-----B---B-----------------BBBB----BU----B---BBU------U-----U--U-------U----------------------BBU--B-----U---B-B-------BUB--B---B-----------------BBU-----------------B---------------------------------
---------------------------------------------------------C-----------------------------------------------------------------------C----------------------------------------------------------------------
--------------------------------------------------------------------------------------------------------------------------------------------------------------------------------------------------------
--------------------------------------------------------------------------------------------------------------------------------------------------------------------------------------------------------
--------------------------------------------------------------------------------------------------------------------------------------------------------------------------------------------------------
BC--------tt--#---C-----------------C----------C------C--BCCCU-C---B-CBCBC-U--U--#tt---C-----B--C--------C------#C------C-----U--B-UC-----#-#-C--B--C----CCBB-C----------#------------------------------
----------tt--#------#---------tt----tt-----#------------------------------------#tt-------#--------------------#------------------------##-#------------------tt--------#------------------------------
----#-tt--tt#-#tt#---##--------tt----tttt-#-#----------tt-------#-----------tt--##tt-tt----##----tt-------------#--------------#------tt###-#--tt------tt------tt-tttt-tt#tttttttt-tttttttttttttttttttt-
--#-#-ttg-tt###tt#-g-###-k-gg-gtt--g-ttttg#-#---k-g-g#-tt-------#-----------tt-g##tt-tt--g-##----tt-----g-------#-g-k-k--g#g-g-#-----gtt#####g-tt----g-tt------ttktttt-tt#tttttttt-ttttttttttttttttttttF
XXX-XXXXX-XXXXXXXXXX-XXXXXXXX-XXXXXXXXXXXXX-X-XXXXXXXXXXXXXXXXXXX-XXXXXXXXXXXXXXXXXXXXXXXXXXXXXXXXX--XXXXX-X-XXXXXXXXXX-XXXX-XXXXXXXXXXXXXXXXXXXXX--XXXXXXXXXXXXXXXXXXXXXXXXXXXXXXXXXXXXXXXXXXXXXXXXXXXX
XXX-XXXXX-XXXXXXXXXX-XXXXXXXX-XXXXXXXXXXXXX-X-XXXXXXXXXXXXXXXXXXX-XXXXXXXXXXXXXXXXXXXXXXXXXXXXXXXXX--XXXXX-X-XXXXXXXXXX-XXXX-XXXXXXXXXXXXXXXXXXXXX--XXXXXXXXXXXXXXXXXXXXXXXXXXXXXXXXXXXXXXXXXXXXXXXXXXXX
