--------------------------------------------------------------------------------------------------------------------------------------------------------------------------------------------------------
--------------------------------------------------------------------------------------------------------------------------------------------------------------------------------------------------------
--------------------------------------------------------------------------------------------------------------------------------------------------------------------------------------------------------
--------------------------------------------------------------------------------------------------------------------------------------------------------------------------------------------------------
--------------------------------------------------------------------------------------------------------------------------------------------------------------------------------------------------------
U----------BB-----------B----U-----------B-------------U----------------BU----------------B---------BB---B---------------B--BU------BB-----------U--------------B-B-B-BB------B-------------------------
-------------CCC------------C---------C----------------------------------------C-----------------------C--------------------------------C---------C-----------------------------------------------------
--------------------------------------------------------------------------------------------------------------------------------------------------------------------------------------------------------
--------------------------------------------------------------------------------------------------------------------------------------------------------------------------------------------------------
--------------------------------------------------------------------------------------------------------------------------------------------------------------------------------------------------------
C------B-----BBB--C-tt------BC------B#B-C------------CBCBC--------C-U-C--C--C--B----ttBC---tt-C-B--B---B--tt---tt--tt-#------C---BB---UBB-tt-----CB--------B-----B--------------------------------------
---------tt-----tt--tt----------#----#-------tt-----------------------------------#-tt-----tt-----------#-tttt-tt--tt-#-------------------tt-------tt-------tt------------#---------####################
---tttt--tt-----tt--tt----#-----##---#-------tt#---------------tt#---#----------#-#-tt--#--tt#----------#-tttt-tttttt-#------------------#tt-#-----tt-------tt------------#---------####################
--gtttt-gttg----tt--tt#-gg#---k####--#-#--#--tt#k-g---------k--tt#---#-#--------#-#-tt--#-gtt#-k------g-#gttttktttttt-#--g---------#-----#tt-#-gg--tt#g-k-k-tt##g---g-gg-g#gg-gkkkkk###################F
XXXXXXXXXXXX-XXXXXXXXXXXXXXXXXXXXXXXXXXXXXXXXXXXXXXXXXXXXXXXX-XXXXXXXXXXXX-XXXXXX-XXXXXXXXXXXXXXXX-X--XXXXXXXXXXXXXXXXXXXXXXXXXXXXXX-XXXXXXX-X-XXXXXXXXXXXXXXXXXXX-XXXXXXXXXXXXXXXXXXXXXXXXXXXXXXXXXXXXX
XXXXXXXXXXXX-XXXXXXXXXXXXXXXXXXXXXXXXXXXXXXXXXXXXXXXXXXXXXXXX-XXXXXXXXXXXX-XXXXXX-XXXXXXXXXXXXXXXX-X--XXXXXXXXXXXXXXXXXXXXXXXXXXXXXX-XXXXXXX-X-XXXXXXXXXXXXXXXXXXX-XXXXXXXXXXXXXXXXXXXXXXXXXXXXXXXXXXXXX
