--------------------------------------------------------------------------------------------------------------------------------------------------------------------------------------------------------
--------------------------------------------------------------------------------------------------------------------------------------------------------------------------------------------------------
--------------------------------------------------------------------------------------------------------------------------------------------------------------------------------------------------------
--------------------------------------------------------------------------------------------------------------------------------------------------------------------------------------------------------
--------------------------------------------------------------------------------------------------------------------------------------------------------------------------------------------------------
--------B-B---------B---------BB-----B-----------------B-----B---B---------------------B-------------------B----------------B------B-------UB--------BB---B-B---B-----------------BBBBBBBBBBBBBBBBBBBBBB
C-----C--------------------------C-----------------------------C-------------------------CC--------------------------------C--------C-------------------------------------------------------------------
--------------------------------------------------------------------------------------------------------------------------------------------------------------------------------------------------------
--------------------------------------------------------------------------------------------------------------------------------------------------------------------------------------------------------
--------------------------------------------------------------------------------------------------------------------------------------------------------------------------------------------------------
B-----B--C-----------U-tt-tttt---B--B---------------tt------U--BC--tt--U-C--------------CBB--BB-tt----#--B---Btt----BB---#-B-B--C---B-CC-#UC--C----BB--#---U--tt------#----U----------------------------
------------tt-----#--#tt-tttt----#-----------#-----tt-------------tt----------------#----------tt---##---#---tt---------#-------tt------#-------------#------tt---#--#--#------------------------------
--tttt------tt--tt-#--#tt-tttt----#-------#--###----tt-------------tt--------------#-#----------tt#-###---#---tttttt--#-##-------tt------#-------------#------tt---#--#--#------------------------------
--tttt----g-tt--tt-#--#tt-tttt--k-#-----#-#k#####g--tt---k-k-------ttg--#-k-g-g----#-#gg---g#--#tt#-###---#g--tttttt--#k##g------ttg-----#---g--gkk----#------tt---#gg#--#g--g-kgg----------g----------F
XXXXXXX-XXXXXXX-XXXXXXXXXXXXXXXXXXXXXXXXX-XXXXXXXXXXXXX-XXXXX--XXXXXXXXXXXXXXXXXXXXX-XXXXXXXXXXXXXXXXXXXXXXXXXXXXXXXXXXXXXXXXXXXXXXXXXXXXXXX-XX-XXXXX--X-X-X--XX-X-XXXX-XXXXXXXXXXXXXXXXXXXXXXXXXXXXXXXX
XXXXXXX-XXXXXXX-XXXXXXXXXXXXXXXXXXXXXXXXX-XXXXXXXXXXXXX-XXXXX--XXXXXXXXXXXXXXXXXXXXX-XXXXXXXXXXXXXXXXXXXXXXXXXXXXXXXXXXXXXXXXXXXXXXXXXXXXXXX-XX-XXXXX--X-X-X--XX-X-XXXX-XXXXXXXXXXXXXXXXXXXXXXXXXXXXXXXX
