--------------------------------------------------------------------------------------------------------------------------------------------------------------------------------------------------------
--------------------------------------------------------------------------------------------------------------------------------------------------------------------------------------------------------
--------------------------------------------------------------------------------------------------------------------------------------------------------------------------------------------------------
--------------------------------------------------------------------------------------------------------------------------------------------------------------------------------------------------------
--------------------------------------------------------------------------------------------------------------------------------------------------------------------------------------------------------
--------SS---SS---S---------U--------S--------S------S--S-------------S-S------U----US---------S-------U---S----S---S-U---SS-S-S---------------S----------------------S---------------------------------
----------C--------------C-----------------------C------------------------------------------------------------------------------------------C----------C------------------C-C---------------------------
--------------------------------------------------------------------------------------------------------------------------------------------------------------------------------------------------------
--------------------------------------------------------------------------------------------------------------------------------------------------------------------------------------------------------
--------------------------------------------------------------------------------------------------------------------------------------------------------------------------------------------------------
---tt-U#--S-S--ttU-tt----S--C#----U-S-C----------S-#-------tttt-------------tt-C----C-C----------------CC#--tt---S-#-CC--S------Ctt---tt---#SC-------C-S---------U-------SSSSSSSS-SSS--tt---------------
---tt--#-------tt--tt-#------#---------------------#-------tttt-----tt-#---#tt---------------------------#--tt-----#-------------tt#--tt--##-------tt----------------------------------tt----#----------
---tt--#-------tt--tt-#---tt-#---------tt-------#--##-tt---tttt#----tt-#-#-#tt---tt----------#-----------#--tt----##----------#--tt##-tt-###-------tt----------------------------------tt----#----------
---ttg-#-------tt--tt-#---tt-#--#------tt#-k-kgg#--##-tt-k-tttt#g-gkttg#g#-#tt---ttg---##---g#gg-g-kg#k--#-gtt----##g--gg-----#--tt###tt####---gk--tt---g-k-g---g---k-gg---------------tt----#---------F
-%%|||%|-%%-%%%||%-||%|%%%||%|%%|%%%%%%|||%|%||||%%||%||-|%||||||%||||||||-|||%%%|||%%%||%%%||||-|-||||%%|%|||%-%%|||%%||%--%-|%%|||||||||||%%%||%-||%-%|%|%|%%%|%-%|%||%%%%%%%%%%%%%%%||%%%%|%%%%%%%%%%
-|||||||-||-||||||-|||||||||||||||||||||||||||||||||||||-|||||||||||||||||-|||||||||||||||||||||-|-||||||||||||-||||||||||--|-||||||||||||||||||||-|||-|||||||||||-|||||||||||||||||||||||||||||||||||||
