--------------------------------------------------------------------------------------------------------------------------------------------------------------------------------------------------------
--------------------------------------------------------------------------------------------------------------------------------------------------------------------------------------------------------
--------------------------------------------------------------------------------------------------------------------------------------------------------------------------------------------------------
--------------------------------------------------------------------------------------------------------------------------------------------------------------------------------------------------------
--------------------------------------------------------------------------------------------------------------------------------------------------------------------------------------------------------
------------------B------------BB--B--------------B-------------B-U----------B-------------U----BU-B--U------------B-----------------------B--BB-U---------B---U----BBBB--------------------------------
----C---------------------------------------------------------------------------C-----------------C---------------C--C----------------------------------------------------------------------------------
--------------------------------------------------------------------------------------------------------------------------------------------------------------------------------------------------------
--------------------------------------------------------------------------------------------------------------------------------------------------------------------------------------------------------
--------------------------------------------------------------------------------------------------------------------------------------------------------------------------------------------------------
----B#tt---CCU-----------#C-------U----------------U----tt-B-tt---C-----U--tt---B------tt--C-U---CB-B-C----tt-----B--B--------B---------ttU--B---CCCB----B----UC---B------------------------------------
-----#tt#---------------##--tt#-------------------------tt#--tt----------#-tt---------#tt------------------tt------------tt-----tt------tt------------#-------------------tt----------------------------
-----#tt#tt----#-------###--tt#----------------------#--tt#--tt--#-------#-tt---------#tt------------------tttt----------tt-----tt--tt--tt------#-----#------------------#tttttttttttttttttttt-tttttttt-
-----#tt#tt---g#-gg---####-ktt#-g---g-k-g-g----------#ggtt#--ttg-#-k-----#-ttgk--kg-#-#tt---g-#g---g-#-k-##tttt-g-----gg-tt-kg--tt--tt--tt--g---#----k##--k-#g---k------g#tttttttttttttttttttt-ttttttttF
X-XXXXXXXXXXXXXXXXXXXXXXXXXXXXX-XXX-XXXXXXXXX--XXXXXXXXXXXXXXXXX-XXXXXXXXXXXXXXXXXXXXXXXXX-XXXXXXXXXXXXXXXXXXXXXXXXXXXXXXXXXXXXXXXX-XXXXXXX-XX--XXXXXXXXXXX-XXXXXXXXXXXXXXXXXXXXXXXXXXXXXXXXXXXXXXXXXXXX
X-XXXXXXXXXXXXXXXXXXXXXXXXXXXXX-XXX-XXXXXXXXX--XXXXXXXXXXXXXXXXX-XXXXXXXXXXXXXXXXXXXXXXXXX-XXXXXXXXXXXXXXXXXXXXXXXXXXXXXXXXXXXXXXXX-XXXXXXX-XX--XXXXXXXXXXX-XXXXXXXXXXXXXXXXXXXXXXXXXXXXXXXXXXXXXXXXXXXX
