--------------------------------------------------------------------------------------------------------------------------------------------------------------------------------------------------------
--------------------------------------------------------------------------------------------------------------------------------------------------------------------------------------------------------
--------------------------------------------------------------------------------------------------------------------------------------------------------------------------------------------------------
--------------------------------------------------------------------------------------------------------------------------------------------------------------------------------------------------------
--------------------------------------------------------------------------------------------------------------------------------------------------------------------------------------------------------
-----B----B---U-B--BU-----U----B-----U----------------U------U--U-------B------------------------------------------BB--------B----------BBB--BUB--------------------------------------------------------
----------------------------------------------------------------------------------------------C---------------C-----------------C-----------------------------CCCCCC-CCCCCCCC--CCCCCCCCCCC-C-CCCCCCCCCCC
--------------------------------------------------------------------------------------------------------------------------------------------------------------------------------------------------------
--------------------------------------------------------------------------------------------------------------------------------------------------------------------------------------------------------
--------------------------------------------------------------------------------------------------------------------------------------------------------------------------------------------------------
---CB---------C-----CC#-CBCBCC#----ttC##--U-tt--CU--CUC---#C-C-CCUU----#-----C----------tt----B---#----------BB---B---------#---B---tt-B------C-B#B-U-----C---BBBBBB-BBBBBBBB--BBBBBBBBBBBBBBBBBBBBBBBBB
-------#--------------#-------#----tt-##----tt-----------##--------tt--#---#----#-tt----tt--------#------------------tttt---#-------tt-----tt----#------------------------------------------------------
-------#tt---#---tt---#-------#----tt-###---tttt---#----###--------tt--#-tt#--#-#-tt#---tttt-----##------------------tttt-tt#-----tttt-----tt----#---------tt----------------tt-------------------------
g-#--g##ttg--#---tt---#-------#-g-gtt-###---tttt---#---####--------ttgk#-tt#--#-#-tt##--tttt---#-##-kg-k-g-------#---tttt-tt#gg--gtttt-----tt----#-#-k-kgg-tt#------g--------tt------------------------F
XXXXXXXXXXXXXXXXXXXXXXXXXXXXXXX-X-XXXXXXX-XXXXXXXXXXXXXXXXXXXXXXXXXXXXXX-XXXXXX-XXXXXXXXXXXXXXXX-XX-XXXXXXXXXXXXXXXXXXXXX-XXXXXXXXXXXXXX--XXX-X-XXXXXXXXXXXXXXXXXXXXXXXXXXXXXXXXXXXXXXXXXXXXXXXXXXXXXXXX
XXXXXXXXXXXXXXXXXXXXXXXXXXXXXXX-X-XXXXXXX-XXXXXXXXXXXXXXXXXXXXXXXXXXXXXX-XXXXXX-XXXXXXXXXXXXXXXX-XX-XXXXXXXXXXXXXXXXXXXXX-XXXXXXXXXXXXXX--XXX-X-XXXXXXXXXXXXXXXXXXXXXXXXXXXXXXXXXXXXXXXXXXXXXXXXXXXXXXXX
