--------------------------------------------------------------------------------------------------------------------------------------------------------------------------------------------------------
--------------------------------------------------------------------------------------------------------------------------------------------------------------------------------------------------------
--------------------------------------------------------------------------------------------------------------------------------------------------------------------------------------------------------
--------------------------------------------------------------------------------------------------------------------------------------------------------------------------------------------------------
--------------------------------------------------------------------------------------------------------------------------------------------------------------------------------------------------------
--U----B----B-------------BB----------U------B------U---------B--B-U-------------U---------UB--------U-U------BB--B--B------BB-----------B-------B---B---U----B-------------------B-BBBBBBBBBBBBBBB-----
-----------------------C----------------------------------C-----------------------------------------------------------------------------------------C---------------------------------------------------
--------------------------------------------------------------------------------------------------------------------------------------------------------------------------------------------------------
--------------------------------------------------------------------------------------------------------------------------------------------------------------------------------------------------------
--------------------------------------------------------------------------------------------------------------------------------------------------------------------------------------------------------
--C--tt--U----ttB--#---B-B--------#-U-C-tt----------CUB---B--------C--------C----Ctt---UC--C-------C-C-CttttUB--#--U--tttt-------UB#--#-----tt------B----C---U---------#U#---------#--------------------
tt---tt---tt--tt---#-#-------tt--##-----tttt----------------tt-tt----tt--------tt-tt--#-------tt--------tttt----#-----tttt---------#--#tt---tt--------#----------------#-#---------#--------------------
tt---tt---tt--tt-tt###-------tt-###----#tttt----------------tt-tt----tt---tt-tttt-tt--#-------tt--------tttt----#-----tttt---------##-#tt---tt-tt-----#----------------#-#---------#--------------------
tt--ktt-k-ttggtt-tt###--#----tt#####---#ttttk----gkk---gg--gtt-tt-g--ttg-ktt-tttt-ttkk#---#---ttg-g-----tttt----##--g-tttt-ggg#g#--##k#tt--ktt-tt-k---#-g-#k--g-------g#-#kk-k-----#---------------kkkkF
XXXXXXXXXXXXXXXXXXXXXXXXXX---XXXXXXXXXXXXXXXXXXXXXXXXXXXXXXXXX-XXXXXXXXXXXXXXXXXXXXXXXXXX-XXXXXXXXXXXXXXXXXXXXXXXX-XX-XXXXXXXXXXXXXXXXXXXXXXXXXXX-XXXXX-XXXXXXX--XX--XXXXXXXXXXXXXXXXXXXXXXXXXXXXXXXXXXX
XXXXXXXXXXXXXXXXXXXXXXXXXX---XXXXXXXXXXXXXXXXXXXXXXXXXXXXXXXXX-XXXXXXXXXXXXXXXXXXXXXXXXXX-XXXXXXXXXXXXXXXXXXXXXXXX-XX-XXXXXXXXXXXXXXXXXXXXXXXXXXX-XXXXX-XXXXXXX--XX--XXXXXXXXXXXXXXXXXXXXXXXXXXXXXXXXXXX
