--------------------------------------------------------------------------------------------------------------------------------------------------------------------------------------------------------
--------------------------------------------------------------------------------------------------------------------------------------------------------------------------------------------------------
--------------------------------------------------------------------------------------------------------------------------------------------------------------------------------------------------------
--------------------------------------------------------------------------------------------------------------------------------------------------------------------------------------------------------
--------------------------------------------------------------------------------------------------------------------------------------------------------------------------------------------------------
----S-----------U-SUS-------S-SS---S---------------U--S---------S-S-----S------S-----SU--------------S-S-----S---SS-SS----------S------------S--S-----SS-S----------------------------------------------
-----------------------C-----C--------C--------C--------------------------------C-----------------------------------------------------------------------------------------------------------------------
--------------------------------------------------------------------------------------------------------------------------------------------------------------------------------------------------------
--------------------------------------------------------------------------------------------------------------------------------------------------------------------------------------------------------
--------------------------------------------------------------------------------------------------------------------------------------------------------------------------------------------------------
-------------ttUC--C---SttC--S-------SS#---CC-#SU--C----------U#-U----tt-----#C-S-----CU-----S--------------#------S---------U-U-----#---#-----S---ttS--C--Stt--------UUUUUUUUU--UU-UUUUUUUUUUUUUUUUUUUU
-------------tt---------tt-------------#------#--tt-----tt#----#---#--tt---#-#--------------------------tt--#-#---------------#--#--##---#---------tt-------tt------------------------------------------
---#-tt------tt---------tt-#-----#--#--#tt----#--tt-----tt##---#---#--tt-#-#-#-----tt---tt------#-------tt--#-#---------------#--#-###---#--#------tt-------tt-tt---------------#-----------------------
-#-#-tt--k-kgtt---------tt-#--g-g#-g#--#tt----#--tt---g-tt###g-#g--#ggtt-#-#g#-g--ktt---tt----k-##-##-ggttgk#g#kk-----k-g-k---#--#####k--#gg#-g--#ktt-------tt-tt-g-------------#--g-------------------F
-|-|%||%-|%||||%%--%%%-%||%|%%|-||%||%%|||%%%%|%%||%%%|%||||||%||%%|||||-|-|||%|%-|||-%%||%%%%|%||%||-|||||||||||%-%%%|%|%|%%%|%-||||||%%||||-|%%||||%--%-%%||-||%|%%%%%%%%%%%%-|%%|%%%%%%%%%%%%%%%%%%%%
-|-|||||-||||||||--|||-||||||||-||||||||||||||||||||||||||||||||||||||||-|-||||||-|||-|||||||||||||||-||||||||||||-|||||||||||||-||||||||||||-||||||||--|-||||-||||||||||||||||-||||||||||||||||||||||||
