--------------------------------------------------------------------------------------------------------------------------------------------------------------------------------------------------------
--------------------------------------------------------------------------------------------------------------------------------------------------------------------------------------------------------
--------------------------------------------------------------------------------------------------------------------------------------------------------------------------------------------------------
--------------------------------------------------------------------------------------------------------------------------------------------------------------------------------------------------------
--------------------------------------------------------------------------------------------------------------------------------------------------------------------------------------------------------
---------S----------SSU------S------SS---S--SS--------S--------S--S----S--U--------------------------------------USU----U-U---------------S---S--------S-S---S--------------U---------------------------
-----C-----------------------------------------------C-----------------------------------C------C--------------------------------------------------C-------------C--------------------------------------
--------------------------------------------------------------------------------------------------------------------------------------------------------------------------------------------------------
--------------------------------------------------------------------------------------------------------------------------------------------------------------------------------------------------------
--------------------------------------------------------------------------------------------------------------------------------------------------------------------------------------------------------
--SCCS-#--tt-------S--C---UCU-U-----------S-------U--S----C---S-C--C----#-Ctt-------tttt-S---C--S---S--U-U--#-tt-C-CC---CSCC----------------tt-----SttC----US----SU---S--S--C---------------------------
##-----#--tt-------------------tt-------#-------------------tt------tt--#--tt-------tttt-------------------##-tt---------------#------tttt--tt---tt-tt----------#---------------------------------------
##-----#--tttttt-------tt------tt-----#-#--#-----#-----tt---tt------tt--##-tt-------tttt-------------tt---###-tt---------------#------tttt--tt-tttt-tt---------##---------------------------------------
##-----#-gttttttg------tt------tt-kgg-#-#--#gg-#-#-#g-gtt---tt-g----ttg-##-tt##g-k--tttt#-#k------kg-tt-#-###-tt#----k-k----k--#k-g---tttt--ttgtttt-tt-gg-k---###--g-g-------------k-------------------F
||%%%%%|%||||||||%%%%%%||%%%%-%||-|||-|-|-%|||%|-|%||%|||%%%||%|%%-%|||-||%|||||%|%%|||||%||%%-%%-||%||%|%|||-|||%-%%|%|%%%%|--||%|%%%||||-%|||||||%||%||%|%%%|||%%|%|%%%%%%%%%%%%%|%%%%%%%%%%%%%%%%%%%%
|||||||||||||||||||||||||||||-|||-|||-|-|-||||||-|||||||||||||||||-||||-||||||||||||||||||||||-||-|||||||||||-||||-||||||||||--|||||||||||-|||||||||||||||||||||||||||||||||||||||||||||||||||||||||||||
