--------------------------------------------------------------------------------------------------------------------------------------------------------------------------------------------------------
--------------------------------------------------------------------------------------------------------------------------------------------------------------------------------------------------------
--------------------------------------------------------------------------------------------------------------------------------------------------------------------------------------------------------
--------------------------------------------------------------------------------------------------------------------------------------------------------------------------------------------------------
--------------------------------------------------------------------------------------------------------------------------------------------------------------------------------------------------------
----------------B-------B--B------------B-B------B-------------B-----B--U--B----U-----------------B----------B------B-------------B-B-----B-----B---------B--------------U----B-B------BB--BB-----------
-----------------------C--------------------C----------------------------------------------C---------------------------------C--------C-------C---------------C-----------------------------------------
--------------------------------------------------------------------------------------------------------------------------------------------------------------------------------------------------------
--------------------------------------------------------------------------------------------------------------------------------------------------------------------------------------------------------
--------------------------------------------------------------------------------------------------------------------------------------------------------------------------------------------------------
------tt-BB------U---#UB-----C----#tt-------B-----------------C--#----BCC-C---ttC#-C---#C--B----------tt------#------UC--tt-#B-------BB----U--B--C-U#-------ttB-B--------CBU-----tttttt--tt----tttttttt-
------tt-------------#------#-----#tt---------------------------##-------#--tttt-#----##-#------tt---#tt------#----------tt-#-----------------------#-------tt---#-----tt----#---tttttt--tt--tttttttttt-
--tt--tt---tt#-------#---tt-#---tt#tttt-----------tt-tt------#--##-tt----#--tttt-#---###-#------tt-#-#tttt----#---------#tt##------#---tt#-----#----#----#--tt---#---#-tt----#---tttttt--tt--tttttttttt-
--tt-gtt---tt##k-----#---ttg#--ktt#ttttk---k--g---ttkttk-k##-#-g##-tt----#--tttt-##-####-#--#--gtt-#-#tttt#kg-#g-g-k---##tt##----gg#---tt#-----#g---#k-g##-gtt-k-#-g-#-tt---g#-g-tttttt--tt--ttttttttttF
XXXXXXXXXXXXXXXXXX--XXXXXXXXXX-XXXXXXXXX-X-XX-XX--XXXXXXXXXX-XXXXXXXXXXXXXXXXXXXXXXXXXXXXXXXXX-XXX-X-XXXXXXXX-XXXXXX-XXXXXXXXXXXXXXXXXXXXX-XXXXXXXXXXXXXXXXXXXXXXXXX-XXXXXXXXX-X-XXXXXX--XX--XXXXXXXXXXX
XXXXXXXXXXXXXXXXXX--XXXXXXXXXX-XXXXXXXXX-X-XX-XX--XXXXXXXXXX-XXXXXXXXXXXXXXXXXXXXXXXXXXXXXXXXX-XXX-X-XXXXXXXX-XXXXXX-XXXXXXXXXXXXXXXXXXXXX-XXXXXXXXXXXXXXXXXXXXXXXXX-XXXXXXXXX-X-XXXXXX--XX--XXXXXXXXXXX
