--------------------------------------------------------------------------------------------------------------------------------------------------------------------------------------------------------
--------------------------------------------------------------------------------------------------------------------------------------------------------------------------------------------------------
--------------------------------------------------------------------------------------------------------------------------------------------------------------------------------------------------------
--------------------------------------------------------------------------------------------------------------------------------------------------------------------------------------------------------
--------------------------------------------------------------------------------------------------------------------------------------------------------------------------------------------------------
---USU--S-------S--------S-----------S---------U-U-S----US-SS-S--------SS--------------------S----U----------S-----------------S---S-----SS--------S-S--------------S-----------------------------------
---------------C----------C------------------C---------C----------------------------------------CC------------------------------C-----------------------------------------------------------C-----------
--------------------------------------------------------------------------------------------------------------------------------------------------------------------------------------------------------
--------------------------------------------------------------------------------------------------------------------------------------------------------------------------------------------------------
--------------------------------------------------------------------------------------------------------------------------------------------------------------------------------------------------------
C-UC-C----tt#S-S-------SC-S-U---tt-----#U----SUC-CS-U--SC----C-U------S---------------tt------ttSSC-------------SU#SU-----S---U-S-------S-----#-Ctt----------S-------U-U--------------------S-----------
------tt-#tt#----tttt--------tt-tt-----#-------------tt-------------------------------tt--#---tt-----#------------#-----------------tttt-----##--tt-#----------tt-----------#---------------------------
------tt-#tt#----tttt--------tt-tt-----#--tt---------tt-------------tt---tt-----------tt--#---tt---#-#------------#-----------------tttt----###--tt-#-tt-------tttt---------#---------------------------
-k----tt-#tt#----tttt#-------tt#tt-g--##--tt---------tt----gg---ggg-tt---tt-gk-g-k-k--ttk-#-ggtt---#-#-g-g-#g-----#---#----#-----kggtttt---####--tt-#-tt----#-ktttt---------#--------------------------F
%|%%%%||-||||%%%-|||||%%%%%%%|||||%|%-||%%||%%%%%%%-%||%%%%||%%%|||%||%--||%||%|%|%|%%|||%|%||||%%%|-|-|%|%||-%%%%|%%-|%-%%|%%%-%|||||||%%%||||%%||-|-||-%%%|%|||||--%%%%%%%|%%%%%%%%%%%%%%%%%%%%%%%%%%%
||||||||-|||||||-||||||||||||||||||||-|||||||||||||-|||||||||||||||||||--|||||||||||||||||||||||||||-|-||||||-|||||||-||-||||||-|||||||||||||||||||-|-||-||||||||||--|||||||||||||||||||||||||||||||||||
