--------------------------------------------------------------------------------------------------------------------------------------------------------------------------------------------------------
--------------------------------------------------------------------------------------------------------------------------------------------------------------------------------------------------------
--------------------------------------------------------------------------------------------------------------------------------------------------------------------------------------------------------
--------------------------------------------------------------------------------------------------------------------------------------------------------------------------------------------------------
--------------------------------------------------------------------------------------------------------------------------------------------------------------------------------------------------------
-------------S-U-----------SU----S--------SS------U----------U-------U---U-----S----------------S-S---------U---SU---S---SS-S-SS------------------S-S-------------------SU----U-------------------------
----------------------------------------------------------------C------------CC---------------------------------------------------------CC--------------------------C-----------------------------------
--------------------------------------------------------------------------------------------------------------------------------------------------------------------------------------------------------
--------------------------------------------------------------------------------------------------------------------------------------------------------------------------------------------------------
--------------------------------------------------------------------------------------------------------------------------------------------------------------------------------------------------------
-----S--#US----C--CC--------CS-------C##-S-----#--C----#-----C#-S-tt-CC--C---SS--------C---C---#------------C----C--S---S----S--------#SSS-----------tt--------tt-#-S#---C--C-C-------------------------
--------#--tt-#-----------------------##-------#------##------#---tt#------------#---#----#----#--------------#-----------------------#------------#-tt--#tt---tt-#--#----------------------------------
---tt---#--tt-#-tt--tt-------------#--##----tt-#tt---###------#--#tt#--tt--tt----##-##--#-#-tt-#----#-tt------#-------tt--------------#------tt-tt-#-tt-##tt#--tt-#--#----tt------#---------------------
g-gtt--##--ttg#-tt--tt-#g-g----k#-g#--##----tt-#tt---###-kk-g-#--#tt#--tt--tt---g#####k-#-#-tt-#-#--#ktt-----k#-g--g-gtt-g-g-----g-k-k#----##tt-tt-#-tt###tt#-gttk#--#-#g-tt---g#-#---------k----------F
|%|||%%||%%||||%||%%||%||%|%%%%||-||%%||%%%%||-|||%%%|||%||%|%|%%||||%%||%%||%%-|||||||%|-|%||-|-|-%||||%%%%%||%|%%|%|||%|-|-%--%|%|%||%%%%||||-||-|%||||||||%|||||%%|%||%||%%%||-|---------|----------%
|||||||||||||||||||||||||||||||||-||||||||||||-||||||||||||||||||||||||||||||||-|||||||||-||||-|-|-|||||||||||||||||||||||-|-|--|||||||||||||||-||-||||||||||||||||||||||||||||||-|---------|----------|
