--------------------------------------------------------------------------------------------------------------------------------------------------------------------------------------------------------
--------------------------------------------------------------------------------------------------------------------------------------------------------------------------------------------------------
--------------------------------------------------------------------------------------------------------------------------------------------------------------------------------------------------------
--------------------------------------------------------------------------------------------------------------------------------------------------------------------------------------------------------
--------------------------------------------------------------------------------------------------------------------------------------------------------------------------------------------------------
-------------------BBUU-BBBB-----------B----------------------U------BB------B-------------------U-B---------B--B---------------B----U----------------BB----BBB-----------------------------------------
-----------------------------------------------------------C---------------------------------------------C----C--C------------------------C-------------------------------------------------------------
--------------------------------------------------------------------------------------------------------------------------------------------------------------------------------------------------------
--------------------------------------------------------------------------------------------------------------------------------------------------------------------------------------------------------
--------------------------------------------------------------------------------------------------------------------------------------------------------------------------------------------------------
-C--------------#-B--CC-----BB--tt---#B---ttCB--C----------B#-C---U--------CU-------------tttt---C-------B--C-B--BC-U------CC-#----C-C----B--------------ttU----------------------------tt--------------
------tt--------#---------------tt--##----tt--------------#-#-------#---------------------tttt-------tt---tt-----------tttt---#-------------------tttt---tt-------#-----tttttttttttttttttttttttttttttttt
------tt--------#--------------#tt-###----tt--------------#-#-------#---tt----------------tttt-tt----tt---tt-----------tttt---#----------#--------tttt---tt----##-##-###tttttttttttttttttttttttttttttttt
k-#g-gtt#g-k-g--#------#-g-g---#tt####--gktt--#---k-k-----#-#----#-g#gg-ttg---g---------#-tttt#tt---gtt---tt----------gtttt---#gg------#-#--g#g#ggtttt---tt----##-######tttttttttttttttttttttttttttttttF
XXXXXXXXXXXXXXXXXXXXXXXXXX-XXXXXXXXXXXXXXXXXXXXXXXXXXXX-XXXXXXXXXXXXXXXXXXXXXXX--XXX--XXXXXXXXXXXXX-XXX-XXXXX-XXXXXXXXXXXXXXXXXXX-XXXXXX-XX-XXXXXXXXXX--XXXXXXXXX-XXXXXXXXXXXXXXXXXXXXXXXXXXXXXXXXXXXXXX
XXXXXXXXXXXXXXXXXXXXXXXXXX-XXXXXXXXXXXXXXXXXXXXXXXXXXXX-XXXXXXXXXXXXXXXXXXXXXXX--XXX--XXXXXXXXXXXXX-XXX-XXXXX-XXXXXXXXXXXXXXXXXXX-XXXXXX-XX-XXXXXXXXXX--XXXXXXXXX-XXXXXXXXXXXXXXXXXXXXXXXXXXXXXXXXXXXXXX
