--------------------------------------------------------------------------------------------------------------------------------------------------------------------------------------------------------
--------------------------------------------------------------------------------------------------------------------------------------------------------------------------------------------------------
--------------------------------------------------------------------------------------------------------------------------------------------------------------------------------------------------------
--------------------------------------------------------------------------------------------------------------------------------------------------------------------------------------------------------
--------------------------------------------------------------------------------------------------------------------------------------------------------------------------------------------------------
UB----B------------BU----BBU-B--------------U-----B-------B-----------B-----U-----------------------BBU--B---U------B-BB--------BBB-B---------------------------------------B---------------------------
----------------------C--------C--C-------------------------------C----------------------------------------------C-----------------------------------------------------------C--------------------------
--------------------------------------------------------------------------------------------------------------------------------------------------------------------------------------------------------
--------------------------------------------------------------------------------------------------------------------------------------------------------------------------------------------------------
--------------------------------------------------------------------------------------------------------------------------------------------------------------------------------------------------------
C--#---tttt-U--B----C-B-U--C---B-CBU----C---CB--------------------B-----C---C----C-B------------------C-U----C---B---B---------B-----UB----#-CC----------ttB-B-#-########--#-B######B###################
---#---tttt#------#-----------------tt------------------#----------#tt-----------------tttt-------------------#---------------------------##-------------tt----#-########--#--######-###################
---##--tttt#-----##-----------------tt#-------#-----tt#-#----------#tt--------#--------tttt------tt---------#-##---#-----tt--------------###-----------tttt----#-########--#--######-###################
---##--tttt#----###------g--gg#-----tt#-------#-----tt#-#g-#g-g-kk-#tt-g------#-g-----ktttt--#---tt----g--#-#-###--#-----tt-------------####----#gk-k-gtttt-k--#-########--#--######-##################F
XX-XXXXXXXXXX-XXXXX-XXXXXX-XXXXXXXXXXXXXXXX-XXXX-X-XXXX-XX-XXXXXXXXXXXXXXX-XXXXXXXXXXXXXXXXXXXXXXXXXX-XXX-X-XXXXXXXXXX--XXXX-XXXXXXX-XXXXXXXXXXXXXXXXXXXXXXXXXXXXXXXXXXXXXXX-XXXXXXXXXXXXXXXXXXXXXXXXXXX
XX-XXXXXXXXXX-XXXXX-XXXXXX-XXXXXXXXXXXXXXXX-XXXX-X-XXXX-XX-XXXXXXXXXXXXXXX-XXXXXXXXXXXXXXXXXXXXXXXXXX-XXX-X-XXXXXXXXXX--XXXX-XXXXXXX-XXXXXXXXXXXXXXXXXXXXXXXXXXXXXXXXXXXXXXX-XXXXXXXXXXXXXXXXXXXXXXXXXXX
