--------------------------------------------------------------------------------------------------------------------------------------------------------------------------------------------------------
--------------------------------------------------------------------------------------------------------------------------------------------------------------------------------------------------------
--------------------------------------------------------------------------------------------------------------------------------------------------------------------------------------------------------
--------------------------------------------------------------------------------------------------------------------------------------------------------------------------------------------------------
--------------------------------------------------------------------------------------------------------------------------------------------------------------------------------------------------------
-----------------------B---B---------------BB------------B----U-----------B----B-------U--BB------B-B---------BB---------B---------B------------U---U--------------U--------BB--B-----------------------
------------------------------------CC--------------------------C-----------------------C----------C----------------------C----------------------C-----------------------------C-----CCCCCCCCCCCCCCCCCCC
--------------------------------------------------------------------------------------------------------------------------------------------------------------------------------------------------------
--------------------------------------------------------------------------------------------------------------------------------------------------------------------------------------------------------
--------------------------------------------------------------------------------------------------------------------------------------------------------------------------------------------------------
---------C#-U-------------#-#tt-B---BB-------ttttC-----#---U-#C-B-----------B-#-ttC----CBB---------B---tt-C----------#tt--B-UB-U-------C--C-----CB#-C---BB---U-----C---tt-##--CB-----BBBBBBBBBBBBBBBBBBB
----------#-------------tt#-#tt#-------tt----tttt-----##--#--#---tt---#-------#-tt---tt-------#--------tt------------#tt------------#------tt-----#--------------tt----tt-##-----tt---------------------
--tt--tt--#-------------tt#-#tt#-#tt---tt#---tttt----###--#--#---tt---#-tt----#-tt-#-tt-----#-#--------tt#-tt-----#tt#tt------------#---#--tt-tt--#--------tt--#-tt----tt-##-----tt---------------------
--ttggttg-#---g-g--k-k#gtt#-#tt#-#tt---tt#--gtttt--#####--#--#-g-tt--g#-ttgg-g#gtt-#ktt-----#-#k-gg-gg#tt#-ttk--#-#tt#tt------k-g-k-#-k-#--ttgtt--#---g---ktt--#-tt-kg-tt###-g---tt--------------------F
X-XXXXXXXXXXXXXXXXXXXXXXXXX-XXXXXXXXXXXXXXXXXXXXXXXXXXXX-XXXXXXXXXXX-XXXXXXXXXXXXXXXXXXXXX--X-XXXXXXXXXXXXXXXX-XX-XXXXXXXXX-XXXXXXX-X-XXX-XXXXXXXXXXX-X-XXXXXX-XXXXXXXXXXXXX-XXX-XXXXXXXXXXXXXXXXXXXXXXX
X-XXXXXXXXXXXXXXXXXXXXXXXXX-XXXXXXXXXXXXXXXXXXXXXXXXXXXX-XXXXXXXXXXX-XXXXXXXXXXXXXXXXXXXXX--X-XXXXXXXXXXXXXXXX-XX-XXXXXXXXX-XXXXXXX-X-XXX-XXXXXXXXXXX-X-XXXXXX-XXXXXXXXXXXXX-XXX-XXXXXXXXXXXXXXXXXXXXXXX
