--------------------------------------------------------------------------------------------------------------------------------------------------------------------------------------------------------
--------------------------------------------------------------------------------------------------------------------------------------------------------------------------------------------------------
--------------------------------------------------------------------------------------------------------------------------------------------------------------------------------------------------------
--------------------------------------------------------------------------------------------------------------------------------------------------------------------------------------------------------
--------------------------------------------------------------------------------------------------------------------------------------------------------------------------------------------------------
-BB---B-UB--B--------B-B------BU------B--------B-----U-B-----B--------------------BBUB--U--------B-------------------------B--------B---B----BB-----BB--------UB-----------B----------------------------
-----------C-----------------------------------------------------C-------------------------------------C------------------------------------C----------------C------------------------------------------
--------------------------------------------------------------------------------------------------------------------------------------------------------------------------------------------------------
--------------------------------------------------------------------------------------------------------------------------------------------------------------------------------------------------------
--------------------------------------------------------------------------------------------------------------------------------------------------------------------------------------------------------
B------CC-BB------U-C----U-----C-------B#U-U-C--CU---C#-tt----#C-B-U---U-----ttB-B--C---C--------------B----tt-----#--U---#---UU--tt---U----B-----tt--#------BC-----tt--tt------------------------------
-------------#-------------tt-----------#----------tt-#-tttt--#-----------#--tt--------#----------#-----#---tt-----#tt---##-------tt-#-----------#tt--#--#--------tttt--tt------------------------------
-------------##--#---------tt-----------#----------tt-#-tttt--#---------tt#--tt--------#----------#-----#---tt-----#tt--###-------tt-#-----#---#-#tt--#--#------tttttttttt------------------------------
---kg-g------###-#-g----g--tt------k--g-#-----k---gtt-#gttttg-#-----#g--tt#--tt-g----gk#-g-k-g---g#-----#k-ktt-g--k#tt-####--g--gktt-##-g--#-g-#-#tt--##-#g-g---tttttttttt-g--------g--k---------------F
X--XXXXXXXXX-XXX-XXXXX--XXXXXXXXXXXXX-XXXXXXXXXXXXXXXXXXXXXXXXXXXX-XXXXXXXXXXXXXXXXXXXXXXXXXXXXXXXXX-XXXXXXXXXXX-XXXXXXXXXXXXXXXXXXX-XXXXXXXXX-X-XXXX-XXXXXXXXXXXXXXXXXXXXXXXXXXXXXXXXXXXXXXXXXXXXXXXXXX
X--XXXXXXXXX-XXX-XXXXX--XXXXXXXXXXXXX-XXXXXXXXXXXXXXXXXXXXXXXXXXXX-XXXXXXXXXXXXXXXXXXXXXXXXXXXXXXXXX-XXXXXXXXXXX-XXXXXXXXXXXXXXXXXXX-XXXXXXXXX-X-XXXX-XXXXXXXXXXXXXXXXXXXXXXXXXXXXXXXXXXXXXXXXXXXXXXXXXX
