--------------------------------------------------------------------------------------------------------------------------------------------------------------------------------------------------------
--------------------------------------------------------------------------------------------------------------------------------------------------------------------------------------------------------
--------------------------------------------------------------------------------------------------------------------------------------------------------------------------------------------------------
--------------------------------------------------------------------------------------------------------------------------------------------------------------------------------------------------------
--------------------------------------------------------------------------------------------------------------------------------------------------------------------------------------------------------
--------------U--S----S-----U-------U---------------------------S-------------U-S----------------------U--------S-------------S-SS------------U----------U----------------------------------------------
---C---------------C---------C--------------------------------------------------------------------------------------------------------------------------------C----------C------------------------------
--------------------------------------------------------------------------------------------------------------------------------------------------------------------------------------------------------
--------------------------------------------------------------------------------------------------------------------------------------------------------------------------------------------------------
--------------------------------------------------------------------------------------------------------------------------------------------------------------------------------------------------------
tt-SC---SUtt--C----S##----C-CS------C-C----tt-#--------#-CCC-#---#------------C----------tt-#----------C-----C---#--------S--#-S----tt---S#UC-C-C----U#--C----S---S------S------------------------------
tt--------tt--------##-----#----#----------tt-#---tt---#-----##--#-#---#-----------------tt-#--------------#-----#----#-----##----tttt----#------tt---#---tttt------------------------------------------
tt---tt---tt----#---##-#---#----#-tt-----tttt-#tt-tt-tt#-----##--#-##-##tt-tt------------tt-#-----tt-tt----#-----#--#-#----###----tttt#---#------tt---#---tttt------------------------------------------
tt---tt---ttg--g#g--##g#---#--kg#-tt---g-tttt-#ttgtt-tt#-----##kg#-#####tt-ttg-#-g-g-k--gtt-#-----tt-tt-k-g#--#--##-#-#-kg-###----tttt#-#-#------tt---#---tttt-###-#g##-#-#############################F
||%%%||%%%|||%%|||%%||||%%%|%%|||%||%%%|%||||%||||||%|||%%%%%|||||%|||||||%|||%|%|%|%|%%|||%|%%%%%||-||%|%||%%|%%||-|-|%||%|||%%%%|||||%|%|%%%%%%||%%%|%%%||||%|||%||||%|%|||||||||||||||||||||||||||||%
||||||||||||||||||||||||||||||||||||||||||||||||||||||||||||||||||||||||||||||||||||||||||||||||||||-||||||||||||||-|-||||||||||||||||||||||||||||||||||||||||||||||||||||||||||||||||||||||||||||||||||
