--------------------------------------------------------------------------------------------------------------------------------------------------------------------------------------------------------
--------------------------------------------------------------------------------------------------------------------------------------------------------------------------------------------------------
--------------------------------------------------------------------------------------------------------------------------------------------------------------------------------------------------------
--------------------------------------------------------------------------------------------------------------------------------------------------------------------------------------------------------
--------------------------------------------------------------------------------------------------------------------------------------------------------------------------------------------------------
-SU---------------------------------------S----S-----U--------------SS---S---------------S--S--------------------U------SS--------UU-----S----------------SU-------S--------S-S-S-S---------------------
-------------------------------------------C----------------------------------------C--------------------------------C--------------------------------C-------------------------------------------------
--------------------------------------------------------------------------------------------------------------------------------------------------------------------------------------------------------
--------------------------------------------------------------------------------------------------------------------------------------------------------------------------------------------------------
--------------------------------------------------------------------------------------------------------------------------------------------------------------------------------------------------------
U-C----#--#--S---C#--------C#--------#-----S#CU-----#C------U---tt-S-------U-----C-#S--tt--------U----#S------S--C-S-S-S----------CC--Utt-tt--tt------S#-#-C--U------#tt--------------------------------
-------#tt#tt-----#---------#-#tt#---#-#----#---tt-##-----------tt-------------tt--#---tt-----------tt#----#---#-----------------------tt-tt--tt---#tt-#-#------#---##tt--------------------------------
------##tt#tt-----#---------#-#tt#---#-##---#---tt###----------#tt-------------tt--#---tt---------tttt#--tt##--##----------------#-----tt-tt--tt##-#tt-#-#--tt--#---##tt--------------------------------
-g-g-g##tt#tt-g-g-#--g-g#-#-###tt#---#-###--#---tt###---g----#-#tt-----gkg-----tt--#-g-ttg----k---tttt#--tt##g-##-----#----k-kk--#-----tt-tt-gtt##-#tt-#-#--tt-g#-k-##tt#g-k-g-g-g-ggggggggggggggggggggF
%|%|%||||||||%|%|%|-%|-||%|%||||||%%%|%|||%%|%%%|||||%%%|%%%%|-|||%%---|||%%%%%||%%|%|%|||%%%%|%%%|||||%%|||||%||%%%%%|%%%%|%||%%|%%%%%||-||%|||||-|||%|%|-%||%||-|%||||||%|-|-|-|-||||||||||||||||||||%
|||||||||||||||||||-||-|||||||||||||||||||||||||||||||||||||||-|||||---||||||||||||||||||||||||||||||||||||||||||||||||||||||||||||||||||-||||||||-|||||||-||||||-||||||||||-|-|-|-|||||||||||||||||||||
