--------------------------------------------------------------------------------------------------------------------------------------------------------------------------------------------------------
--------------------------------------------------------------------------------------------------------------------------------------------------------------------------------------------------------
--------------------------------------------------------------------------------------------------------------------------------------------------------------------------------------------------------
--------------------------------------------------------------------------------------------------------------------------------------------------------------------------------------------------------
--------------------------------------------------------------------------------------------------------------------------------------------------------------------------------------------------------
-B--------------------BB------B------U----------------------------U----B--B--B--U--B---------------------------B-B-----BB-------BU----------B-B----------B----------------------------------------------
-----------------------------------------C-------------------------------------C--------------------------------C--------C-------------------C---------------C------------------------------------------
--------------------------------------------------------------------------------------------------------------------------------------------------------------------------------------------------------
--------------------------------------------------------------------------------------------------------------------------------------------------------------------------------------------------------
--------------------------------------------------------------------------------------------------------------------------------------------------------------------------------------------------------
--C------Btt----#----------C---------C---B----------tt---C----Utt-C---U--#-----BC-#-------tt----------------tt--B-tt--B--B-------C----B---C--B--U-------U----B-----------------------------C------------
----------tt-#-##--------tt--------##---#-----------tt---------tt--------#--------#-------tt#---------------tt----tt-----------------#-#--------------tt----------------------tt------------------------
-------tt-tt-####---#----tt-tt-tt-###-tt#-tt----tt--tt-tt------tt--------#--------#--tt---tt#-------------##tt#---tt---------------#-#-##--#------###-tt---##-################tt###########-#-##########
g---gg-tt-tt-####ggk#g-ggtt-tt-tt####-tt#-tt-k--tt--tt-tt-g-g--tt--g-k--g#-kggk---#g-ttk-gtt#k---g----kg#-##tt#---tt-#----#--------#-#-###-#g-----###gtt---##-################tt###########-#-#########F
XXXXXXXXXXXX-XXXXXXXXX-XXXXXXX-XXXXXXXXXXXXXXXXXXX-XXXXXXXXXXXXXXXXXXXX-XXXXXXXXXXXX-XXXXXXXXXXXXXXX--XXX-XXXXX-XXXXXXXXXXXX--XX-XXXXXXXXXXXXX--XXXXXXXXXXXXXXXXXXXXXXXXXXXXXXXXXXXXXXXXXXXXXXXXXXXXXXXX
XXXXXXXXXXXX-XXXXXXXXX-XXXXXXX-XXXXXXXXXXXXXXXXXXX-XXXXXXXXXXXXXXXXXXXX-XXXXXXXXXXXX-XXXXXXXXXXXXXXX--XXX-XXXXX-XXXXXXXXXXXX--XX-XXXXXXXXXXXXX--XXXXXXXXXXXXXXXXXXXXXXXXXXXXXXXXXXXXXXXXXXXXXXXXXXXXXXXX
