--------------------------------------------------------------------------------------------------------------------------------------------------------------------------------------------------------
--------------------------------------------------------------------------------------------------------------------------------------------------------------------------------------------------------
--------------------------------------------------------------------------------------------------------------------------------------------------------------------------------------------------------
--------------------------------------------------------------------------------------------------------------------------------------------------------------------------------------------------------
--------------------------------------------------------------------------------------------------------------------------------------------------------------------------------------------------------
-S--------------------SS------S------U----------------------------U----S--S--S--U--S---------------------------S-S-----SS-------SU----------S-S----------S----------------------------------------------
-----------------------------------------C-------------------------------------C--------------------------------C--------C-------------------C---------------C------------------------------------------
--------------------------------------------------------------------------------------------------------------------------------------------------------------------------------------------------------
--------------------------------------------------------------------------------------------------------------------------------------------------------------------------------------------------------
--------------------------------------------------------------------------------------------------------------------------------------------------------------------------------------------------------
--C------Stt----#----------C---------C---S----------tt---C----Utt-C---U--#-----SC-#-------tt----------------tt--S-tt--S--S-------C----S---C--S--U-------U----S-----------------------------C------------
----------tt-#-##--------tt--------##---#-----------tt---------tt--------#--------#-------tt#---------------tt----tt-----------------#-#--------------tt----------------------tt------------------------
-------tt-tt-####---#----tt-tt-tt-###-tt#-tt----tt--tt-tt------tt--------#--------#--tt---tt#-------------##tt#---tt---------------#-#-##--#------###-tt---##-################tt###########-#-##########
g---gg-tt-tt-####ggk#g-ggtt-tt-tt####-tt#-tt-k--tt--tt-tt-g-g--tt--g-k--g#-kggk---#g-ttk-gtt#k---g----kg#-##tt#---tt-#----#--------#-#-###-#g-----###gtt---##-################tt###########-#-#########F
|%%%||%||%||-|||||||||-||||%||-||||||%|||%||%|%%||-%||%||%|%|%%||%%|%|%-||%||||%%%||-|||%|||||%%%|%%--|||-|||||-%%||%|%%%%|%--%%-%%|%|%|||%||%--%%||||||%%%||%|||||||||||||||||||||||||||||%|%|||||||||%
||||||||||||-|||||||||-|||||||-|||||||||||||||||||-||||||||||||||||||||-||||||||||||-|||||||||||||||--|||-|||||-||||||||||||--||-|||||||||||||--||||||||||||||||||||||||||||||||||||||||||||||||||||||||
