--------------------------------------------------------------------------------------------------------------------------------------------------------------------------------------------------------
--------------------------------------------------------------------------------------------------------------------------------------------------------------------------------------------------------
--------------------------------------------------------------------------------------------------------------------------------------------------------------------------------------------------------
--------------------------------------------------------------------------------------------------------------------------------------------------------------------------------------------------------
--------------------------------------------------------------------------------------------------------------------------------------------------------------------------------------------------------
B-------------------B-----U--------------U---B---B--UB----------------B--U-------U----------------B---U---------BB------------U--B-----------B--B-B---UB-U------B----B----------------------------------
--------------------------------------------------------------C----C-----------------------------------------------C-----C-----------------C--------------C----------------------------------CCC--CCCCCC
--------------------------------------------------------------------------------------------------------------------------------------------------------------------------------------------------------
--------------------------------------------------------------------------------------------------------------------------------------------------------------------------------------------------------
--------------------------------------------------------------------------------------------------------------------------------------------------------------------------------------------------------
--tt-----UttC--U-C--------C-C-----BttC-ttC--C-C-----C---C--B--B---#B---C-C-------CC------ttU--C--#----C------ttB---B---C-B#-C-C-C----------B#--U------C--CB-tt---B#----B---------------------BBB--BBBBBB
--tt------tt---------#-------------tt--tt---------tt------#----tt-#-----------#----------tt-#----#---#--#----tt-----------#-----------------#------tt-------tttt--#------tttttttttttttttttttt---tt------
--tt------tt---------#tt-----------tt--tt--#---#--tt--tt--#--#-tt-#-------tt--##---tt-tt-tt-#----#-#-#--#---#tt-----------#---------tt------#------tt-------tttt--#------tttttttttttttttttttt---tt------
--ttk-g-g-tt-g--g-kg-#tt#--g-#g----tt--tt-g#---#--tt-gtt-##-g#-tt##-g---g-ttg-###--tt-ttktt-#----#-#-#--#k#-#tt---g-g-----#---------tt-k-kg-#------ttk-g#---tttt--#-kg---tttttttttttttttttttt---tt-----F
X-XXXXXXXXXXXXXXXXXXXXXXXXXXXXXXXXXXXXXXXXXXX-XXXXXXXXXXXXXXXXXXXXXXXX-XXXXXXXXXXXXXX-XXXXXXXXXX-XXX-XXXXXX-XXXX--XXXX-XXXXXXXXXX-X-XXXXXXXXX-XX-X-XXXXXXXXXXXXXXXXXXXXXXXXXXXXXXXXXXXXXXXXXXXXXXXXXXXXX
X-XXXXXXXXXXXXXXXXXXXXXXXXXXXXXXXXXXXXXXXXXXX-XXXXXXXXXXXXXXXXXXXXXXXX-XXXXXXXXXXXXXX-XXXXXXXXXX-XXX-XXXXXX-XXXX--XXXX-XXXXXXXXXX-X-XXXXXXXXX-XX-X-XXXXXXXXXXXXXXXXXXXXXXXXXXXXXXXXXXXXXXXXXXXXXXXXXXXXX
