--------------------------------------------------------------------------------------------------------------------------------------------------------------------------------------------------------
--------------------------------------------------------------------------------------------------------------------------------------------------------------------------------------------------------
--------------------------------------------------------------------------------------------------------------------------------------------------------------------------------------------------------
--------------------------------------------------------------------------------------------------------------------------------------------------------------------------------------------------------
--------------------------------------------------------------------------------------------------------------------------------------------------------------------------------------------------------
----S----S---S--S-S---US----S---------U--------------S---U-----------------S-------------S--S----------------U-SS--U----------------------------------------S----S--SSS--S-S----------------------------
------C-------------------------------------------C-----C--------C-----------------------------------------------------------------------------------CC-------------------------C-----------------------
--------------------------------------------------------------------------------------------------------------------------------------------------------------------------------------------------------
--------------------------------------------------------------------------------------------------------------------------------------------------------------------------------------------------------
--------------------------------------------------------------------------------------------------------------------------------------------------------------------------------------------------------
--#---S---------------C----#-tttt-S--#Ctt-U-C-----SU----SC-------S-----CC-----U-------SU-----tttttt-----tt---CS----C--U--------------S-S--ttSS-------SS-tt------S--#------------S-----------------------
--#-----------------------##-tttt#-tt#-tt---------------------tt#-----------tt------------tt-tttttt---#-tt-----------#--#-----------------tt---tt-------tt---------#------------------------------------
--#--------#---#-----#---###-tttt#-tt#-tt---------------------tt#-----------tt------------tt-tttttt-#-#-tt-tt-----#--#--##--tt--#-#-------tt---tt------#tt----tt---#------------------------------------
--#-------g#g-k#---#-#--####gtttt#-tt#-ttg-----g-k--ggkg------tt#---g-g--#--tt---k---g----ttgtttttt-#-##tt-tt----g#--#-g###-tt#-#g#-#----gtt---ttgg----#tt-g--tt-g-#g--kkgkgk-kk-kkk-kkkkkkkkkkkkkkkkkkF
%%|%%%%%%%|||%||%%-|%|%-||||||||||%|||%|||%%%%%|%|%%||||%%%%--|||%%-|%|%%|%%||%-%|%%%|%%%-|||||||||%|-||||%||%%--||%%|%||||%|||-|||%|%%%%|||%%%||||%%%%|||%|-%||%|%||--||||||%||%|||%||||||||||||||||||%
||||||||||||||||||-||||-||||||||||||||||||||||||||||||||||||--|||||-|||||||||||-|||||||||-|||||||||||-|||||||||--||||||||||||||-||||||||||||||||||||||||||||-||||||||--|||||||||||||||||||||||||||||||||
