--------------------------------------------------------------------------------------------------------------------------------------------------------------------------------------------------------
--------------------------------------------------------------------------------------------------------------------------------------------------------------------------------------------------------
--------------------------------------------------------------------------------------------------------------------------------------------------------------------------------------------------------
--------------------------------------------------------------------------------------------------------------------------------------------------------------------------------------------------------
--------------------------------------------------------------------------------------------------------------------------------------------------------------------------------------------------------
------B--BB--------------B-----B-B------------B----B-------BB-----B----------B-----------------------------B------------B-------BB--B-------BB------B------------------U-U-----BBBBBBBBBBBBB-BUBBBBBBBBB
C----------------------------------C----------------------------------------------------------------------------------------------------------------------------------------C---------------------------
--------------------------------------------------------------------------------------------------------------------------------------------------------------------------------------------------------
--------------------------------------------------------------------------------------------------------------------------------------------------------------------------------------------------------
--------------------------------------------------------------------------------------------------------------------------------------------------------------------------------------------------------
B-------B----tt-------U-C---------UB------------------tt-#B----B---#--UU------------U---CCtt----tt-------B---U-----tt--#----#-----#-------tt------C#-B----#-CC--tt-Utt-C-C#-B-----------------C---------
-------------tt------#----#----------------#----------tt-#---tt----#-----------------tt---tt----tt---------------#-tt-##----#-----#-------tt-------#------#-----tt--tt----#-----------------------------
-------#-----tttt-tt-#----#---#------------##---tt----tt-#---tt-#--#-----------tt----tt---tt----tt-------------#-#-tt###----#-----#--tt---tt--tt---#---##-#-----tt--tt----#--tt-------------#-----------
-#-----#----ktttt-tt-#----#g--#g-----------###gktt-g--tt-#---tt-#g-#-g----g-gg-tt-g--ttg--tt-k-ktt--k-g----gg--#-##tt###---g#--#gg#-gttgkkttg-tt-#-#--k##-#-----ttg-ttg---#--ttggggggggggggg#g-ggggggggF
XXXXXX-XXXXXXXXXXXXXXXXXXXXXXXXXXXXXXXX--XXXXXXXXXXX-XXXXXX--XXXXXXXXXXXXXXXXXXXXXX-XXXXXXXXXXXXXXXXXXXX-XXXXXXX-XXXXXXX-XXXXXXXXXXXXXXXXXXXXXXX-XXXXXXXXXXXXXXXXXXXXXXXXXXXXXXXXXXXXXXXXXXXXXXXXXXXXXXX
XXXXXX-XXXXXXXXXXXXXXXXXXXXXXXXXXXXXXXX--XXXXXXXXXXX-XXXXXX--XXXXXXXXXXXXXXXXXXXXXX-XXXXXXXXXXXXXXXXXXXX-XXXXXXX-XXXXXXX-XXXXXXXXXXXXXXXXXXXXXXX-XXXXXXXXXXXXXXXXXXXXXXXXXXXXXXXXXXXXXXXXXXXXXXXXXXXXXXX
