--------------------------------------------------------------------------------------------------------------------------------------------------------------------------------------------------------
--------------------------------------------------------------------------------------------------------------------------------------------------------------------------------------------------------
--------------------------------------------------------------------------------------------------------------------------------------------------------------------------------------------------------
--------------------------------------------------------------------------------------------------------------------------------------------------------------------------------------------------------
--------------------------------------------------------------------------------------------------------------------------------------------------------------------------------------------------------
------U-------------U---S----S----------S------S-----S---S---------------U-S--U--U-S---S----S--SS-----SS-S----S------UUS----------------------------------S-S-------------------------------------------
-------------------------------------------------------C--------C-C---C--------------C-------C----------------------------C-----------------------------------------------------------------------------
--------------------------------------------------------------------------------------------------------------------------------------------------------------------------------------------------------
--------------------------------------------------------------------------------------------------------------------------------------------------------------------------------------------------------
--------------------------------------------------------------------------------------------------------------------------------------------------------------------------------------------------------
------C---S---C-tt--Ctt--#----------------SS--#---C-#--S-------US-S---S#-C#---C-CC---S-------S---CSS-S--C-tttt-tt---#CC---S--------------------#--------#U------CC--------------S-----------------------
--#-------------tt#--tt--#tt------------------#-----#------tt----#-tt--#--#--#-#--------------------------tttt-tt---#----#------tt--#-tttt#---##--------#-----------------------------------------------
--#tt--tt----#-#tt#--tt--#tt--------#---------#-tt--#------tt----#-tt--#--#--#-#--------------------------tttt-tt-tt#---##------tt#-#-tttt##-###-#------#----tt---#-------------------------------------
g-#ttk-ttg-#-#-#tt#k-ttg-#tt--#k-k-g#--#-k----#-tt--#gg-g--ttgg--#-tt--#--#--#-#--------gk#---ggg---------tttt-tt-tt#---##--g-gktt#-#-tttt######-#---g-k#-gg-tt---#---#--------------------------------F
|%||||%|||%|-|%|||||%|||-|||-%||%|%||%%|-|%%%-|-||%%|||%|-%||||%%|%||%%|-%|%%|%|%%%%%%%%|||%%%|||%%%%%--%-||||-||%|||%%-||%%|%|||||-|%||||||||||%|%%%|%||%||%||%%%|%%%|%%%%%%%%%%%%%%%%%%%%%%%%%%%%%%%%%
||||||||||||-|||||||||||-|||-|||||||||||-||||-|-|||||||||-||||||||||||||-|||||||||||||||||||||||||||||--|-||||-||||||||-|||||||||||-||||||||||||||||||||||||||||||||||||||||||||||||||||||||||||||||||||
