--------------------------------------------------------------------------------------------------------------------------------------------------------------------------------------------------------
--------------------------------------------------------------------------------------------------------------------------------------------------------------------------------------------------------
--------------------------------------------------------------------------------------------------------------------------------------------------------------------------------------------------------
--------------------------------------------------------------------------------------------------------------------------------------------------------------------------------------------------------
--------------------------------------------------------------------------------------------------------------------------------------------------------------------------------------------------------
--------SS----------------S-----S-S-----S--S------------------------U-------S------S---S--S---------U-------SUU----------------------S-------S--S--U-----U-----S---S------------------SS-S--US----------
---------------------------------C-------------------C--------------------------C-------C-------------------------------------------------C---------------------C---------------------------------------
--------------------------------------------------------------------------------------------------------------------------------------------------------------------------------------------------------
--------------------------------------------------------------------------------------------------------------------------------------------------------------------------------------------------------
--------------------------------------------------------------------------------------------------------------------------------------------------------------------------------------------------------
--U----------S---C-U-------------S-------tt---ttS----Stt-tt--#------C--CU-tt-#--S-------S-------Ctt-C-CC##U--CC----------#tt#U--tt-U------SS--SU-S-C-----CC--U--S#----U--------US-tt-S-----UC-----------
#-----#----------------------------------tt---tt------tt-tt#-#-------tt---tt-#tt----#------tt----tt-----##------#tt--tt--#tt#---tt--#-#---------------------#----#--#------tt-----tt--------------------
#--##-#-------------tt------#-tt---#-tt--tt---tt------tt-tt#-#-------tt---tt-#tt----#------tt-tt-tt-----##------#tt--tt--#tt#-#-tt--#-##---------------#----#----#--#--tt--tt-----tt#-----#-------------
#--##-##---kg---#-#-tt-g-g--#-ttg--#-tt#-tt---tt---k--tt-tt#-#g-k--k-tt---tt-#tt----#-k--ggtt-tt-tt-----##-k----#ttg-tt-g#tt#-#gttg-#-###----g--g-----g#---g#-k--#--#--tt--tt----gtt#-----#------------F
|%%||-||%-%||%%%|%|%||%|%|%%|%|||%%|%|||-||-%%||%%-|%%||%|||-||%|%%|%||%%-||%|||%%%%|%|-%||||-||%||%%%%%||%|%%%%||||-||%|||||%|||||%|%|||-%%%|%%|%%%%%||%%%||%|%%|-%|%%||%%||%-%%||||%--%-|%%%%%%%%%%%%%
|||||-|||-||||||||||||||||||||||||||||||-||-||||||-|||||||||-||||||||||||-|||||||||||||-|||||-||||||||||||||||||||||-||||||||||||||||||||-||||||||||||||||||||||||-|||||||||||-|||||||--|-||||||||||||||
