--------------------------------------------------------------------------------------------------------------------------------------------------------------------------------------------------------
--------------------------------------------------------------------------------------------------------------------------------------------------------------------------------------------------------
--------------------------------------------------------------------------------------------------------------------------------------------------------------------------------------------------------
--------------------------------------------------------------------------------------------------------------------------------------------------------------------------------------------------------
--------------------------------------------------------------------------------------------------------------------------------------------------------------------------------------------------------
S-U--------U-----------------S---------------S-----U----------U------------S----S---U---S--SS-------------S---U------US------S------US-----------------S-------------------------------S----------------
-----C-C-------------------C--------CC------------------------------------------------------------------------------C-------C--------------------C------------C-------------------------------C---------
--------------------------------------------------------------------------------------------------------------------------------------------------------------------------------------------------------
--------------------------------------------------------------------------------------------------------------------------------------------------------------------------------------------------------
--------------------------------------------------------------------------------------------------------------------------------------------------------------------------------------------------------
--C-SSSSS--C---------------S--tt---#SS---#-tt------C----------C---------C---S----C--Ctt---S------#S----S------CU----SC------S--tttt-C--tt-----C-SStt-------#--S-------------------------------S---------
---------tt----#----------#---tt#--#-----#-tt--------------------------------tt------tt---------##-#----tt---------------------tttt----tttt----#--tt-----tt#--------------------------------------------
---------tt--#-#-------tt-#---tt#--#-----#-tt-------tt-------------------#---tt#-----tt--------###-##---tt---#-------------#---tttt---#tttt----#--tt-----tt#------------#-------------------------------
-g-------tt--#-##--g---tt-#--gtt#--#----k#-tt-----g-tt-----k-k--gg-g-k---#kg-tt#-----ttg-----k####-###g-tt-#-#---g-k-----gg#-g-tttt--g#ttttk-g-#--tt-g#-#tt#----g-g-----#-----------------gg-g-ggggggggF
-|%%%%%%%||%%|-||%%|%%%||%|%%||||%%|%%%%||%||%%-%%|%||%%--%|%|%%||%|%|%%%|||%|||-%%%%|||%%%--|||||%||||%||%|-|%%%|%|%%-%%|||%|%||||%%|||||||%|%|%%||%||%||||%%%%|%|%%%%%|%%%%%%%%%%-%%%%%%||%|%||||||||%
-|||||||||||||-||||||||||||||||||||||||||||||||-||||||||--||||||||||||||||||||||-||||||||||--|||||||||||||||-|||||||||-||||||||||||||||||||||||||||||||||||||||||||||||||||||||||||-||||||||||||||||||||
