--------------------------------------------------------------------------------------------------------------------------------------------------------------------------------------------------------
--------------------------------------------------------------------------------------------------------------------------------------------------------------------------------------------------------
--------------------------------------------------------------------------------------------------------------------------------------------------------------------------------------------------------
--------------------------------------------------------------------------------------------------------------------------------------------------------------------------------------------------------
--------------------------------------------------------------------------------------------------------------------------------------------------------------------------------------------------------
-------------B----B---------B-----B---BB----BB--------B-----------B--------------U-BB----------------U---------U---B-------------B-U----------U---------------------------------------------B-----------
-------------------C------------C------------------------------C----------------------------------------------------------------------------------------------------------------------------------------
--------------------------------------------------------------------------------------------------------------------------------------------------------------------------------------------------------
--------------------------------------------------------------------------------------------------------------------------------------------------------------------------------------------------------
--------------------------------------------------------------------------------------------------------------------------------------------------------------------------------------------------------
--------ttttU-ttU--B---#tt-U---UB----B--tt-B-----B-tt--B-------B-U--C---#--------CU---tttt---------C-C-C-------C------B--B---tt----C---B---U--C---tt--#C---ttUB-Utt-------------------------------------
--------tttt--tt-------#tt#-------------tt---------tt---------#--------##-----#-------tttt--tt----------tt------#---#--------tt-----tt------------tt-##----tt----tt-------------------------------------
--------tttt--tt----tt-#tt#--------tt---tt---------tt---------#-------###-tt--#-------tttt#-tt----------tttt----#tt-#--tt----tt-----tt------------tt###--#-tt--#-tt----------------tt-------------------
---g---#tttt-gtt-#--ttg#tt#--kg--ggtt---ttg--------ttg-----kgk#-k-g--####-tt-k#-g--g--tttt#gttg-gkk-----tttt----#tt-#--tt--gktt#g---ttk--g#----#--tt###-##-tt--#-ttk-k-------------tt------------------F
X-XXXXXXXXXXXXXXXX-XXXXXXXXX-XXXXXXXXXXXXXXX--XXXXXXXX-XXXXXXXXXXXXXXXXXXXXXXXX-XXXXXXXXXXXXXXXXXXXXXXXXXXXX-XXXXXX-XXXXXXXXXXXXXXXXXXXXXXXXXXXXXXXXXXXXXXXXXXXXXXXXXXX-XX--XX-----XX--X----------------
X-XXXXXXXXXXXXXXXX-XXXXXXXXX-XXXXXXXXXXXXXXX--XXXXXXXX-XXXXXXXXXXXXXXXXXXXXXXXX-XXXXXXXXXXXXXXXXXXXXXXXXXXXX-XXXXXX-XXXXXXXXXXXXXXXXXXXXXXXXXXXXXXXXXXXXXXXXXXXXXXXXXXX-XX--XX-----XX--X----------------
