--------------------------------------------------------------------------------------------------------------------------------------------------------------------------------------------------------
--------------------------------------------------------------------------------------------------------------------------------------------------------------------------------------------------------
--------------------------------------------------------------------------------------------------------------------------------------------------------------------------------------------------------
--------------------------------------------------------------------------------------------------------------------------------------------------------------------------------------------------------
--------------------------------------------------------------------------------------------------------------------------------------------------------------------------------------------------------
-----------------------------------S-------------------------U----------SU-S---S-S---S----------U-----------------S-------U---S------S----------------S--S-----------SS---------------------------------
--C---C-----------------------------------------------C-----------------------------------C------C-------------------------C---------------------C------------------------------------------------------
--------------------------------------------------------------------------------------------------------------------------------------------------------------------------------------------------------
--------------------------------------------------------------------------------------------------------------------------------------------------------------------------------------------------------
--------------------------------------------------------------------------------------------------------------------------------------------------------------------------------------------------------
-#SU--S------------------U--U---------------tt#-----ttS------C-------#---C--------tt--tt--S#----CS-----tt-----U-----------CS----S-C---U--##-----#S#--C-#---S----S---S--tt-------------------------------
-#------------------------------------tt-#--tt#tt---tt--------------##tt----------tt--tt---#-----------tt-------##----------tt------#----##---tt#-#----#-----#---------tt---------#----tttttttttttttttt-
##------tt-------------tt-------------tt-#--tt#tt-tttt-------------###tt------#---tt--tt---#-tt#-------tt-------##-tt-------tt------#----##---tt#-##---#-----#---------tt-#######-##-##tttttttttttttttt-
##--g---ttg-k---------gtt-------gg----tt-#--tt#tt-tttt-g-g------g-####tt---g#-#---tt-gtt---#gtt#--k-k-gtt---gg--##-ttg-kg---ttg--g--#----##-ggtt#-##---#-g#--#-----g---tt-#######-#####ttttttttttttttttF
||%%|-%%|||%|%%%--%%%%|||%%%%-%%||%-%-||%|%-|||||-||||%|%|%%%%%%|%||||||%%%||-|-%-||%|||%%%|||||%%|%|%|||-%%||%%||%|||-||-%%|||%%|%%|%%--||%|||||%||%%%|%||%%|%%%%%|%--||%|||||||-|||||||||||||||||||||%
|||||-||||||||||--|||||||||||-|||||-|-|||||-|||||-|||||||||||||||||||||||||||-|-|-|||||||||||||||||||||||-||||||||||||-||-|||||||||||||--||||||||||||||||||||||||||||--||||||||||-||||||||||||||||||||||
