--------------------------------------------------------------------------------------------------------------------------------------------------------------------------------------------------------
--------------------------------------------------------------------------------------------------------------------------------------------------------------------------------------------------------
--------------------------------------------------------------------------------------------------------------------------------------------------------------------------------------------------------
--------------------------------------------------------------------------------------------------------------------------------------------------------------------------------------------------------
--------------------------------------------------------------------------------------------------------------------------------------------------------------------------------------------------------
--S-S-----SS--S-------SSSS-----S--------S------------S--------------------S----SS--S--------------------------US--------SS----------S--U---------S------------------------------------------------------
--------------------C-----C------------------------C---------------------C-C----------------------------------------C------C----------------------------------------------------------------------------
--------------------------------------------------------------------------------------------------------------------------------------------------------------------------------------------------------
--------------------------------------------------------------------------------------------------------------------------------------------------------------------------------------------------------
--------------------------------------------------------------------------------------------------------------------------------------------------------------------------------------------------------
--------C----C------S-----S#UU----S---#S-----#-----S---#---------------S-S-S--S-----------ttC--S-#U---S-------C--UU-S--S---S---------#-C--------U----tt--------#---------------tt-----------------------
-----tt--------------#-----#---------##----#-#----#----#-------#--------------------------tt-tt-##-#-----#-------------------------#-#------------tt-tt--tt----#-tt----#-------tt-----------------------
-----tt--------------#-----#-------tt##--#-#-#----#----##-tt--##------------------#-------tt-tt-##-##----#------------------tt----##-#------#tt---tt#tt-#tt----#-tttt--#-------tt-----------------------
gk---ttg---gg-gk-g---#---g-#---gg--tt##--#-#g##g-g#--gk##ktt#-##--------g---#----k#g-g-g-gtt-tt-##-###--g#---k--k----g----k-tt-k-###-##-gkk-#tt---tt#ttg#tt-k--#gtttt-g##-#----tt----------------------F
||%--|||%--||%||%|%%%|%%%|%|%%-||%%||||%-|-|||||%||%%||||||||-||%%--%%%%|%%%|-%--|||%|%|%|||%||%||%|||%%||%%%|%-|%%%%|%%%%|%||%|%|||%||%|||%|||-%%|||||||||%|%%||||||%|||%|%%%%||%%%%%%%%%%%%%%%%%%%%%%%
|||--||||--|||||||||||||||||||-|||||||||-|-||||||||||||||||||-||||--|||||||||-|--||||||||||||||||||||||||||||||-|||||||||||||||||||||||||||||||-||||||||||||||||||||||||||||||||||||||||||||||||||||||||
