--------------------------------------------------------------------------------------------------------------------------------------------------------------------------------------------------------
--------------------------------------------------------------------------------------------------------------------------------------------------------------------------------------------------------
--------------------------------------------------------------------------------------------------------------------------------------------------------------------------------------------------------
--------------------------------------------------------------------------------------------------------------------------------------------------------------------------------------------------------
--------------------------------------------------------------------------------------------------------------------------------------------------------------------------------------------------------
-B---B---------------------------------U-BB--B----UB-U-----B-B----B---B----------------------B--------B----B--U----BB-------U--------B----BB------B---------------B-UUUUUUUUBUUUUUUUU--U--UUUUUUUUUUUUUU
--------------------C------------------------------------------------------C-------------C---------------------------------------------------C----------------------------------------------------------
--------------------------------------------------------------------------------------------------------------------------------------------------------------------------------------------------------
--------------------------------------------------------------------------------------------------------------------------------------------------------------------------------------------------------
--------------------------------------------------------------------------------------------------------------------------------------------------------------------------------------------------------
--------------------B-tt----##U--tt-#--CB-----tt--C--C-B--B---ttU#-U----C--B--------#-CC-B-----C-------C--C---CB-UC-------U-C#----tt-----B---B-----U--B-C-----------CCCCCCCC-CCCCCCCCCBCBCCCCCCCCCCCCCCC
----------------------tt----##---tt-#---------tttt----#-------tt-#-----#-------tt--##-------------#-----#--------------------#----tt----------#--#------------------------------------------------------
--#-----------#-------tttt--##-tttt##------tt-tttt----#-------tt-#-----#-tt----tt-###------tt----##-----#------------tt-tt---#-tt-tt----#-----##-#-------tt-tttt----------------------------------------
-g#--gg-k-g---#gg-k--#tttt#g##-tttt##g-----ttgtttt--k-#-k--gg-tt-#g--gg#-tt-k-ktt-###-----gtt---###g-gg-##---#-----g-ttgtt-g-#kttktt--#-#-----##-#g--g---ttgtttt-#----------g--------------------------F
XXXXXXXXXXXXXXXXXXXXXXXXXXXXXXXXXXXXXXXXXXXXXXXXXXX-XXXXXXXXX-XXXXXX-XXXXXXXXXXXXXXXXXXXXXXXX-XXXXXXXXXXXXX-XXXXXXXXXXXXXXXXXXXXXXXXXXX-XX--XXXX-XXXXXXXXXXXXXXXXX-XXXXXXXXXXXXXXXXXXXXXXXXXXXXXXXXXXXXX
XXXXXXXXXXXXXXXXXXXXXXXXXXXXXXXXXXXXXXXXXXXXXXXXXXX-XXXXXXXXX-XXXXXX-XXXXXXXXXXXXXXXXXXXXXXXX-XXXXXXXXXXXXX-XXXXXXXXXXXXXXXXXXXXXXXXXXX-XX--XXXX-XXXXXXXXXXXXXXXXX-XXXXXXXXXXXXXXXXXXXXXXXXXXXXXXXXXXXXX
