--------------------------------------------------------------------------------------------------------------------------------------------------------------------------------------------------------
--------------------------------------------------------------------------------------------------------------------------------------------------------------------------------------------------------
--------------------------------------------------------------------------------------------------------------------------------------------------------------------------------------------------------
--------------------------------------------------------------------------------------------------------------------------------------------------------------------------------------------------------
--------------------------------------------------------------------------------------------------------------------------------------------------------------------------------------------------------
----B-------B-------------------------------------B-----------BBB--B--B------U--------B-----------BBB-----B----BB-------B---------------------BB------B--------U-U--B-B---------------------------------
-----------------------C----------C-------------------------------------------------C----------------------------------------------C--------------------------------------------------------------------
--------------------------------------------------------------------------------------------------------------------------------------------------------------------------------------------------------
--------------------------------------------------------------------------------------------------------------------------------------------------------------------------------------------------------
--------------------------------------------------------------------------------------------------------------------------------------------------------------------------------------------------------
---#---C--U--U---------B---B---U--BttBC----tt-------BB#-----BU---tt-tt-------C-tt---B------------B----------#-------------U---U----BB---UU--#B--UB---------Utt-CUC##-----U-C--U--------B----------------
--##----tt--------tt---------------tt---tt-tttt-------#----------tt-tt-tt------tttt-----------tt------------#tt--------------#-------------##-----------#---tt----##---tt---tt-tttttt-------------------
-###----tt--------tt---------------tt---tt#tttt-#--#--#----------tt-tt-tt------tttt------tt---tt------------#tt--tt---tt-----#---------#---##-----------#---tt----##-#-tt---tt-tttttt-------------------
####--g-tt--------tt----k#g-k-g-k--tt---tt#tttt-#g-#--#--##---g-gtt-tt-tt-k-g--tttt---gkgttg--tt------k-----#tt-gtt-kgttg--gg#-gg-g--g##---##-----#-g---#---ttg---##g#gtt---tt-tttttt------------------F
XXXX-XXXXXXX-XXXX-XX-XXXXXXXXXXXXXXXXXX-XXXXXXX-XXXXXXX-XXXXXXXXXXXXXX-XXXXXXX-XXXXXXXXXXXXXXXXXXX--XXXXXXXXXXX-XXXXXXXXXXXXXXXXXXXXXXXXXXXXXXXXXXXXX-XXXX-XXXXXXXXXXXXXXXXXXXXXXXXXXXXXXXXXXXXXXXXXXXXX
XXXX-XXXXXXX-XXXX-XX-XXXXXXXXXXXXXXXXXX-XXXXXXX-XXXXXXX-XXXXXXXXXXXXXX-XXXXXXX-XXXXXXXXXXXXXXXXXXX--XXXXXXXXXXX-XXXXXXXXXXXXXXXXXXXXXXXXXXXXXXXXXXXXX-XXXX-XXXXXXXXXXXXXXXXXXXXXXXXXXXXXXXXXXXXXXXXXXXXX
