--------------------------------------------------------------------------------------------------------------------------------------------------------------------------------------------------------
--------------------------------------------------------------------------------------------------------------------------------------------------------------------------------------------------------
--------------------------------------------------------------------------------------------------------------------------------------------------------------------------------------------------------
--------------------------------------------------------------------------------------------------------------------------------------------------------------------------------------------------------
--------------------------------------------------------------------------------------------------------------------------------------------------------------------------------------------------------
S-----S-U---------------S--------------S---S------SS-----------------------------SS--------SU-----------------U------S----S-S-S---S---S------S--US---S-----U---U-U-------------------------S------------
-------C------------------------------------------------------------------------C--------C--------------------------------------------------------------------------------------------------------------
--------------------------------------------------------------------------------------------------------------------------------------------------------------------------------------------------------
--------------------------------------------------------------------------------------------------------------------------------------------------------------------------------------------------------
--------------------------------------------------------------------------------------------------------------------------------------------------------------------------------------------------------
-S--CS-SCC----#---CU---C------------tt-------U--#----CU--------#-------#-CC-----S--------S--C--U--------UCU---C---U------C------#--------C------C--tt--#-C-C---C-CC--US---------------------------------
--------------#-tt----------tttt----tt---tt----##---#---tttt---#-tt-tt-#---------------------------------------tt------tt-------#---------#--------tt--#-----tt-#---------------------------------------
--------------#-tt--------tttttt-#--tt---tt---###---#---tttt-tt#-tt-tt-#-------------tt------#---#----------tt-tt--tt--tt------##---------#--------tt--#-----tt-#---------------------------------------
---g--g----g-g#gtt--#----gtttttt-#-gttg--ttg--###gg-#---ttttgtt#-ttgtt##------k#--g--tt-g--g-#g--#--k------gtt-tt--ttg-tt-g----##gg#---kg-#--g---ggttg-#-----tt-#--------------------------------------F
%%%|%%|%%%%|%|||||%%|%%%-|||||||%|%||||-%|||%%|||||-|%%%||||||||%|||||||%%%%-%||%-|%%||%|%%|%||%%|-%|%%%%%%|||%||%%|||%||%|%-%%|||||%%-||%|%%|%%%|||||%|%%%%%||%|%%%%%%%%%-%%--%%--%%%%%%%-%%%%%%%%%%%%%
||||||||||||||||||||||||-||||||||||||||-|||||||||||-||||||||||||||||||||||||-||||-||||||||||||||||-|||||||||||||||||||||||||-|||||||||-|||||||||||||||||||||||||||||||||||-||--||--|||||||-|||||||||||||
