--------------------------------------------------------------------------------------------------------------------------------------------------------------------------------------------------------
--------------------------------------------------------------------------------------------------------------------------------------------------------------------------------------------------------
--------------------------------------------------------------------------------------------------------------------------------------------------------------------------------------------------------
--------------------------------------------------------------------------------------------------------------------------------------------------------------------------------------------------------
--------------------------------------------------------------------------------------------------------------------------------------------------------------------------------------------------------
------B-B----------U--U--B--------------------------B------------B----B-U---BU--UU-----B-------------U--B----B--B------------U------------B--------U---BB-----------------------------------------------
-------------------------------------------C-----C---------------------C--------------------------------------------------------C----------------C------------------------------------------------------
--------------------------------------------------------------------------------------------------------------------------------------------------------------------------------------------------------
--------------------------------------------------------------------------------------------------------------------------------------------------------------------------------------------------------
--------------------------------------------------------------------------------------------------------------------------------------------------------------------------------------------------------
---#U------tt---B--CC-C-C-#UU-U------------BU-tt-B---U----------#-#----BC----C-#CCU---C----tt----Utt-Ctt-----------tt-------#C--B-----------tt#-BB-CUCB-------------tttttt-tttttttt----tttttttttttttttt-
---#-----#-tttt-----------#-------#tt---------tt-----------#-#-##-#------------#----#------tt-----tt#-tt------tt---tt-------#----#--#-------tt#---------------------tttttt-tttttttt----tttttttttttttttt-
tt-#-----#-tttt--tt-------#--#---##tt-----#---tt---#------##-####-#-tt---tt----#----#-----#tt---#-tt#-tt------tt---tt-------#----##-##------tt#-------------------tttttttt-tttttttttttttttttttttttttttt-
tt-#---g-#gtttt#-tt-------#--#--k##ttg-g-g#---ttk--#--##-###-####-#-tt---tt----#----#----g#tt-#-#-tt#-ttgg#---ttgg-ttk-k-g-k#-gk-##-###----ktt#---k--------kk#gg-gttttttttkttttttttttttttttttttttttttttF
XX-XXX-X-XXXXXXXXXXXXXXXX-XXXXXXXXXXXX-XXXXXXXXXXXXX-XXXXXXX-XXXXXXXXX-XXXXX-XXXXXXXXXXXXXXXXXX-XXXXXXXXXXXXX-XXXXXXXXXXXXXXXXXXXXX-XXXXXXXXXXXXXXXXXXX---XXXXXXXXXXXXXXXXXXXXXXXXXXXXXXXXXXXXXXXXXXXXXX
XX-XXX-X-XXXXXXXXXXXXXXXX-XXXXXXXXXXXX-XXXXXXXXXXXXX-XXXXXXX-XXXXXXXXX-XXXXX-XXXXXXXXXXXXXXXXXX-XXXXXXXXXXXXX-XXXXXXXXXXXXXXXXXXXXX-XXXXXXXXXXXXXXXXXXX---XXXXXXXXXXXXXXXXXXXXXXXXXXXXXXXXXXXXXXXXXXXXXX
