--------------------------------------------------------------------------------------------------------------------------------------------------------------------------------------------------------
--------------------------------------------------------------------------------------------------------------------------------------------------------------------------------------------------------
--------------------------------------------------------------------------------------------------------------------------------------------------------------------------------------------------------
--------------------------------------------------------------------------------------------------------------------------------------------------------------------------------------------------------
--------------------------------------------------------------------------------------------------------------------------------------------------------------------------------------------------------
-----U------------------S-S------------S----S----SS----S------S-------S-S--U--S--U------------------U-S--------SS--S---------S-S--------U-U----------S-------S----S-U---S-----------------U---U---------
-----------------------------------------------------C-----------------------------------C-C-------------------------------------C----------------------------------------------------------------------
--------------------------------------------------------------------------------------------------------------------------------------------------------------------------------------------------------
--------------------------------------------------------------------------------------------------------------------------------------------------------------------------------------------------------
--------------------------------------------------------------------------------------------------------------------------------------------------------------------------------------------------------
S----C--#-C----------C---#-----------U#-------S-S----SU-U---tt-----------ttC-----C-#--#C-S-S--------C---------U------CU----------Stttt--C-C-tt---#----C-##--C-U-tt--C----SSSSSSSS-SSSSSSSSCSCSCSS-SSSSSS
--------#-----#--tt------#---#-tt--tt-#------#-----tt-----tttt-----------tt--------#-##--------------------#tt---#-----tt#--------tttt------tt---#tt----##tt---#tt--------------------------------------
--------#--tt-#tttt------#--##-tt--tt-#---#--#-#---tt----#tttt----#-tt---tt-tt-tt--####--------------------#tt---#--#--tt##-------tttt---#--tt---#tt----##tt---#tt--------------------------------------
--g-g-kg#g-tt-#tttt----gg#g###ktt-gtt-#---#g-#-#---tt----#tttt-g-##-tt--gtt-ttgtt--####-g---k-k-g-------#-g#tt---#--#--tt###-g-gg-tttt-g-#-ktt-g-#ttg--k##tt-g-#tt---g-k-------------------------------F
%%|%|%||||%||-|||||%%%%||||||||||%|||%|-%%||-|%|%%%||%%%%|||||%|-||-||%%|||%|||||%%||||%|%-%|%|%|%%%%%-%|%||||%-%|%-|%%|||||%|-||%||||-|%|%|||%|%||||-%|||||%|%|||-%%|%|-%%%%%%%%%%%%%%%%%%%%%%%%%%%%%%%
|||||||||||||-|||||||||||||||||||||||||-||||-|||||||||||||||||||-||-||||||||||||||||||||||-|||||||||||-||||||||-|||-||||||||||-|||||||-||||||||||||||-||||||||||||-|||||-|||||||||||||||||||||||||||||||
