--------------------------------------------------------------------------------------------------------------------------------------------------------------------------------------------------------
--------------------------------------------------------------------------------------------------------------------------------------------------------------------------------------------------------
--------------------------------------------------------------------------------------------------------------------------------------------------------------------------------------------------------
--------------------------------------------------------------------------------------------------------------------------------------------------------------------------------------------------------
--------------------------------------------------------------------------------------------------------------------------------------------------------------------------------------------------------
BU-------------B------B-----B---------B--B------------BB-B---------B-B------BB-------------------------------------B-------B------B-----B--------B----------B--U-------U-----BBBB-BBBBUBBBBB-BBBBBBBBBBB
------------------C------------------------C-------C-------------------C-----------------------------------------------C--------------------C---------C---------------C---------------------------------
--------------------------------------------------------------------------------------------------------------------------------------------------------------------------------------------------------
--------------------------------------------------------------------------------------------------------------------------------------------------------------------------------------------------------
--------------------------------------------------------------------------------------------------------------------------------------------------------------------------------------------------------
-C-#------#-----U-B--------#-UU------------B------CBU------U-#U-B------BUU----------------------------------#BB--tt----B----B--#---tt-----BCBCC-#-C-C-Btttt----C------BC--#U-----B----C-----#-----------
---#------#---#--#-tt------#---------#----------#----#-------#---tt--------------#-------------tt--#--------#----tt-tt--------##---tt-----------#------tttt--tt-----------#-----------------#-----------
---#-tt---#---#--#-tt------#---#---#-#-tt-------#----#-------#---tt-------------##-----------tttttt##-------#----tt-tt--##---###tt-tt-----------#------tttt--tt------#---##-----------------#-----------
---#ktt#--#---#g-#-tt--g-g-#---#gg-#-#-tt-k----k#g---#-g-gk--#---ttg-------#gg-###-gk-k-g--gktttttt###g-k--g#--#-tt-tt--##gg-###ttgtt-ggg-------#g-----ttttg-tt---g#-#---##--g--------------#----------F
XXXXXXXXXXXXXXXXXXXXXXXXXXXX-XXXXXXX-X-XX-XXXXXXXXXXXXXX-XXXXXXXXXXXXX-XXXXXXXXXXX-XXXXXXXXXXXXXXXXXXXXXXXXXXXXXXXXXXXXXXXXXXXXXXXXXXXXXXXXXXXXXXXXXXXXXXXXXXXXX--XX-XXXXXXXXXXXXXXXXXXXXXXXXXXXXXXXXXXX
XXXXXXXXXXXXXXXXXXXXXXXXXXXX-XXXXXXX-X-XX-XXXXXXXXXXXXXX-XXXXXXXXXXXXX-XXXXXXXXXXX-XXXXXXXXXXXXXXXXXXXXXXXXXXXXXXXXXXXXXXXXXXXXXXXXXXXXXXXXXXXXXXXXXXXXXXXXXXXXX--XX-XXXXXXXXXXXXXXXXXXXXXXXXXXXXXXXXXXX
