--------------------------------------------------------------------------------------------------------------------------------------------------------------------------------------------------------
--------------------------------------------------------------------------------------------------------------------------------------------------------------------------------------------------------
--------------------------------------------------------------------------------------------------------------------------------------------------------------------------------------------------------
--------------------------------------------------------------------------------------------------------------------------------------------------------------------------------------------------------
--------------------------------------------------------------------------------------------------------------------------------------------------------------------------------------------------------
B-----B-U---------------B--------------B---B------BB-----------------------------BB--------BU-----------------U------B----B-B-B---B---B------B--UB---B-----U---U-U-------------------------B------------
-------C------------------------------------------------------------------------C--------C--------------------------------------------------------------------------------------------------------------
--------------------------------------------------------------------------------------------------------------------------------------------------------------------------------------------------------
--------------------------------------------------------------------------------------------------------------------------------------------------------------------------------------------------------
--------------------------------------------------------------------------------------------------------------------------------------------------------------------------------------------------------
-B--CB-BCC----#---CU---C------------tt-------U--#----CU--------#-------#-CC-----B--------B--C--U--------UCU---C---U------C------#--------C------C--tt--#-C-C---C-CC--UB---------------------------------
--------------#-tt----------tttt----tt---tt----##---#---tttt---#-tt-tt-#---------------------------------------tt------tt-------#---------#--------tt--#-----tt-#---------------------------------------
--------------#-tt--------tttttt-#--tt---tt---###---#---tttt-tt#-tt-tt-#-------------tt------#---#----------tt-tt--tt--tt------##---------#--------tt--#-----tt-#---------------------------------------
---g--g----g-g#gtt--#----gtttttt-#-gttg--ttg--###gg-#---ttttgtt#-ttgtt##------k#--g--tt-g--g-#g--#--k------gtt-tt--ttg-tt-g----##gg#---kg-#--g---ggttg-#-----tt-#--------------------------------------F
XXXXXXXXXXXXXXXXXXXXXXXX-XXXXXXXXXXXXXX-XXXXXXXXXXX-XXXXXXXXXXXXXXXXXXXXXXXX-XXXX-XXXXXXXXXXXXXXXX-XXXXXXXXXXXXXXXXXXXXXXXXX-XXXXXXXXX-XXXXXXXXXXXXXXXXXXXXXXXXXXXXXXXXXXX-XX--XX--XXXXXXX-XXXXXXXXXXXXX
XXXXXXXXXXXXXXXXXXXXXXXX-XXXXXXXXXXXXXX-XXXXXXXXXXX-XXXXXXXXXXXXXXXXXXXXXXXX-XXXX-XXXXXXXXXXXXXXXX-XXXXXXXXXXXXXXXXXXXXXXXXX-XXXXXXXXX-XXXXXXXXXXXXXXXXXXXXXXXXXXXXXXXXXXX-XX--XX--XXXXXXX-XXXXXXXXXXXXX
