--------------------------------------------------------------------------------------------------------------------------------------------------------------------------------------------------------
--------------------------------------------------------------------------------------------------------------------------------------------------------------------------------------------------------
--------------------------------------------------------------------------------------------------------------------------------------------------------------------------------------------------------
--------------------------------------------------------------------------------------------------------------------------------------------------------------------------------------------------------
--------------------------------------------------------------------------------------------------------------------------------------------------------------------------------------------------------
--------------------U---B-----U-------U----------U-UB--------BB-----B---------------B-U--B-B--U---U--B---------------B-B---------U--------------------------------------------U-------------------------
---------------------------CC-----------C------------------------C-------------------------------------C---------------------------------------C--------------------------------------------------------
--------------------------------------------------------------------------------------------------------------------------------------------------------------------------------------------------------
--------------------------------------------------------------------------------------------------------------------------------------------------------------------------------------------------------
--------------------------------------------------------------------------------------------------------------------------------------------------------------------------------------------------------
tt---U-tt----#------C-----BBB#Ctt-----C-Btt------C-C-#--#-U-B--CUB---UU---------------C-----C-C-CBCBC-CB----------------BCC-#tt-BC--#--------#UBB-----------------------------C-------------------------
tt-----tt----#--#------------#-tt--------tttt--------#--#-----------------------------------------------------#tt#----------#tt----##-------##----------------------------------------------------------
tt-----tttttt#tt#------------#-tt--------tttt---#----#--#---------tt---tt------------------------------------##tt##---------#tt----##----tt###---###tt#########--#######-#-tt#-###tt####################
ttg-k--tttttt#tt#gk--g-#g#---#-tt-k--#-#-tttt-kk#----#g-#---------tt---ttk-g--------g--#g---------------g-g-###tt###-ggg----#ttg---##kg-gtt###---###tt##########-#######-#ktt#-###tt###################F
XXXXXX-XXXXXXXXXXXXXXXXXXXXXXXXXXXXXXXXXXXXXX-XXXXXX-XXXXXXXXXXXXXXXXXXXXXXXXXX--XXXXXXXXXX-XXXXXXXXX-XXXXX-XXXXXXXXXXXXXXXXXXXXXXXXXXXXXXXXXXXXXXXXXXXXXXXXXXXX-XXXXXXXXXXXXXXXXXXXXXXXXXXXXXXXXXXXXXXX
XXXXXX-XXXXXXXXXXXXXXXXXXXXXXXXXXXXXXXXXXXXXX-XXXXXX-XXXXXXXXXXXXXXXXXXXXXXXXXX--XXXXXXXXXX-XXXXXXXXX-XXXXX-XXXXXXXXXXXXXXXXXXXXXXXXXXXXXXXXXXXXXXXXXXXXXXXXXXXX-XXXXXXXXXXXXXXXXXXXXXXXXXXXXXXXXXXXXXXX
