--------------------------------------------------------------------------------------------------------------------------------------------------------------------------------------------------------
--------------------------------------------------------------------------------------------------------------------------------------------------------------------------------------------------------
--------------------------------------------------------------------------------------------------------------------------------------------------------------------------------------------------------
--------------------------------------------------------------------------------------------------------------------------------------------------------------------------------------------------------
--------------------------------------------------------------------------------------------------------------------------------------------------------------------------------------------------------
--------U-UBU-----B--------B-------B-------B---B---U-BU-B-----U----BB------U------BU----B--B-B---BB-------------------------BB-B-UB----------BB-------------------U---U--------------------B------------
----------------------------C-------------------------------------------------------------------------------------------------------------------------------C-C-----------------------------------------
--------------------------------------------------------------------------------------------------------------------------------------------------------------------------------------------------------
--------------------------------------------------------------------------------------------------------------------------------------------------------------------------------------------------------
--------------------------------------------------------------------------------------------------------------------------------------------------------------------------------------------------------
-tttt---C#C-C----U----------B-----C----#-----------C--C#-C----C-C#C--------C--ttB--C------C-#--BB--U-U------#tt-----------tt-----C-tt--BBBBBB--B--BBBBBB-BBBBBBBBBCBCBCBBBCBB-BBBBBBBBBBBBB-BBBBBBBttBBB
-tttt----#----#------tt-#-------------##---------------#---tt--#-#----------tttt------------#---------------#tt-----------tt-------tt-#------------------------------------------------------------tt---
-tttt----#----##---tttt##------------###------#--------#---tt--#-#----tt-tt-tttt------------#---------------#tt-----------tt-------tt-#------------------------------------------------------------tt---
-ttttk-k-#---k###--tttt##----g-k-g--####-#--#-#g--g-k--#---tt--#-#-ggktt-tt-tttt-k--gg#ggg--#g--------g-g-#g#tt------g-g--tt---g---tt-#------------------------------------------------------------tt--F
XXXXXXXXXXXXXXXXXX-XXXXXXX-XXXXXXXX-XXXX-X--X-XX-XXXXXXX-XXXXXXXXXXXXXXX-XXXXXXXXX-XXXXXXXX-XXXXX--XXXXXXXXXXXXX--XXXXXXXXXXXXXXXX-XXXXXXXXXXX-XXXXXXXXXXXXXXXXXXXXXXXXXXXXXXXXXXXXXXXXXXXX-XXXXXXXXXXXX
XXXXXXXXXXXXXXXXXX-XXXXXXX-XXXXXXXX-XXXX-X--X-XX-XXXXXXX-XXXXXXXXXXXXXXX-XXXXXXXXX-XXXXXXXX-XXXXX--XXXXXXXXXXXXX--XXXXXXXXXXXXXXXX-XXXXXXXXXXX-XXXXXXXXXXXXXXXXXXXXXXXXXXXXXXXXXXXXXXXXXXXX-XXXXXXXXXXXX
