--------------------------------------------------------------------------------------------------------------------------------------------------------------------------------------------------------
--------------------------------------------------------------------------------------------------------------------------------------------------------------------------------------------------------
--------------------------------------------------------------------------------------------------------------------------------------------------------------------------------------------------------
--------------------------------------------------------------------------------------------------------------------------------------------------------------------------------------------------------
--------------------------------------------------------------------------------------------------------------------------------------------------------------------------------------------------------
---B-------------BB---U-----------U----------------------------UB------U-----------------B--U--UB---U--U-----BBB-------B---BB-B-B-----------------------B-B-----B---U--B--------BBB---------------------
-------------------------------C-------------------C----C----C-------------------C----------------------------------C---------------------C----------------CC---------C-------------C-------------------
--------------------------------------------------------------------------------------------------------------------------------------------------------------------------------------------------------
--------------------------------------------------------------------------------------------------------------------------------------------------------------------------------------------------------
--------------------------------------------------------------------------------------------------------------------------------------------------------------------------------------------------------
tt--------------B-----C--U-tt--BttC-tt--ttB---C----B----B----B-C-------C---------B---#ttU---C--C-BC-C--C------------B-----#----------B--#-B-#-C----B--tt---BBU----#-C-B--B----U-----B-------------------
tt-----#--tt------------#--tt#--tt--tt--tt-tt---------------------------------tt-----#tt------------------#----------tt-tt#------tttt--##---#---------tt----------#-----#-------------------------------
tt--#--##-tt--------tt--#--tt#--tt--tt--tt-tt--tt------------------tt-------tttt--tt-#tt-----tt----------##tt---tttt-tt-tt#------tttt-###---#---------tt----------#-----#---#--------###################
tt--#-####tt-g-g----tt--#--tt#--tt--tt-#tt-tt--ttkg--k-k---k--#-g#gtt-#--g--tttt--ttk#tt---#-tt-------g-###tt-g-tttt-ttgtt#-g----tttt-###---#--g-k--kgtt-k-----g-g#g-g--#-#-#--gg-g--##################F
XXXXXXXXXXXXXXXXXXX-XXXXXXXXXXXXXXXXXXXXXXXXXXXXXXXXXXXXXXXXXXXXXXXXXXXXXX-XXXXX-XXXXXXXXXXXXXXXXXXXXXXXXXXXXXX-XXXXXXXXXXXXXX-XXXXXXXXXXXXXXXXXXXXXXXXX-XXXXX-XXXXXXXXXXXX-XXXXXXXXXXXXXXXXXXXXXXXXXXXX
XXXXXXXXXXXXXXXXXXX-XXXXXXXXXXXXXXXXXXXXXXXXXXXXXXXXXXXXXXXXXXXXXXXXXXXXXX-XXXXX-XXXXXXXXXXXXXXXXXXXXXXXXXXXXXX-XXXXXXXXXXXXXX-XXXXXXXXXXXXXXXXXXXXXXXXX-XXXXX-XXXXXXXXXXXX-XXXXXXXXXXXXXXXXXXXXXXXXXXXX
