--------------------------------------------------------------------------------------------------------------------------------------------------------------------------------------------------------
--------------------------------------------------------------------------------------------------------------------------------------------------------------------------------------------------------
--------------------------------------------------------------------------------------------------------------------------------------------------------------------------------------------------------
--------------------------------------------------------------------------------------------------------------------------------------------------------------------------------------------------------
--------------------------------------------------------------------------------------------------------------------------------------------------------------------------------------------------------
BBB-B-------------B---UB---B--------------U------B-------------------BBB--B------------U---B--B-----------------B----UU----------B-B------------B------------------B------------------------------------
---------------------------------------------------------------------------------------------------------------------------------------------C----------------------C-----------------------------------
--------------------------------------------------------------------------------------------------------------------------------------------------------------------------------------------------------
--------------------------------------------------------------------------------------------------------------------------------------------------------------------------------------------------------
--------------------------------------------------------------------------------------------------------------------------------------------------------------------------------------------------------
---C---B------------CCC-tt--tt#B-U----ttttC-------Btt---#-tt-------------------Btt--B--C----tt-C#------#CU--------tt-CC-----------C--CB-----#B-#----U-#tt-CC---C----B----B------------------------------
-----------#------------tt--tt#-------tttt---------tt---#-tt--#--tt-------------tt-#-tt-----tt--##----##-----tt--#tt----------tt------------#--#-#----#tt----#------------------------------------------
---------#-#------------tt#-tt#-#---#-tttt---------tttt-#-tttt##-tttt--------tt-tt-#-tt-----tt--##---###---tttt--#tt----------tt-------tt-tt#--#-#----#tt----#---------#----tttttttttttttttt-tttttttttt-
gg--ggk--#-##g-g--------tt#-tt#-#--g#-tttt-k-g-----tttt-#-tttt###tttt---#ggkgtt-ttg#-tt--g--tt--##g-####---tttt-g#tt----g-k---tt-g-g---tt-tt#--#-##--k#tt----#k----g-#-#k-g-tttttttttttttttt-ttttttttttF
XXXXXXXXXX-XXXXXXXX-XXXXXXXXXXXXXXXXX-XXXXXXXXXXXXXXXXX-XXXXXXXXXXXXXXXXXXXXXXXXXXXXXXXXXXX-XXXXXXX-XXXXXXXXXXX-XXXXXXXXXXXXXXXX-XXX-XXXX-XXXXXXXXXXXXXXXXXXXXXXXX-XXX-XXXXXXXXXXXXXXXXXXXXXXXXXXXXXXXXX
XXXXXXXXXX-XXXXXXXX-XXXXXXXXXXXXXXXXX-XXXXXXXXXXXXXXXXX-XXXXXXXXXXXXXXXXXXXXXXXXXXXXXXXXXXX-XXXXXXX-XXXXXXXXXXX-XXXXXXXXXXXXXXXX-XXX-XXXX-XXXXXXXXXXXXXXXXXXXXXXXX-XXX-XXXXXXXXXXXXXXXXXXXXXXXXXXXXXXXXX
