--------------------------------------------------------------------------------------------------------------------------------------------------------------------------------------------------------
--------------------------------------------------------------------------------------------------------------------------------------------------------------------------------------------------------
--------------------------------------------------------------------------------------------------------------------------------------------------------------------------------------------------------
--------------------------------------------------------------------------------------------------------------------------------------------------------------------------------------------------------
--------------------------------------------------------------------------------------------------------------------------------------------------------------------------------------------------------
--U-SS------------US-------------------S-----------S---------S-----------------S----S----------------------------U-----S-------U---S---SS--------S-U------S----S---S-------S--S--S----------------------
---------------------------------C---------------------------------------------------C------------------------------------C-C------------C--C-----------------------------------------------------------
--------------------------------------------------------------------------------------------------------------------------------------------------------------------------------------------------------
--------------------------------------------------------------------------------------------------------------------------------------------------------------------------------------------------------
--------------------------------------------------------------------------------------------------------------------------------------------------------------------------------------------------------
CSCS--------------C---#CU--------S-------S---C-C-SU-------#C--#---------#-ttU---C----S----tt---U---SSS-C---------C-S--U--SSSS--C-SC------S--SU----#C-------------------S----U---------------------------
--------tt-----tt-----#----tt------tt---#--tt-------------#---#---------#-tt-tt-------tt--tt-----------------#---------------#--------------------#-----tt---tt-----------------------------------------
--------tttt---tt---tt#----tt-tt---tt---#--tt-------------#---#---------#-tt-tt-------tt-#tt-----------------#---------------#----------------tt--#---tttt---tt---#-----tt------------------------------
-------kttttg--tt#-gtt#----tt-ttg-#tt--g#-ktt-g----g-k-g--#---#-k---k-g-#gtt-tt-------ttk#tt-g#-g-------g-g--#g-k----g--g----#g----g#kkgg-g---tt#-#-g#tttt---tt---#-----ttgg-gg-#-kkk-k----------------F
%%%%---||||||%-|||%||||%%%%||%|||%|||%%||%|||%|%-%%|%|%|%%|%%%|%|%%%|%|-||||%||-%%-%-%||||||%||%|-%%%%%%|%|-%||%|%%%-|%-|%%%%||%%%%||||||%|-%%|||%|%||||||-%%||%%%|%-%-%||||%||-|%|||%|%%%%%%%%%%%%%%%%%
||||---|||||||-|||||||||||||||||||||||||||||||||-||||||||||||||||||||||-|||||||-||-|-||||||||||||-|||||||||-||||||||-||-|||||||||||||||||||-||||||||||||||-|||||||||-|-||||||||-||||||||||||||||||||||||
