--------------------------------------------------------------------------------------------------------------------------------------------------------------------------------------------------------
--------------------------------------------------------------------------------------------------------------------------------------------------------------------------------------------------------
--------------------------------------------------------------------------------------------------------------------------------------------------------------------------------------------------------
--------------------------------------------------------------------------------------------------------------------------------------------------------------------------------------------------------
--------------------------------------------------------------------------------------------------------------------------------------------------------------------------------------------------------
--------------------------------S-----S----U------------SS---------SS-S---S---------S--S--------------------------------S-S-----S--S------------U-U-------SSS-S----S------------------------------------
------------------------------C------------------------------------------C-----------------------------C-C-C----------C------------------------------C-------------------C---C--------------------------
--------------------------------------------------------------------------------------------------------------------------------------------------------------------------------------------------------
--------------------------------------------------------------------------------------------------------------------------------------------------------------------------------------------------------
--------------------------------------------------------------------------------------------------------------------------------------------------------------------------------------------------------
--CSS--U----------#--S--------S--------tt--Ctt-C-#S-U--S---C--ttS-U----C#S--------C---#-S------------#-S-SCSU--tt-----SC---tt--------U-tt------CC-C--S---S-----U---------S---S-------------------tt-----
---------#--tt----#---------------tt---tttt-tt---#------------tt--------#----tt-------#-------------##---------tt----------tt--#-------tt---------------------------#--tt-###-#--###-############tt#####
---------##-tt----#tt-----#----#--tt---tttt-tt---#-#----------tt--------#----tt-------#--tt--------###---------tt----------tt--#-tt---#tt----------#---tt----#------#--tt-###-##-###-############tt#####
--------k###tt-k-g#tt-#-#-#g---#--tt--gtttt-tt---#-#--g-----g-tt---g----#----ttk#---g-#--tt-------####--g-----gtt-g-g-----gttg-#-tt-k-#tt#-k-gk----##--tt----#---#--##-tt-###-##-###-############tt####F
%%%%%%-%||||||%|%||||%|%|-||%%%|--||%%|||||%||-%-|%|%%|%%%%%|%||%%%|%-%%|%-%%||||%%%|%|-%||%%%--%%||||%%|%%%%%|||%|%|-%%%%||||%|%||%|%||||%|-||%%%%||%%||%--%|%%%|%-||%||%|||%||-|||%||||||||||||||||||%
||||||-||||||||||||||||||-||||||--||||||||||||-|-||||||||||||||||||||-||||-||||||||||||-||||||--|||||||||||||||||||||-||||||||||||||||||||||-|||||||||||||--|||||||-||||||||||||-|||||||||||||||||||||||
