--------------------------------------------------------------------------------------------------------------------------------------------------------------------------------------------------------
--------------------------------------------------------------------------------------------------------------------------------------------------------------------------------------------------------
--------------------------------------------------------------------------------------------------------------------------------------------------------------------------------------------------------
--------------------------------------------------------------------------------------------------------------------------------------------------------------------------------------------------------
--------------------------------------------------------------------------------------------------------------------------------------------------------------------------------------------------------
----B--B--------------BB-----------UBUB-B-B-B-------------------BU--BB---B-------B--------------------------B-BBU-BB-B---U---------------------B--------B---UU-BB--B--------B----BB---------------------
-------------C----C----------C----------------------C-C-------------------------------------------C-------------------------------------C-----C---------------------------------C-----------------------
--------------------------------------------------------------------------------------------------------------------------------------------------------------------------------------------------------
--------------------------------------------------------------------------------------------------------------------------------------------------------------------------------------------------------
--------------------------------------------------------------------------------------------------------------------------------------------------------------------------------------------------------
U-------U--#-BBUttBB---------B-U---C-C---C-#--------B-B---C-U----C-B--U-#----------------C---Btt-#B-------------CB------CC-#-----#B-#---B-tt-CB---U------#ttCCC--tt------B------B--BBBBBBBB-BBBBBBBBBBBB
-----------#----tt--------------##---------#-----tt----tt--#---#--------#---------------------tt-#---#-----#---------------#-----#--#-----tt-----------#-#tt-----tt-----------tt------------------------
-----#---tt#----tt--tt--tt#-----##---------#-tt-#tt----tt--#---#--------#---------------------tt-#-#-#-----#----------#----##tttt#--##-#--tt---------tt#-#tt-----tt-----------tt------------------------
--ggg#k--tt#----tt--tt-gtt##----##g-g------#gtt-#tt----tt--#-g-#--k----k#-g-g-------kg-kg-----tt-#-#-#-k-gk#----------#g--g##tttt#--##-#--tt-------gktt#-#tt---ggttggkgkg--k-gtt--g--------------------F
XXXXXXXXXXXX-XXXXXXXXX-XXXXXXXXXXXXXXXXXXX-XXXX-XXXXXXXXXXXXXXXXXXXX--XXX-XXXXXXXXXXXXXXXXXXXXXX-XXX-XXXXXXXX-X-XXXX-XXXXXXXXXXXXXX-XXXXXXXX-XX--XXXXXXXXXXXXXXXXXXXXXXXXX-XXXXXX-XXXXXXXXXXXXXXXXXXXXXX
XXXXXXXXXXXX-XXXXXXXXX-XXXXXXXXXXXXXXXXXXX-XXXX-XXXXXXXXXXXXXXXXXXXX--XXX-XXXXXXXXXXXXXXXXXXXXXX-XXX-XXXXXXXX-X-XXXX-XXXXXXXXXXXXXX-XXXXXXXX-XX--XXXXXXXXXXXXXXXXXXXXXXXXX-XXXXXX-XXXXXXXXXXXXXXXXXXXXXX
