--------------------------------------------------------------------------------------------------------------------------------------------------------------------------------------------------------
--------------------------------------------------------------------------------------------------------------------------------------------------------------------------------------------------------
--------------------------------------------------------------------------------------------------------------------------------------------------------------------------------------------------------
--------------------------------------------------------------------------------------------------------------------------------------------------------------------------------------------------------
--------------------------------------------------------------------------------------------------------------------------------------------------------------------------------------------------------
-----BB------B----------B---------BBBU-------------------------U---BB--B---------BB-----------U-------------B--------------B---U-----BB---B---------B--------B------------------------------------------
----------------C----------------------------------------C------------------------------------------------------------------------------------C---------------------------------------------------------
--------------------------------------------------------------------------------------------------------------------------------------------------------------------------------------------------------
--------------------------------------------------------------------------------------------------------------------------------------------------------------------------------------------------------
--------------------------------------------------------------------------------------------------------------------------------------------------------------------------------------------------------
#---B--tt-------B---C----------------C----------#-----tt-B-----C--B--B-----CB-tt---ttC-tt-----C---------tt----BC-tt-----------BCB-tt---#------BB--#--B----U-----tt-CUtttttttttttttttttttttttttttttttttt-
#------tttt-#----#tt-------#-----------tt------##-tt--tt----------------------tt#--tt--tt----#----------tt-------tt------tt-------tt---#----------#---tt--------tt---tttttttttttttttttttttttttttttttttt-
#-tt---tttt-#-tt-#tt--#----##--#tt-----tt#----###-tt--tt---tt-----------#tt---tt#--tt--tt-tt-#--#-#-----tt---#---tt------tt-tt----tt---#---tt---tt#---tt----#---tt---tttttttttttttttttttttttttttttttttt-
#-tt---ttttg#gtt-#tt--#----###-#tt-g--gtt#g-g####gtt--ttg--tt#g-------k-#tt--ktt#-gtt-gtt-tt-#-##g#-----tt--g#---tt-k-g--tt-tt---gttkg-##--tt---tt#-g-tt#--g#g--tt---ttttttttttttttttttttttttttttttttttF
XXXXX--XXXXXXXXXXXXXXXXXXXXXXX-XXXXXXXXXXXXXXXXXXXXXXXXXXXXXXXXXXXXXXXX-XXXXXXXXX-XXXXXXXXXX-XXXXXXX--XXXXXXXXXXXXXXXXXXXXX-XXXXXXXXXX-XXX-XXXXXXXXXXXXXXXXXXXXXXXXXXXXXXXXXXXXXXXXXXXXXXXXXXXXXXXXXXXXX
XXXXX--XXXXXXXXXXXXXXXXXXXXXXX-XXXXXXXXXXXXXXXXXXXXXXXXXXXXXXXXXXXXXXXX-XXXXXXXXX-XXXXXXXXXX-XXXXXXX--XXXXXXXXXXXXXXXXXXXXX-XXXXXXXXXX-XXX-XXXXXXXXXXXXXXXXXXXXXXXXXXXXXXXXXXXXXXXXXXXXXXXXXXXXXXXXXXXXX
