--------------------------------------------------------------------------------------------------------------------------------------------------------------------------------------------------------
--------------------------------------------------------------------------------------------------------------------------------------------------------------------------------------------------------
--------------------------------------------------------------------------------------------------------------------------------------------------------------------------------------------------------
--------------------------------------------------------------------------------------------------------------------------------------------------------------------------------------------------------
--------------------------------------------------------------------------------------------------------------------------------------------------------------------------------------------------------
---------U-S-----S-SUU-----------------S-----------------U------------U--------------S-----S-------------S-----S----SS-----S--------------------SS---S--S-------S-------------U--U----------------------
----C-----------C--------C--CC---------------------------------------------------------C-----------------------------------------------C----------------------------------------------------------------
--------------------------------------------------------------------------------------------------------------------------------------------------------------------------------------------------------
--------------------------------------------------------------------------------------------------------------------------------------------------------------------------------------------------------
--------------------------------------------------------------------------------------------------------------------------------------------------------------------------------------------------------
S---S--ttCS-----S---CC---S--SStt-C-C--------------UC-----CC--------C--C--U---U---#-----S-----S---------tt-----------------------------#S-#SCUS------------CS------C-----------C#-Ctttttttttttttttttttttt
-------tt---------------------tt----------------------#--------#----tt------#----#--------#------tt----tt----------------------------##-##-------------------#-----#--#--------#--tttttttttttttttttttttt
-------tt---------------------tt----tt--tt-tt---------##---tt--#----tt--#--##----##-------#-----#tt--tttt---tt----tt----------------###-##----tt-------------#-----##-#----tt--#--tttttttttttttttttttttt
-g---gktt--gg-k-------#---g#--ttg-g-tt--tt-ttk-k-g---g###--ttgg#----tt--#-###----##g------#-g-#-#tt-kttttg--ttk-g-tt--g-gg---g-k#---###-##----tt--g--g-g-g--k#-kg--##-#--g-tt--#--tttttttttttttttttttttF
%|%%%||||%%||-|%%-%-%%|%%%||%%|||%|%||%-||%|||%|%|%%-||||%%|||||-%-%||%-|%|||%%%%|||%-%%%%|-|%|-|||%||||||%%|||-|%||-%|%||%%%|%||%%%|||%||%%%%||%%|%%|-|%|%%||-||%%||-|%%|%||-%|-%|||||||||||||||||||||%
|||||||||||||-|||-|-|||||||||||||||||||-||||||||||||-|||||||||||-|-||||-|||||||||||||-|||||-|||-|||||||||||||||-||||-|||||||||||||||||||||||||||||||||-|||||||-||||||-|||||||-||-|||||||||||||||||||||||
