--------------------------------------------------------------------------------------------------------------------------------------------------------------------------------------------------------
--------------------------------------------------------------------------------------------------------------------------------------------------------------------------------------------------------
--------------------------------------------------------------------------------------------------------------------------------------------------------------------------------------------------------
--------------------------------------------------------------------------------------------------------------------------------------------------------------------------------------------------------
--------------------------------------------------------------------------------------------------------------------------------------------------------------------------------------------------------
--S--------------U-S--S----SS----------SS-------------S---------------------S-----U---SS----S------------S-----S----------S-----S-----SS-------S---------S--SSS-----------------SS-S-SSS----------------
-C---------------------C------------------------------------------------------------C---------------------C---------------------------------------------------------------------------------------------
--------------------------------------------------------------------------------------------------------------------------------------------------------------------------------------------------------
--------------------------------------------------------------------------------------------------------------------------------------------------------------------------------------------------------
--------------------------------------------------------------------------------------------------------------------------------------------------------------------------------------------------------
-S--C----#-S-----C-----SUtt--------------tt--------tt#-S-----Utttt--------#------CCCSC-----U--------------Stt-----------UU-----#-----------#----------#---------C---CU---------S------------------------
--------##---------------tt---tt-----tt--tt--------tt#--------tttttt------##--------------#----tt------tt--tt#---------------#-#--#--------#-------tt-#---tt-----#tt--tt-------------------tt-----------
-------###--tt-------#---tt---tt--tt-tt--tt--------tt#---#----tttttt----tt##------------#-#--tttt-tt-tttt--tt#-------------tt#-#--#--------#tt-----tt-##--tt-----#tt--tt-----##---#-#---###tt###########
g-g--g####--tt--k---k#---ttg--tt--tt#tt-gtt--g-k--gtt#--g#g-g-tttttt----tt##----g-------#-#--tttt-tt-tttt--tt#gg-k-g---g---tt#-#--#---ggg-g#tt-----tt-##-gtt-----#tt--tt--k-k##---#-#---###tt##########F
|%|-%|||||%%||-%|%%%||-%%|||-%||-%|||||%|||%%|%|%%||||-%|||%|%||||||%%%%||||-%%%|%%%%%--|-|%%||||%||-||||-%|||||%|%|%%%|%%-|||%|%%|%-%|||%||||%-%%%||%||%|||---%%|||%%||%-|%|||%%%|%|%%%|||||||||||||||%
|||-||||||||||-|||||||-|||||-|||-|||||||||||||||||||||-|||||||||||||||||||||-|||||||||--|-||||||||||-||||-||||||||||||||||-|||||||||-||||||||||-||||||||||||---||||||||||-||||||||||||||||||||||||||||||
