--------------------------------------------------------------------------------------------------------------------------------------------------------------------------------------------------------
--------------------------------------------------------------------------------------------------------------------------------------------------------------------------------------------------------
--------------------------------------------------------------------------------------------------------------------------------------------------------------------------------------------------------
--------------------------------------------------------------------------------------------------------------------------------------------------------------------------------------------------------
--------------------------------------------------------------------------------------------------------------------------------------------------------------------------------------------------------
B-----------U-------------B--B--------BB--------------BB---B---B----B--BB---------------B--------B--------------B-B----B---------------UU---B---------------B-------------------------------------------
---------------C-------------------------------------------------------------------------------------C-C-C-C---------------------------------------------------C----------------------------------------
--------------------------------------------------------------------------------------------------------------------------------------------------------------------------------------------------------
--------------------------------------------------------------------------------------------------------------------------------------------------------------------------------------------------------
--------------------------------------------------------------------------------------------------------------------------------------------------------------------------------------------------------
--------C---CU-B--------C-------BU---B--------#---------UC-----------tt---tt-----------#-------B#----BBBBB-B---------tt-C#--CBB---C----CC-#---C---------tt---ttBtt-------------------#------------------
-tt---#--#--------------------#--------------##-------------#--------tt---tt-------#---#--------#-#--------------#---tt--#----------#-----#-------------tt#--tt-tt------------tt-----#------------------
-tt##-#--#--------------------#-------------###-------------#-----tt-tt---tt-------#tt-#--------#-##--------tttt-#---tt--##--------##-----#-----tt-#--tttt#--tt-tt------------tt-----#------------------
-tt##-#k-#gk-----g-g-k-#-g-g--#g--g-k------####-#g-k-g-----g#-g---tt-tt--gtt------g#tt##--kgkkg-#g###-----k-tttt-#--kttg-##--------##----g#-gg--tt-#-gtttt#kgtt-ttk-kkkkk-kk-kttkkkkk#kkkkkk-kkkkkkkkkkF
-XXXX-XXXXXXXXXXXXXXXXXXXX-X--XXXXXXXX--X--XXXXXXXXXXXXXXXXXXXXXXXXXXXX-XXXXXX--XXXXXXXXXXXXXXXXXXXXXXXXXXXXXXXXXXX-XXXXXXXXXXXXXXXXXXXXXXXXXXXXXXXXXXXXXXXXXXXXXXXXXXXXXXXXXXXXXXXXXXXXXXXXXXXXXXXXXXXX
-XXXX-XXXXXXXXXXXXXXXXXXXX-X--XXXXXXXX--X--XXXXXXXXXXXXXXXXXXXXXXXXXXXX-XXXXXX--XXXXXXXXXXXXXXXXXXXXXXXXXXXXXXXXXXX-XXXXXXXXXXXXXXXXXXXXXXXXXXXXXXXXXXXXXXXXXXXXXXXXXXXXXXXXXXXXXXXXXXXXXXXXXXXXXXXXXXXX
