--------------------------------------------------------------------------------------------------------------------------------------------------------------------------------------------------------
--------------------------------------------------------------------------------------------------------------------------------------------------------------------------------------------------------
--------------------------------------------------------------------------------------------------------------------------------------------------------------------------------------------------------
--------------------------------------------------------------------------------------------------------------------------------------------------------------------------------------------------------
--------------------------------------------------------------------------------------------------------------------------------------------------------------------------------------------------------
---------------------------------B-U--------B----------------------------BU------B--------------BB--BB----------------BBB-------------B-----------------------B-----------------------------------------
----------C--------C-------------------------C-------C-----------------CC------C------------------C--------C------------------------------C----------------------------C--------------------------------
--------------------------------------------------------------------------------------------------------------------------------------------------------------------------------------------------------
--------------------------------------------------------------------------------------------------------------------------------------------------------------------------------------------------------
--------------------------------------------------------------------------------------------------------------------------------------------------------------------------------------------------------
U--#------B-BC--#--B--B-----CB-tt-#C---------B--C--#-B---#---ttUB------BB-C----BU---tt------------BB--C---BB------C--B------U----tt-U----#B-------U-----U-B-----U-----BB--------------------------------
---#------------#---------#----tt-#--------------tt#----##-#-tt------------#------#-tt-----------------#-----------tt----tt----#-tt------#-----#----tt-------------#tt-------#######################-#--
---#--#---------#-------#-#----tt-#---#tt--------tt#---###-#-tt------------#------#-tt#-----tt#--------##---tt-----tt----tt#---#-tt------#-tt--#----tt-------------#tt-------#######################-#--
-g-#--#g-g-k---##g--g--k#-#g---tt-#-#-#ttkgk---g-tt#--####-#gtt-----k-k--g-###g---#-tt#g-k--tt#g-------###--tt-g---tt----tt#--g#gtt-----##-ttk###k--tt-------g---g-#tt--gg-gg#######################-#-F
XX-XXXXXXXXXXXXXXXXXXXXXX-XXXXXXXXXXX-XXXXXX-XXXXXXXXXXXXXXXXXXXXX-XXXXXXXXXXXXXXXXXXXXXXXXXXXXXX-XXXXXXXXXXXXXXXXXXXX---XXXXXXXXXXXX-XXXXXXXXXXXXXXXXXXXXXXXXXXXXXXXXXXXXXXXXXXXXXXXXXXXXXXXXXXXXXX-X--
XX-XXXXXXXXXXXXXXXXXXXXXX-XXXXXXXXXXX-XXXXXX-XXXXXXXXXXXXXXXXXXXXX-XXXXXXXXXXXXXXXXXXXXXXXXXXXXXX-XXXXXXXXXXXXXXXXXXXX---XXXXXXXXXXXX-XXXXXXXXXXXXXXXXXXXXXXXXXXXXXXXXXXXXXXXXXXXXXXXXXXXXXXXXXXXXXX-X--
