--------------------------------------------------------------------------------------------------------------------------------------------------------------------------------------------------------
--------------------------------------------------------------------------------------------------------------------------------------------------------------------------------------------------------
--------------------------------------------------------------------------------------------------------------------------------------------------------------------------------------------------------
--------------------------------------------------------------------------------------------------------------------------------------------------------------------------------------------------------
--------------------------------------------------------------------------------------------------------------------------------------------------------------------------------------------------------
UB-B----------U---U-----U------B---B----U----B---B-B--------B---B--------------------B---U-----B------B--------------------B--B----------------U-B---BB---------------BB--------------------------------
-------------------------C--------C-------------------------------------------------------------------------------C------C------------------------------------------------------------------------------
--------------------------------------------------------------------------------------------------------------------------------------------------------------------------------------------------------
--------------------------------------------------------------------------------------------------------------------------------------------------------------------------------------------------------
--------------------------------------------------------------------------------------------------------------------------------------------------------------------------------------------------------
C---C-----B---C-C-C---U-CB----C--#B-----C------------#-CC-----tt---B---tt-----C-C---B---CC---------#---tt-------ttB-----BB--B--#--#------------C--B-B--U-tt---B---tt-B---tttttttttttttttttttttttttttttt-
---------------------------------#-------------------#---tt---tt-tt----tt--tt---------tt---#------##---tt-------tt----#--------#--##-------#----#--------tt-------tt-----tttttttttttttttttttttttttttttt-
--#--tt----tt-------tt-----#tt---#-------tt----------#---tt---tt-tt----tt#-tt----tt---tt---##----###---tt-------tt----#--------#--##tt---#-#----#--------tt----tt-tt-----tttttttttttttttttttttttttttttt-
--#g-tt--g-tt-------tt-----#tt---#---k-k-tt-----#g--g#---tt---ttgtt---ktt#gtt--#-tt#-gtt--g###kg####g--tt--k-g-gtt--g-##------g#--##tt-gk#-##---#-------gttg-k-tt-ttg----ttttttttttttttttttttttttttttttF
XXXXXXXX-XXXXXXXXXXXXXX-XXXXXXXXXXXXXXXXXXXXXXXXXX--XXXXXXXX-XXXXXXXX-XXXXXXX-XXXXXXXXXXXXXXXXXXXXXXXXXXX-XXXXXXXXXXXXXXXXX-XXXXXXXXXXXXXX-XXXXXXXXXXXXXXXXXXXXXXXXXXX--XXXXXXXXXXXXXXXXXXXXXXXXXXXXXXXX
XXXXXXXX-XXXXXXXXXXXXXX-XXXXXXXXXXXXXXXXXXXXXXXXXX--XXXXXXXX-XXXXXXXX-XXXXXXX-XXXXXXXXXXXXXXXXXXXXXXXXXXX-XXXXXXXXXXXXXXXXX-XXXXXXXXXXXXXX-XXXXXXXXXXXXXXXXXXXXXXXXXXX--XXXXXXXXXXXXXXXXXXXXXXXXXXXXXXXX
