--------------------------------------------------------------------------------------------------------------------------------------------------------------------------------------------------------
--------------------------------------------------------------------------------------------------------------------------------------------------------------------------------------------------------
--------------------------------------------------------------------------------------------------------------------------------------------------------------------------------------------------------
--------------------------------------------------------------------------------------------------------------------------------------------------------------------------------------------------------
--------------------------------------------------------------------------------------------------------------------------------------------------------------------------------------------------------
--------------------------------------------------------------------------------------------------------------------------------------------------------------------------------------------------------
--------------------------------------------------------------------------------------------------------------------------------------------------------------------------------------------------------
--------------------------------------------------------------------------------------------------------------------------------------------------------------------------------------------------------
--------------------------------------------------------------------------------------------------------------------------------------------------------------------------------------------------------
--------------------------------------------------------------------------------------------------------------------------------------------------------------------------------------------------------
---------------------------------#---#------------------------------------------------------------------------------------------------------------------------------------------------------------------
-------------------CUCCCCCC-----##---##---B-----------------------------------B--------------B------------------------------------------------B----------------------------------B----------------------
------------------------------%%%%---%%%%-----------------#-----#----------------------------------------%%%%-----%%%%------------%%%%---%%%%----BBB----------------------------------------------------
----------%%%%%%%-------------||||---||||----------------##-----##---------------------------------------||||-----||||------------||||---||||-------------------------------------------------%%%%%F%%%%
----------|||||||-r-----------||||---||||--------------%%%%-----%%%%------------r-------k----------------||||-----||||------------||||---||||-------------------------------------------------|||||X||||
%%%%%%%%%%|||||||%%%%%%%%%%%%%||||---||||%%%%%%%%%%%%%%||||-----||||%%%%%%%%%%%%%%%%----%%%%%%%%%%%%%%%%%||||-----||||%%%%%%%%%%%%||||---||||%%%%%%%%%%%%%%%%%%-----%%%%%%%%%%%%%%%%%%%%%%%%%%|||||X||||
