--------------------------------------------------------------------------------------------------------------------------------------------------------------------------------------------------------
--------------------------------------------------------------------------------------------------------------------------------------------------------------------------------------------------------
--------------------------------------------------------------------------------------------------------------------------------------------------------------------------------------------------------
--------------------------------------------------------------------------------------------------------------------------------------------------------------------------------------------------------
--------------------------------------------------------------------------------------------------------------------------------------------------------------------------------------------------------
--------------------------------------------------------------------------------------------------------------------------------------------------------------------------------------------------------
--------------------------------------------------------------------------------------------------------------------------------------------------------------------------------------------------------
--------------------------------------------------------------------------------------------------------------------------------------------------------------------------------------------------------
--------------------------------------------------------------------------------------------------------------------------------------------------------------------------------------------------------
--------------------------------------------------------------------------------------------------------------------------------------------------------------------------------------------------------
--------------------------------------------------------------------------------------------------------------------------------------------------------------------------------------------------------
------------------------------------------------------------------------------------------------------------#-----#-------------------------------------------------------------------------------------
--------------%%%%%----------------------------------------------------------------------------------------##-----##-----------------------k---------------%%%%---%%%%----------------------------------
%%%%%%%%%%----|||||%%%%%%%%%--%%%%---%%%%-----------------#----#-------------------#-----#---------------%%%%-----%%%%------------%%%%-----%%%%------------||||---||||----------------------------------
||||||||||----||||||||||||||--||||---||||----------------##----##-----------------##-----##--------------||||-----||||------------||||-----||||----------g-||||---||||-------------g----------%%%%%F%%%%
||||||||||%%%%||||||||||||||%%||||---||||%%%%%%%%%%%%%%%%%%----%%%%%%%%%%%%%%%%%%%%%-----%%%%%%%%%%%%%%%%||||-----||||%%%%%%%%%%%%||||-----||||%%%%%%%%%%%%||||---||||%%%%%%%%%%%%%%%%%%%%%%%%|||||X||||
