--------------------------------------------------------------------------------------------------------------------------------------------------------------------------------------------------------
--------------------------------------------------------------------------------------------------------------------------------------------------------------------------------------------------------
--------------------------------------------------------------------------------------------------------------------------------------------------------------------------------------------------------
--------------------------------------------------------------------------------------------------------------------------------------------------------------------------------------------------------
--------------------------------------------------------------------------------------------------------------------------------------------------------------------------------------------------------
--------------------------------------------------------------------------------------------------------------------------------------------------------------------------------------------------------
--------------------------------------------------------------------------------------------------------------------------------------------------------------------------------------------------------
--------------------------------------------------------------------------------------------------------------------------------------------------------------------------------------------------------
--------------------------------------------------------------------------------------------------------------------------------------------------------------------------------------------------------
--------------------------------------------------------------------------------------------------------------------------------------------------------------------------------------------------------
--------------------------------------------------------------------------------------------------------------------------------------------------------------------------------------------------------
--------------Tt----------------------------------------------------------------------------------------------------------------------------------------------#---#-------------------------------------
--------------ttg--------------------------------------------------------------------------------------------------------------------------------------------##---##------------------------------------
%%%%%%%%%%%%%%%%%----------------------------------------------------------------------------------------%%%%---%%%%---------------------------------------%%%%---%%%%------------------------%%%%%F%%%%
|||||||||||||||||r-----g------%%%%-----%%%%------------%%%%----%%%%---------------------------r----------||||---||||------------k----------------g---------||||---||||-------------------k----|||||X||||
|||||||||||||||||%%%%%%%%%%%%%||||-----||||%%%%%%%%%%%%||||----||||%%%%%%%%%%%%%%%%%-----%%%%%%%%%%%%%%%%||||---||||%%%%%%%%%%%%%%%%%%-----%%%%%%%%%%%%%%%%||||---||||%%%%%%%%%%%%%%%%%%%%%%%%|||||X||||
