--------------------------------------------------------------------------------------------------------------------------------------------------------------------------------------------------------
--------------------------------------------------------------------------------------------------------------------------------------------------------------------------------------------------------
--------------------------------------------------------------------------------------------------------------------------------------------------------------------------------------------------------
--------------------------------------------------------------------------------------------------------------------------------------------------------------------------------------------------------
--------------------------------------------------------------------------------------------------------------------------------------------------------------------------------------------------------
--------------------------------------------------------------------------------------------------------------------------------------------------------------------------------------------------------
--------------------------------------------------------------------------------------------------------------------------------------------------------------------------------------------------------
--------------------------------------------------------------------------------------------------------------------------------------------------------------------------------------------------------
--------------------------------------------------------------------------------------------------------------------------------------------------------------------------------------------------------
--------------------------------------------------------------------------------------------------------------------------------------------------------------------------------------------------------
-----------Tt-----kG------------------------------------------------------------------------------------------------------------------------------------------------------------------------------------
-----------tt------CCUCCCC2--------------------------S---------------S--------S-------------------------------------------------S-------------S----------S---------------S--------S---------------------
----------%%%%%%%---------------------------------------------------------------%%%%--%%%%--------------------------------------------------------------------------------------------------------------
----------|||||||-----------------------------------------#-----#---------------||||--||||---------------%%%%-----%%%%------------%%%%---%%%%-------------------------------------------------%%%%%F%%%%
%%%%%%%%%%|||||||-------------k--------g-----------------##-----##--------------||||--||||---------------||||-----||||------------||||---||||--------------%%%%-----%%%%----------------------|||||%||||
|||||||||||||||||XXXXXXXXXXXXXXXXX-----XXXXXXXXXXXXXXXXXXXX-----XXXXXXXXXXXXXXXX||||--||||XXXXXXXXXXXXXXX||||-----||||XXXXXXXXXXXX||||---||||XXXXXXXXXXXXXX||||-----||||XXXXXXXXXXXXXXXXXXXXXX||||||||||
