--------------------------------------------------------------------------------------------------------------------------------------------------------------------------------------------------------
--------------------------------------------------------------------------------------------------------------------------------------------------------------------------------------------------------
--------------------------------------------------------------------------------------------------------------------------------------------------------------------------------------------------------
--------------------------------------------------------------------------------------------------------------------------------------------------------------------------------------------------------
--------------------------------------------------------------------------------------------------------------------------------------------------------------------------------------------------------
--------------------------------------------------------------------------------------------------------------------------------------------------------------------------------------------------------
--------------------------------------------------------------------------------------------------------------------------------------------------------------------------------------------------------
--------------------------------------------------------------------------------------------------------------------------------------------------------------------------------------------------------
--------------------------------------------------------------------------------------------------------------------------------------------------------------------------------------------------------
--------------------------------------------------------------------------------------------------------------------------------------------------------------------------------------------------------
--------------------k-----------------------------------------------------------------------------------------------------------------------------------------------------------------------------------
------------Tt-----UCCCCC2--2------B----------------------B-----------------------B--------B--B----------B-------------B---B----------------------------------------------------------------------------
------------tt---------------------------------------------------r-----------r--------------------------------------------------#-------#---------------------------------------------------------------
%%%%%%%%%%--tt---------------------------------------------------%%%%--------%%%%----------------------------------------------##-------##--------------------------------------------------------------
||||||||||%%%%%%%------------------------------------------------||||--------||||--------------------------------------------%%%%-------%%%%-------------------------------------------------k%%%%%F%%%%
|||||||||||||||||%%%%%%%%%%%%%%%%%%%%%%%%%%%%%%%%%%%%%%%%%%%%%%%%||||--------||||%%%%%%%%%%%%%%%%%%%%%%%%%%%%%%%%%%%%%%%%%%%%||||-------||||%%%%%%%%%%%%%%%%%%%%%%%%%%%%%%%%%%%%%%%%%%%%%%%%%%|||||X||||
