--------------------------------------------------------------------------------------------------------------------------------------------------------------------------------------------------------
--------------------------------------------------------------------------------------------------------------------------------------------------------------------------------------------------------
--------------------------------------------------------------------------------------------------------------------------------------------------------------------------------------------------------
--------------------------------------------------------------------------------------------------------------------------------------------------------------------------------------------------------
--------------------------------------------------------------------------------------------------------------------------------------------------------------------------------------------------------
--------------------------------------------------------------------------------------------------------------------------------------------------------------------------------------------------------
--------------------------------------------------------------------------------------------------------------------------------------------------------------------------------------------------------
--------------------------------------------------------------------------------------------------------------------------------------------------------------------------------------------------------
--------------------------------------------------------------------------------------------------------------------------------------------------------------------------------------------------------
-------------Tt-----------------------------------------------------------------------------------------------------------------------------------------------------------------------------------------
-------------tt---r-G-----------------------------------------------------------------------------------------------------------------------------------------------------------------------------------
-------------tt---BCUCCCCC--B--B-----------B--------B----------B------------B------B--------------------B-----------------------------------------------------------------------------------------------
----------%%%%%%%---------------------------------------------------------------------------------------------------------------#---#-------------------------------------------------------------------
----------|||||||--------------------------------------------------------------------------------------------------------------##---##------------------------------------------------------------------
----------|||||||------------------------------------------------r-----r------------------------------------------------r----%%%%---%%%%----------------------------------------------------------------
%%%%%%%%%%|||||||%%%%%%%%%%%%%%%%%%%%%%%%%%%%%%%%%%%%%%%%%%%%%%%%%%%%--%%%%%%%%%%%%%%%%%%%%%%%%%%%%%%%%%%%%%%%%%%%%%%%%%%%%%%||||---||||%%%%%%%%%%%%%%%%%%%%%%%%%%%%%%%%%%%%%%%%%%%%%%%%%%%%%%%%%%%F%%%%
