--------------------------------------------------------------------------------------------------------------------------------------------------------------------------------------------------------
--------------------------------------------------------------------------------------------------------------------------------------------------------------------------------------------------------
--------------------------------------------------------------------------------------------------------------------------------------------------------------------------------------------------------
--------------------------------------------------------------------------------------------------------------------------------------------------------------------------------------------------------
--------------------------------------------------------------------------------------------------------------------------------------------------------------------------------------------------------
--------------------------------------------------------------------------------------------------------------------------------------------------------------------------------------------------------
--------------------------------------------------------------------------------------------------------------------------------------------------------------------------------------------------------
--------------------------------------------------------------------------------------------------------------------------------------------------------------------------------------------------------
--------------------------------------------------------------------------------------------------------------------------------------------------------------------------------------------------------
--------------------------------------------------------------------------------------------------------------------------------------------------------------------------------------------------------
----------------Tt--------------------------------------------------------------------------------------------------------------------------------------------------------------------------------------
----------------tt-------------------------------------------------------------------------------------------------------------------#--#---------------------------------------------------------------
----------------tt---------------#--#-----------------------------------------------------------------------------------------------##--##--------------------------------------------------------------
--------------%%%%%-------------##--##----------------------------------------------------------------------#--#------------------%%%%--%%%%------------------------------------------------------------
%%%%%%%%%%----|||||-----------%%%%--%%%%------r------k----------------r---------%%%%---%%%%------r---------##--##-----------------||||--||||-----------------------k-------r----r-------------%%%%%F%%%%
||||||||||%%%%|||||%%%%%%%%%%%||||--||||%%%%%%%%%%%%%%%%%%%---%%%%%%%%%%%%%%%%%%||||---||||%%%%%%%%%%%%%%%%%%--%%%%%%%%%%%%%%%%%%%||||--||||%%%%%%%%%%%%%%%%%%%---%%%%%%%%%%%%%%%%%%%%%%%%%%%%|||||X||||
