--------------------------------------------------------------------------------------------------------------------------------------------------------------------------------------------------------
--------------------------------------------------------------------------------------------------------------------------------------------------------------------------------------------------------
--------------------------------------------------------------------------------------------------------------------------------------------------------------------------------------------------------
--------------------------------------------------------------------------------------------------------------------------------------------------------------------------------------------------------
--------------------------------------------------------------------------------------------------------------------------------------------------------------------------------------------------------
--------------------------------------------------------------------------------------------------------------------------------------------------------------------------------------------------------
--------------------------------------------------------------------------------------------------------------------------------------------------------------------------------------------------------
--------------------------------------------------------------------------------------------------------------------------------------------------------------------------------------------------------
--------------------------------------------------------------------------------------------------------------------------------------------------------------------------------------------------------
--------------------------------------------------------------------------------------------------------------------------------------------------------------------------------------------------------
--------------------------------------------------------------------------------------------------------------------------------------------------------------------------------------------------------
------------------------k-------------------------------------------------------------------------------------------------------------------------------------------------------------------------------
------------------%%%%%%%%----%%%%-%%%%--------------------------------------------------r----------------------------------------%%%%---%%%%-----------------------------------------------------------
------------------||||||||----||||-||||-------------------#---#-----------------%%%%--%%%%----------------------------------------||||---||||-----------------------------------------------------------
%%%%%%%%%%--------||||||||----||||-||||------------------##---##----------------||||--||||----------r----%%%%---%%%%---------g----||||---||||-------------g-------------------------k--------g%%%%%F%%%%
||||||||||XXXXXXXX||||||||XXXX||||-||||XXXXXXXXXXXXXXXXXXXX---XXXXXXXXXXXXXXXXXX||||--||||XXXXXXXXXXXXXXX||||---||||XXXXXXXXXXXXXX||||---||||XXXXXXXXXXXXXXXXXX---XXXXXXXXXXXXXXXXXXXXXXXXXXXX|||||X||||
