--------------------------------------------------------------------------------------------------------------------------------------------------------------------------------------------------------
--------------------------------------------------------------------------------------------------------------------------------------------------------------------------------------------------------
--------------------------------------------------------------------------------------------------------------------------------------------------------------------------------------------------------
--------------------------------------------------------------------------------------------------------------------------------------------------------------------------------------------------------
--------------------------------------------------------------------------------------------------------------------------------------------------------------------------------------------------------
--------------------------------------------------------------------------------------------------------------------------------------------------------------------------------------------------------
--------------------------------------------------------------------------------------------------------------------------------------------------------------------------------------------------------
--------------------------------------------------------------------------------------------------------------------------------------------------------------------------------------------------------
--------------------------------------------------------------------------------------------------------------------------------------------------------------------------------------------------------
--------------------------------------------------------------------------------------------------------------------------------------------------------------------------------------------------------
-----------------gG-------------------------------------------------------------------------------------------------------------------------------------------------------------------------------------
-----------------2CCUCCCC-B--B---------------------------------B--------------------------------------B-----------B----------------------B--------------------B------------B----------------------------
----------%%%%%%-------------------------------------------------k-----g--------------------------------------------------------------------------------------------------------------------------------
%%%%%%%%%%||||||-------------------------------------------------%%%%--%%%%--------------------------------------------------%%%%---%%%%------------------------------------------------------%%%%%F%%%%
||||||||||||||||-------------------------------------------------||||--||||--------------------------------------------------||||---||||------------------------------------------------------|||||X||||
||||||||||||||||%%%%%%%%%%%%%%%%%%%%%%%%%%%%%%%%%%%%%%%%%%%%%%%%%||||--||||%%%%%%%%%%%%%%%%%%%%%%%%%%%%%%%%%%%%%%%%%%%%%%%%%%||||---||||%%%%%%%%%%%%%%%%%%%%%%%%%%%%%%%%%%%%%%%%%%%%%%%%%%%%%%|||||X||||
