--------------------------------------------------------------------------------------------------------------------------------------------------------------------------------------------------------
--------------------------------------------------------------------------------------------------------------------------------------------------------------------------------------------------------
--------------------------------------------------------------------------------------------------------------------------------------------------------------------------------------------------------
--------------------------------------------------------------------------------------------------------------------------------------------------------------------------------------------------------
--------------------------------------------------------------------------------------------------------------------------------------------------------------------------------------------------------
--------------------------------------------------------------------------------------------------------------------------------------------------------------------------------------------------------
--------------------------------------------------------------------------------------------------------------------------------------------------------------------------------------------------------
--------------------------------------------------------------------------------------------------------------------------------------------------------------------------------------------------------
--------------------------------------------------------------------------------------------------------------------------------------------------------------------------------------------------------
--------------------------------------------------------------------------------------------------------------------------------------------------------------------------------------------------------
-----------------k--------------------------------------------------------------------------------------------------------------------------------------------------------------------------------------
-----------------2CCCCCC------g--------------------S--------------------------S-------------S----------------------S------S--S----------------S------------------------------S--------------------------
----------%%%%%%--------------%%%%---%%%%---------------------------------------%%%%---%%%%----------------------------------------------------------------%%%%--%%%%-----------------------------------
----------||||||--------------||||---||||---------------------------------------||||---||||-----------------#-#--------------------------------------------||||--||||-----------------------------------
----------||||||--------------||||---||||--------------%%%%---%%%%--------------||||---||||----------------##-##-------------------------------------------||||--||||-----------------------------------
XXXXXXXXXX||||||XXXXXXXXXXXXXX||||---||||XXXXXXXXXXXXXX||||---||||XXXXXXXXXXXXXX||||---||||XXXXXXXXXXXXXXXXXX-XXXXXXXXXXXXXXXXXXXXXXXX---XXXXXXXXXXXXXXXXXX||||--||||XXXXXXXXXXXXXXXXXXXXXXXXXXXXXXFXXXX
