--------------------------------------------------------------------------------------------------------------------------------------------------------------------------------------------------------
--------------------------------------------------------------------------------------------------------------------------------------------------------------------------------------------------------
--------------------------------------------------------------------------------------------------------------------------------------------------------------------------------------------------------
--------------------------------------------------------------------------------------------------------------------------------------------------------------------------------------------------------
--------------------------------------------------------------------------------------------------------------------------------------------------------------------------------------------------------
--------------------------------------------------------------------------------------------------------------------------------------------------------------------------------------------------------
--------------------------------------------------------------------------------------------------------------------------------------------------------------------------------------------------------
--------------------------------------------------------------------------------------------------------------------------------------------------------------------------------------------------------
--------------------------------------------------------------------------------------------------------------------------------------------------------------------------------------------------------
--------------------------------------------------------------------------------------------------------------------------------------------------------------------------------------------------------
--------------------------------------------------------------------------------------------------------------------------------------------------------------------------------------------------------
-----------------------------------------g-------------------------------------------------k------------------------------------------------------------------------------------------------------------
------------------------------%%%%-----%%%%-------------------------------------%%%%----%%%%------------------------------------------------------------------------------------------------------------
------------------------------||||-----||||-------------------------------------||||----||||--------------------------------------%%%%----%%%%-------------%%%%-----%%%%----------------------%%%%%F%%%%
%%%%%%%%%%%%%%%%%-------g-----||||-----||||------r-----%%%%--%%%%---------------||||----||||-----------gg----------------r--------||||----||||-------------||||-----||||----------------------|||||X||||
|||||||||||||||||%%%%%%%%%%%%%||||-----||||%%%%%%%%%%%%||||--||||%%%%%%%%%%%%%%%||||----||||%%%%%%%%%%%%%%%%%-----%%%%%%%%%%%%%%%%||||----||||%%%%%%%%%%%%%||||-----||||%%%%%%%%%%%%%%%%%%%%%%|||||X||||
