--------------------------------------------------------------------------------------------------------------------------------------------------------------------------------------------------------
--------------------------------------------------------------------------------------------------------------------------------------------------------------------------------------------------------
--------------------------------------------------------------------------------------------------------------------------------------------------------------------------------------------------------
--------------------------------------------------------------------------------------------------------------------------------------------------------------------------------------------------------
--------------------------------------------------------------------------------------------------------------------------------------------------------------------------------------------------------
--------------------------------------------------------------------------------------------------------------------------------------------------------------------------------------------------------
--------------------------------------------------------------------------------------------------------------------------------------------------------------------------------------------------------
--------------------------------------------------------------------------------------------------------------------------------------------------------------------------------------------------------
--------------------------------------------------------------------------------------------------------------------------------------------------------------------------------------------------------
--------------------------------------------------------------------------------------------------------------------------------------------------------------------------------------------------------
------------------k-------------------------------------------------------------------------------------------------------------------------------------------------------------------------------------
-------------------CUCCCCCC--B--B--------B----------------B----B-------------B----------B----------B----------------------------------------------------------------------------------------------------
-----------------------------------------------------------------------------------------------------------------------------%%%%--%%%%-----------------------------------------------------------------
%%%%%%%%%%-------------------------------------------------------g------r----------------------------------------------------||||--||||-----------------------------------------------------------------
||||||||||%%%%%%%------------------------------------------------%%%%---%%%%-------------------------------------------------||||--||||-------------------------------------------------------%%%%%F%%%%
|||||||||||||||||%%%%%%%%%%%%%%%%%%%%%%%%%%%%%%%%%%%%%%%%%%%%%%%%||||---||||%%%%%%%%%%%%%%%%%%%%%%%%%%%%%%%%%%%%%%%%%%%%%%%%%||||--||||%%%%%%%%%%%%%%%%%%%%%%%%%%%%%%%%%%%%%%%%%%%%%%%%%%%%%%%|||||X||||
