--------------------------------------------------------------------------------------------------------------------------------------------------------------------------------------------------------
--------------------------------------------------------------------------------------------------------------------------------------------------------------------------------------------------------
--------------------------------------------------------------------------------------------------------------------------------------------------------------------------------------------------------
--------------------------------------------------------------------------------------------------------------------------------------------------------------------------------------------------------
--------------------------------------------------------------------------------------------------------------------------------------------------------------------------------------------------------
--------------------------------------------------------------------------------------------------------------------------------------------------------------------------------------------------------
--------------------------------------------------------------------------------------------------------------------------------------------------------------------------------------------------------
--------------------------------------------------------------------------------------------------------------------------------------------------------------------------------------------------------
--------------------------------------------------------------------------------------------------------------------------------------------------------------------------------------------------------
--------------------------------------------------------------------------------------------------------------------------------------------------------------------------------------------------------
--------------------------------------------------------------------------------------------------------------------------------------------------------------------------------------------------------
------------------UCCCCC-------------------CC---------------------B--------B--------------------------------#--#----B-----------B-------------B----B---------------------------------B------B-----------
------------------------------g------k---------------------------------------------------------------------##--##-----------------%%%%---%%%%-----------------#---#-------------------------------------
-------------Tt---------------%%%%---%%%%--------------%%%%--%%%%---------------%%%%--%%%%---------------%%%%--%%%%---------------||||---||||----------------##---##------------------------------------
-------------tt---g-----------||||---||||--------------||||--||||---------------||||--||||---------------||||--||||---------------||||---||||--------------%%%%---%%%%----------------------------------
%%%%%%%%%%%%%%%%%%%%%%%%%%%%%%||||---||||%%%%%%%%%%%%%%||||--||||%%%%%%%%%%%%%%%||||--||||%%%%%%%%%%%%%%%||||--||||%%%%%%%%%%%%%%%||||---||||%%%%%%%%%%%%%%||||---||||%%%%%%%%%%%%%%%%%%%%%%%%%%%%%F%%%%
