--------------------------------------------------------------------------------------------------------------------------------------------------------------------------------------------------------
--------------------------------------------------------------------------------------------------------------------------------------------------------------------------------------------------------
--------------------------------------------------------------------------------------------------------------------------------------------------------------------------------------------------------
--------------------------------------------------------------------------------------------------------------------------------------------------------------------------------------------------------
--------------------------------------------------------------------------------------------------------------------------------------------------------------------------------------------------------
--------------------------------------------------------------------------------------------------------------------------------------------------------------------------------------------------------
--------------------------------------------------------------------------------------------------------------------------------------------------------------------------------------------------------
--------------------------------------------------------------------------------------------------------------------------------------------------------------------------------------------------------
--------------------------------------------------------------------------------------------------------------------------------------------------------------------------------------------------------
--------------------------------------------------------------------------------------------------------------------------------------------------------------------------------------------------------
------------------------------------------------------------------------------------------------------------#-----#-------------------------------------------------------------------------------------
---------------------------------#----#-------------------#---#--------------------------------------------##-----##------------------------------------------------------------------------------------
----------%%%%%%---------------r##----##-----------------##---##g----------------------------------------%%%%-----%%%%----------------------------------------------------------------------------------
----------||||||--------------%%%%----%%%%-------------%%%%---%%%%-----------------#-----#---------------||||-----||||-------------------------------------%%%%----%%%%---------------------------------
%%%%%%%%%%||||||--------------||||----||||---------k---||||---||||---r--k---------##-----##--------------||||-----||||------------k------------------------||||----||||-g-------------------------------
||||||||||||||||%%%%%%%%%%%%%%||||----||||%%%%%%%%%%%%%||||---||||%%%%%%%%%%%%%%%%%%-----%%%%%%%%%%%%%%%%||||-----||||%%%%%%%%%%%%%%%%----%%%%%%%%%%%%%%%%%||||----||||%%%%%%%%%%%%%%%%%%%%%%%%%%%%F%%%%
