--------------------------------------------------------------------------------------------------------------------------------------------------------------------------------------------------------
--------------------------------------------------------------------------------------------------------------------------------------------------------------------------------------------------------
--------------------------------------------------------------------------------------------------------------------------------------------------------------------------------------------------------
--------------------------------------------------------------------------------------------------------------------------------------------------------------------------------------------------------
--------------------------------------------------------------------------------------------------------------------------------------------------------------------------------------------------------
--------------------------------------------------------------------------------------------------------------------------------------------------------------------------------------------------------
--------------------------------------------------------------------------------------------------------------------------------------------------------------------------------------------------------
--------------------------------------------------------------------------------------------------------------------------------------------------------------------------------------------------------
--------------------------------------------------------------------------------------------------------------------------------------------------------------------------------------------------------
--------------------------------------------------------------------------------------------------------------------------------------------------------------------------------------------------------
-----------------------------------------------------------------------------------#--#-----------------------------------------------------------------------------------------------------------------
----------------------------------------------------------------------------------##--##-k--------------------------------------------------------------------------------------------------------------
--------------------------------------------------------------------------------%%%%--%%%%--------------------------------------------------------------------------------------------------------------
--------------------------------------------------------------------------------||||--||||----------------------------------------%%%%---%%%%--------------%%%%---%%%%----------------------------------
%%%%%%%%%%----------------------------------------------------------------------||||--||||---------------%%%%---%%%%--------------||||---||||--------------||||---||||---g--------------------%%%%%F%%%%
||||||||||XXXXXXXXXXXXXXXXXXXXXXXX-XXXXXXXXXXXXXXXXXXXXXXXX---XXXXXXXXXXXXXXXXXX||||--||||XXXXXXXXXXXXXXX||||---||||XXXXXXXXXXXXXX||||---||||XXXXXXXXXXXXXX||||---||||XXXXXXXXXXXXXXXXXXXXXXXX|||||X||||
