--------------------------------------------------------------------------------------------------------------------------------------------------------------------------------------------------------
--------------------------------------------------------------------------------------------------------------------------------------------------------------------------------------------------------
--------------------------------------------------------------------------------------------------------------------------------------------------------------------------------------------------------
--------------------------------------------------------------------------------------------------------------------------------------------------------------------------------------------------------
--------------------------------------------------------------------------------------------------------------------------------------------------------------------------------------------------------
--------------------------------------------------------------------------------------------------------------------------------------------------------------------------------------------------------
--------------------------------------------------------------------------------------------------------------------------------------------------------------------------------------------------------
--------------------------------------------------------------------------------------------------------------------------------------------------------------------------------------------------------
--------------------------------------------------------------------------------------------------------------------------------------------------------------------------------------------------------
--------------------------------------------------------------------------------------------------------------------------------------------------------------------------------------------------------
--------------------------------------------------------------------------------------------------------------------------------------------------------------------------------------------------------
-------------------CCCCCCC----------------S--------------------------S--------S----------------------S------------------------------------------S-----------------------S-------------S-----S-----------
--------------------------------------------------------------------------------%%%%---%%%%--------------%%%%-----%%%%----------------------------------------------------------------------------------
%%%%%%%%%%%%%%%%%----------------#---#------------------------------------------||||---||||--------------||||-----||||------------%%%%-----%%%%------------%%%%----%%%%---------------------------------
|||||||||||||||||-k-------------##---##----------------g------------------------||||---||||--------------||||-----||||------------||||-----||||------------||||----||||-----------------------%%%%%F%%%%
|||||||||||||||||XXXXXXXXXXXXXXXXX---XXXXXXXXXXXXXXXXXXXXXX-----XXXXXXXXXXXXXXXX||||---||||XXXXXXXXXXXXXX||||-----||||XXXXXXXXXXXX||||-----||||XXXXXXXXXXXX||||----||||XXXXXXXXXXXXXXXXXXXXXXX|||||X||||
