--------------------------------------------------------------------------------------------------------------------------------------------------------------------------------------------------------
--------------------------------------------------------------------------------------------------------------------------------------------------------------------------------------------------------
--------------------------------------------------------------------------------------------------------------------------------------------------------------------------------------------------------
--------------------------------------------------------------------------------------------------------------------------------------------------------------------------------------------------------
--------------------------------------------------------------------------------------------------------------------------------------------------------------------------------------------------------
--------------------------------------------------------------------------------------------------------------------------------------------------------------------------------------------------------
--------------------------------------------------------------------------------------------------------------------------------------------------------------------------------------------------------
--------------------------------------------------------------------------------------------------------------------------------------------------------------------------------------------------------
--------------------------------------------------------------------------------------------------------------------------------------------------------------------------------------------------------
--------------------------------------------------------------------------------------------------------------------------------------------------------------------------------------------------------
-----------------------------------------------------------------------------------#--#-----------------------------------------------------------------------------------------------------------------
------------------CCCCCC--------------------2------------------------B--------B---##--##---B---------------------------B----------------------B------B--------#-----#----B-------B----------------------
------------------------------r------------------------%%%%-----%%%%------------%%%%--%%%%-------------------------------------------------------------------##-----##----------------------------------
----------%%%%%%--------------%%%%-----%%%%------------||||-----||||------------||||--||||----------------------------------------%%%%---%%%%--------------%%%%-----%%%%--------------------------------
%%%%%%%%%%||||||-g------------||||-----||||------------||||-----||||------------||||--||||----------------------------------------||||---||||--------------||||-----||||--------------------------------
||||||||||||||||%%%%%%%%%%%%%%||||-----||||%%%%%%%%%%%%||||-----||||%%%%%%%%%%%%||||--||||%%%%%%%%%%%%%%%%%%%-----%%%%%%%%%%%%%%%%||||---||||%%%%%%%%%%%%%%||||-----||||%%%%%%%%%%%%%%%%%%%%%%%%%%%F%%%%
