--------------------------------------------------------------------------------------------------------------------------------------------------------------------------------------------------------
--------------------------------------------------------------------------------------------------------------------------------------------------------------------------------------------------------
--------------------------------------------------------------------------------------------------------------------------------------------------------------------------------------------------------
--------------------------------------------------------------------------------------------------------------------------------------------------------------------------------------------------------
--------------------------------------------------------------------------------------------------------------------------------------------------------------------------------------------------------
--------------------------------------------------------------------------------------------------------------------------------------------------------------------------------------------------------
--------------------------------------------------------------------------------------------------------------------------------------------------------------------------------------------------------
--------------------------------------------------------------------------------------------------------------------------------------------------------------------------------------------------------
--------------------------------------------------------------------------------------------------------------------------------------------------------------------------------------------------------
--------------------------------------------------------------------------------------------------------------------------------------------------------------------------------------------------------
--------------------------------------------------------------------------------------------------------------------------------------------------------------------------------------------------------
------------------------SCCC---------------CCC-------S---------------S------S-----------------S--------S------------------------------------------------------------------------S-----------------------
------------------------------r------g-------------------------------------------------------------------%%%%----%%%%--------------------------------------%%%%---%%%%------SS--------------------------
--------------%%%%%%%%%-------%%%%---%%%%---------------------------------------%%%%-----%%%%------------||||----||||--------------------------------------||||---||||----------------------------------
%%%%%%%%%%%%%%|||||||||--g----||||---||||---------------------------------------||||-----||||------------||||----||||-------------%%%%-----%%%%------------||||---||||------------------------%%%%%F%%%%
|||||||||||||||||||||||XXXXXXX||||---||||XXXXXXXXXXXXXXXXXX-----XXXXXXXXXXXXXXXX||||-----||||XXXXXXXXXXXX||||----||||XXXXXXXXXXXXX||||-----||||XXXXXXXXXXXX||||---||||XXXXXXXXXXXXXXXXXXXXXXXX|||||X||||
