--------------------------------------------------------------------------------------------------------------------------------------------------------------------------------------------------------
--------------------------------------------------------------------------------------------------------------------------------------------------------------------------------------------------------
--------------------------------------------------------------------------------------------------------------------------------------------------------------------------------------------------------
--------------------------------------------------------------------------------------------------------------------------------------------------------------------------------------------------------
--------------------------------------------------------------------------------------------------------------------------------------------------------------------------------------------------------
--------------------------------------------------------------------------------------------------------------------------------------------------------------------------------------------------------
--------------------------------------------------------------------------------------------------------------------------------------------------------------------------------------------------------
--------------------------------------------------------------------------------------------------------------------------------------------------------------------------------------------------------
--------------------------------------------------------------------------------------------------------------------------------------------------------------------------------------------------------
--------------------------------------------------------------------------------------------------------------------------------------------------------------------------------------------------------
-------------------------------------------------------------------------------------------------------------------------------------#---#--------------------------------------------------------------
------------------------------------------------------------------------------------------------------------------------------------##---##------------------k------------------------------------------
-----------k-----------------------------------------------------------------------#-#----------------------#---#-----------------%%%%---%%%%--------------%%%%---%%%%----------------------------------
----------%%%%%%%%%---------------------------------------------------------------##-##--------------------##---##----------------||||---||||--------------||||---||||------------------------%%%%%F%%%%
----------|||||||||---------------------------------------------r---------------%%%%-%%%%----------------%%%%---%%%%--------------||||---||||--------------||||---||||------------------------|||||X||||
%%%%%%%%%%|||||||||%%%%%%%%%%%%%%%---%%%%%%%%%%%%%%%%%%%%%%--%%%%%%%%%%%%%%%%%%%||||-||||%%%%%%%%%%%%%%%%||||---||||%%%%%%%%%%%%%%||||---||||%%%%%%%%%%%%%%||||---||||%%%%%%%%%%%%%%%%%%%%%%%%|||||X||||
