--------------------------------------------------------------------------------------------------------------------------------------------------------------------------------------------------------
--------------------------------------------------------------------------------------------------------------------------------------------------------------------------------------------------------
--------------------------------------------------------------------------------------------------------------------------------------------------------------------------------------------------------
--------------------------------------------------------------------------------------------------------------------------------------------------------------------------------------------------------
--------------------------------------------------------------------------------------------------------------------------------------------------------------------------------------------------------
--------------------------------------------------------------------------------------------------------------------------------------------------------------------------------------------------------
--------------------------------------------------------------------------------------------------------------------------------------------------------------------------------------------------------
--------------------------------------------------------------------------------------------------------------------------------------------------------------------------------------------------------
--------------------------------------------------------------------------------------------------------------------------------------------------------------------------------------------------------
--------------------------------------------------------------------------------------------------------------------------------------------------------------------------------------------------------
-----------------r-------------------------------------------------------------------------------------------------------------------#----#-------------------------------------------------------------
-----------------2CCCCCCS-------------------S-----------------------------------------------S--------S----------------S---------S---##----##---S----------------------------------S---------------------
---------------------------------------------------------------------------------------------------------%%%%----%%%%-------------%%%%----%%%%-------------%%%%----%%%%---------------------------------
------------------------------r---------------------------#-----#---------------%%%%---%%%%--------------||||----||||-------------||||----||||-------------||||----||||-----------------------%%%%%F%%%%
------------------------------%%%%-----%%%%--------------##-----##--------------||||---||||--------------||||----||||-------------||||----||||-------------||||----||||-----------------------|||||%||||
XXXXXXXXXXXXXXXXXXXXXXXXXXXXXX||||-----||||XXXXXXXXXXXXXXXX-----XXXXXXXXXXXXXXXX||||---||||XXXXXXXXXXXXXX||||----||||XXXXXXXXXXXXX||||----||||XXXXXXXXXXXXX||||----||||XXXXXXXXXXXXXXXXXXXXXXX||||||||||
