--------------------------------------------------------------------------------------------------------------------------------------------------------------------------------------------------------
--------------------------------------------------------------------------------------------------------------------------------------------------------------------------------------------------------
--------------------------------------------------------------------------------------------------------------------------------------------------------------------------------------------------------
--------------------------------------------------------------------------------------------------------------------------------------------------------------------------------------------------------
--------------------------------------------------------------------------------------------------------------------------------------------------------------------------------------------------------
--------------------------------------------------------------------------------------------------------------------------------------------------------------------------------------------------------
--------------------------------------------------------------------------------------------------------------------------------------------------------------------------------------------------------
--------------------------------------------------------------------------------------------------------------------------------------------------------------------------------------------------------
--------------------------------------------------------------------------------------------------------------------------------------------------------------------------------------------------------
--------------------------------------------------------------------------------------------------------------------------------------------------------------------------------------------------------
-------------------------------------------------------------------------------------------------------------------------------------#-----#------------------------------------------------------------
----------------------------------------------------------------------------------------------------------g-------------------------##-----##-----------------#--#--------------------------------------
----------%%%%%--------------------------------------------------------------------g------r--------------%%%%-----%%%%------------%%%%-----%%%%--------------##--##-------------------------------------
----------|||||%%%%%----------%%%%----%%%%--------------------------------------%%%%----%%%%-------------||||-----||||------------||||-----||||------------%%%%--%%%%-------------------------%%%%%F%%%%
%%%%%%%%%%||||||||||%%%%%%%%--||||----||||-------r---------------------g-----g--||||----||||-------------||||-----||||------------||||-----||||------------||||--||||---r---------------------|||||X||||
||||||||||||||||||||||||||||%%||||----||||%%%%%%%%%%%%%%%%%-----%%%%%%%%%%%%%%%%||||----||||%%%%%%%%%%%%%||||-----||||%%%%%%%%%%%%||||-----||||%%%%%%%%%%%%||||--||||%%%%%%%%%%%%%%%%%%%%%%%%%|||||X||||
