--------------------------------------------------------------------------------------------------------------------------------------------------------------------------------------------------------
--------------------------------------------------------------------------------------------------------------------------------------------------------------------------------------------------------
--------------------------------------------------------------------------------------------------------------------------------------------------------------------------------------------------------
--------------------------------------------------------------------------------------------------------------------------------------------------------------------------------------------------------
--------------------------------------------------------------------------------------------------------------------------------------------------------------------------------------------------------
--------------------------------------------------------------------------------------------------------------------------------------------------------------------------------------------------------
--------------------------------------------------------------------------------------------------------------------------------------------------------------------------------------------------------
--------------------------------------------------------------------------------------------------------------------------------------------------------------------------------------------------------
--------------------------------------------------------------------------------------------------------------------------------------------------------------------------------------------------------
--------------------------------------------------------------------------------------------------------------------------------------------------------------------------------------------------------
----------------g---------------------------------------------------------------------------------------------------------------------------------------------------------------------------------------
----------------BCCCCCC-----B----------B--B-----------------------------------------------------B------------------B-------B-----------------B------B---------------------------------------------------
-----------Tt----------------------------------------------------g--------------------------------------------------------------------------------------------------------------------------------------
-----------tt----------------------------------------------------%%%%--------%%%%-------------------------------------------------------------------------------------------------------------%%%%%F%%%%
----------%%%%%--------------------------------------------------||||--------||||-------------------------------------------------------------------------------------------------------------|||||X||||
%%%%%%%%%%|||||%%%%%%%%%%%%%%%%%%%%%%%%%%%%%%%%%%%%%%%%%%%%%%%%%%||||--------||||%%%%%%%%%%%%%%%%%%%%%%%%%%%%%%%%%%%%%%%%%%%%%%%%-------%%%%%%%%%%%%%%%%%%%%%%%%%%%%%%%%%%%%%%%%%%%%%%%%%%%%%%|||||X||||
