--------------------------------------------------------------------------------------------------------------------------------------------------------------------------------------------------------
--------------------------------------------------------------------------------------------------------------------------------------------------------------------------------------------------------
--------------------------------------------------------------------------------------------------------------------------------------------------------------------------------------------------------
--------------------------------------------------------------------------------------------------------------------------------------------------------------------------------------------------------
--------------------------------------------------------------------------------------------------------------------------------------------------------------------------------------------------------
--------------------------------------------------------------------------------------------------------------------------------------------------------------------------------------------------------
--------------------------------------------------------------------------------------------------------------------------------------------------------------------------------------------------------
--------------------------------------------------------------------------------------------------------------------------------------------------------------------------------------------------------
--------------------------------------------------------------------------------------------------------------------------------------------------------------------------------------------------------
--------------------------------------------------------------------------------------------------------------------------------------------------------------------------------------------------------
-----------------r-------------------------------------------------------------------------------------------------------------------#----#-------------------------------------------------------------
-----------------2CCCCCCB-------------------B-----------------------------------------------B--------B----------------B---------B---##----##---B----------------------------------B---------------------
---------------------------------------------------------------------------------------------------------%%%%----%%%%-------------%%%%----%%%%-------------%%%%----%%%%---------------------------------
------------------------------r---------------------------#-----#---------------%%%%---%%%%--------------||||----||||-------------||||----||||-------------||||----||||-----------------------%%%%%F%%%%
------------------------------%%%%-----%%%%--------------##-----##--------------||||---||||--------------||||----||||-------------||||----||||-------------||||----||||-----------------------|||||X||||
%%%%%%%%%%%%%%%%%%%%%%%%%%%%%%||||-----||||%%%%%%%%%%%%%%%%-----%%%%%%%%%%%%%%%%||||---||||%%%%%%%%%%%%%%||||----||||%%%%%%%%%%%%%||||----||||%%%%%%%%%%%%%||||----||||%%%%%%%%%%%%%%%%%%%%%%%|||||X||||
