--------------------------------------------------------------------------------------------------------------------------------------------------------------------------------------------------------
--------------------------------------------------------------------------------------------------------------------------------------------------------------------------------------------------------
--------------------------------------------------------------------------------------------------------------------------------------------------------------------------------------------------------
--------------------------------------------------------------------------------------------------------------------------------------------------------------------------------------------------------
--------------------------------------------------------------------------------------------------------------------------------------------------------------------------------------------------------
--------------------------------------------------------------------------------------------------------------------------------------------------------------------------------------------------------
--------------------------------------------------------------------------------------------------------------------------------------------------------------------------------------------------------
--------------------------------------------------------------------------------------------------------------------------------------------------------------------------------------------------------
--------------------------------------------------------------------------------------------------------------------------------------------------------------------------------------------------------
--------------------------------------------------------------------------------------------------------------------------------------------------------------------------------------------------------
------------------k-------------------------------------------------------------------------------------------------------------------------------------------------------------------------------------
----------------2CCCCCCS------------------S-----------------------S-------------------------S----------S-----------S-------S-------------------------------------------S--------------------------------
--------------------------------------------------------------------------------------------------------------------------------------------------------------------------------------------------------
%%%%%%%%%%-----------------------#---#--------------------#--#------------------r------------------------%%%%-%%%%----------------%%%%---%%%%-----------------------------------------------------------
||||||||||----------------------##---##------------------##--##-----------------%%%%---%%%%--------------||||-||||----------------||||---||||-------------------------------------------------%%%%%F%%%%
||||||||||XXXXXXXXXXXXXXXXXXXXXXXX---XXXXXXXXXXXXXXXXXXXXXX--XXXXXXXXXXXXXXXXXXX||||---||||XXXXXXXXXXXXXX||||-||||XXXXXXXXXXXXXXXX||||---||||XXXXXXXXXXXXXXXXXX---XXXXXXXXXXXXXXXXXXXXXXXXXXXX|||||X||||
