--------------------------------------------------------------------------------------------------------------------------------------------------------------------------------------------------------
--------------------------------------------------------------------------------------------------------------------------------------------------------------------------------------------------------
--------------------------------------------------------------------------------------------------------------------------------------------------------------------------------------------------------
--------------------------------------------------------------------------------------------------------------------------------------------------------------------------------------------------------
--------------------------------------------------------------------------------------------------------------------------------------------------------------------------------------------------------
--------------------------------------------------------------------------------------------------------------------------------------------------------------------------------------------------------
--------------------------------------------------------------------------------------------------------------------------------------------------------------------------------------------------------
--------------------------------------------------------------------------------------------------------------------------------------------------------------------------------------------------------
--------------------------------------------------------------------------------------------------------------------------------------------------------------------------------------------------------
-------------------------------------------------------------------------------------------------------------------------------------S------------------------------------------------------------------
----------------r----G-------------------------------------------------------------#---#----------------------------------------------------------------------------------------------------------------
-----------------CCCCCCCU-----k------r----S------------------------S------S-------##---##---------------------------S-----------------------S------------S----------------------------------S-----------
----------%%%%%---------------%%%%---%%%%--------------%%%%---%%%%--------------%%%%---%%%%-------------------------------------------------------------------------------------------------------------
----------|||||---------------||||---||||--------------||||---||||--------------||||---||||---------------------------------------%%%%-%%%%-------------------------------------------------------------
%%%%%%%%%%|||||---------------||||---||||--------------||||---||||--------------||||---||||---------------------------------------||||-||||----------------%%%%---%%%%------------------------%%%%%F%%%%
|||||||||||||||XXXXXXXXXXXXXXX||||---||||XXXXXXXXXXXXXX||||---||||XXXXXXXXXXXXXX||||---||||XXXXXXXXXXXXXXXXXX--XXXXXXXXXXXXXXXXXXX||||-||||XXXXXXXXXXXXXXXX||||---||||XXXXXXXXXXXXXXXXXXXXXXXX|||||X||||
