--------------------------------------------------------------------------------------------------------------------------------------------------------------------------------------------------------
--------------------------------------------------------------------------------------------------------------------------------------------------------------------------------------------------------
--------------------------------------------------------------------------------------------------------------------------------------------------------------------------------------------------------
--------------------------------------------------------------------------------------------------------------------------------------------------------------------------------------------------------
--------------------------------------------------------------------------------------------------------------------------------------------------------------------------------------------------------
--------------------------------------------------------------------------------------------------------------------------------------------------------------------------------------------------------
--------------------------------------------------------------------------------------------------------------------------------------------------------------------------------------------------------
--------------------------------------------------------------------------------------------------------------------------------------------------------------------------------------------------------
--------------------------------------------------------------------------------------------------------------------------------------------------------------------------------------------------------
--------------------------------------------------------------------------------------------------------------------------------------------------------------------------------------------------------
---------------------------------#--#-------------------------------------------------------------------------------------------------------------------------------------------------------------------
--------------------------------##--##------------------------------------------------------------------------------------------------------------------------------------------------------------------
----------%%%%%%%-------------%%%%--%%%%----------------------------------------%%%%---%%%%--------------%%%%--%%%%-------------------------------------------------------------------------------------
----------|||||||-------------||||--||||----------------------------------------||||---||||--------------||||--||||-------------------------------------------------------------------------------------
%%%%%%%%%%|||||||------------g||||--||||---------------------g------------------||||---||||--------------||||--||||-----------------------------------------r-g---------g-------g-----------g-%%%%%F%%%%
|||||||||||||||||XXXXXXXXXXXXX||||--||||XXXXXXXXXXXXXXXXXXX--XXXXXXXXXXXXXXXXXXX||||---||||XXXXXXXXXXXXXX||||--||||XXXXXXXXXXXXXXXXXXX---XXXXXXXXXXXXXXXXXXXXXX---XXXXXXXXXXXXXXXXXXXXXXXXXXXX|||||X||||
