--------------------------------------------------------------------------------------------------------------------------------------------------------------------------------------------------------
--------------------------------------------------------------------------------------------------------------------------------------------------------------------------------------------------------
--------------------------------------------------------------------------------------------------------------------------------------------------------------------------------------------------------
--------------------------------------------------------------------------------------------------------------------------------------------------------------------------------------------------------
--------------------------------------------------------------------------------------------------------------------------------------------------------------------------------------------------------
--------------------------------------------------------------------------------------------------------------------------------------------------------------------------------------------------------
--------------------------------------------------------------------------------------------------------------------------------------------------------------------------------------------------------
--------------------------------------------------------------------------------------------------------------------------------------------------------------------------------------------------------
--------------------------------------------------------------------------------------------------------------------------------------------------------------------------------------------------------
--------------------------------------------------------------------------------------------------------------------------------------------------------------------------------------------------------
--------------------------------------------------------------------------------------------------------------------------------------------------------------------------------------------------------
----------------------------------------------------------------g---------------------------------------------------------------------------------------------------------------------------------------
-------------------------------------------------------%%%%---%%%%-----------------#---#----------------------------------------------------------------------------------------------------------------
%%%%%%%%%%g--------------------------g-----------------||||---||||----------------##---##-----------------------------------------%%%%%%%%-----------------%%%%---%%%%----------------------------------
||||||||||%%%%%%%%g-----------%%%%---%%%%----r-r-------||||---||||--------------%%%%---%%%%----------------g----------------------||||||||-----------------||||---||||------------------------%%%%%F%%%%
||||||||||||||||||%%%%%%%%%%%%||||---||||%%%%%%%%%%%%%%||||---||||%%%%%%%%%%%%%%||||---||||%%%%%%%%%%%%%%%%%%---%%%%%%%%%%%%%%%%%%||||||||%%%%%%%%%%%%%%%%%||||---||||%%%%%%%%%%%%%%%%%%%%%%%%|||||X||||
