--------------------------------------------------------------------------------------------------------------------------------------------------------------------------------------------------------
--------------------------------------------------------------------------------------------------------------------------------------------------------------------------------------------------------
--------------------------------------------------------------------------------------------------------------------------------------------------------------------------------------------------------
--------------------------------------------------------------------------------------------------------------------------------------------------------------------------------------------------------
--------------------------------------------------------------------------------------------------------------------------------------------------------------------------------------------------------
--------------------------------------------------------------------------------------------------------------------------------------------------------------------------------------------------------
--------------------------------------------------------------------------------------------------------------------------------------------------------------------------------------------------------
--------------------------------------------------------------------------------------------------------------------------------------------------------------------------------------------------------
--------------------------------------------------------------------------------------------------------------------------------------------------------------------------------------------------------
--------------------------------------------------------------------------------------------------------------------------------------------------------------------------------------------------------
------------------r-------------------------------------------------------------------------------------------------------------------------------------------------------------------------------------
-----------------CCCCCU---------------------CC--------------------B------BBB---------------------------B----------------------------------------------------------------B-------------------------------
----------%%%%%------------------#----#-----------------------------------------------------------------------------------------------------------------------------------BB----------------------------
----------|||||-----------------##----##------------------------------------------------------------------------------------------%%%%-----%%%%------------%%%%----%%%%-----------------------%%%%%F%%%%
%%%%%%%%%%|||||---------------%%%%----%%%%-------------r-----g-------------------------------------------%%%%-----%%%%------------||||-----||||------------||||----||||-----------------------|||||X||||
|||||||||||||||%%%%%%%%%%%%%%%||||----||||%%%%%%%%%%%%%%%%%--%%%%%%%%%%%%%%%%%%%%%%%-----%%%%%%%%%%%%%%%%||||-----||||%%%%%%%%%%%%||||-----||||%%%%%%%%%%%%||||----||||%%%%%%%%%%%%%%%%%%%%%%%|||||X||||
