--------------------------------------------------------------------------------------------------------------------------------------------------------------------------------------------------------
--------------------------------------------------------------------------------------------------------------------------------------------------------------------------------------------------------
--------------------------------------------------------------------------------------------------------------------------------------------------------------------------------------------------------
--------------------------------------------------------------------------------------------------------------------------------------------------------------------------------------------------------
--------------------------------------------------------------------------------------------------------------------------------------------------------------------------------------------------------
--------------------------------------------------------------------------------------------------------------------------------------------------------------------------------------------------------
--------------------------------------------------------------------------------------------------------------------------------------------------------------------------------------------------------
--------------------------------------------------------------------------------------------------------------------------------------------------------------------------------------------------------
--------------------------------------------------------------------------------------------------------------------------------------------------------------------------------------------------------
--------------------------------------------------------------------------------------------------------------------------------------------------------------------------------------------------------
------------------------------------------------------------------------------------------------------------#---#---------------------------------------------------------------------------------------
----------------------------------------------------------------------------------------------------------g##---##g-------------------------------------------------------------------------------------
---------------------------------------------------------------------------------------------------------%%%%---%%%%------------------------------------------------------------------------------------
------------------------------%%%%--%%%%-----------------------------------------------------------------||||---||||--------------%%%%---%%%%-----------------------------------------------------------
%%%%%%%%%%%%%%%-----r---------||||--||||---------g---r-------------------------------------r-------------||||---||||----k---------||||---||||-----------------------------------------------------------
|||||||||||||||%%%%%%%%%%%%%%%||||--||||%%%%%%%%%%%%%%%%%%%---%%%%%%%%%%%%%%%%%%%%%%--%%%%%%%%%%%%%%%%%%%||||---||||%%%%%%%%%%%%%%||||---||||%%%%%%%%%%%%%%%%%%--%%%%%%%%%%%%%%%%%%%%%%%%%%%%%%%%%%F%%%%
