--------------------------------------------------------------------------------------------------------------------------------------------------------------------------------------------------------
--------------------------------------------------------------------------------------------------------------------------------------------------------------------------------------------------------
--------------------------------------------------------------------------------------------------------------------------------------------------------------------------------------------------------
--------------------------------------------------------------------------------------------------------------------------------------------------------------------------------------------------------
--------------------------------------------------------------------------------------------------------------------------------------------------------------------------------------------------------
--------------------------------------------------------------------------------------------------------------------------------------------------------------------------------------------------------
--------------------------------------------------------------------------------------------------------------------------------------------------------------------------------------------------------
--------------------------------------------------------------------------------------------------------------------------------------------------------------------------------------------------------
--------------------------------------------------------------------------------------------------------------------------------------------------------------------------------------------------------
--------------------------------------------------------------------------------------------------------------------------------------------------------------------------------------------------------
--------------------------------------------------------------------------------------------------------------------------------------------------------------------------------------------------------
------------------CCCCUCCB---------------B-----BB--------------------B---------------------------------B---------------------B-------#---#----B--------------------------B------------------------------
----------%%%%%%--------------------------------------------------------------------------------------------------------------------##---##-------------------------------------------------------------
----------||||||--------------g-----g---------------------------------------------------------------------------------------------%%%%---%%%%-----------------------------------------------------------
%%%%%%%%%%||||||-g--G---------%%%%--%%%%---------------%%%%-----%%%%------------%%%%-----%%%%-------------------------------------||||---||||-----------------------------------------------------------
||||||||||||||||%%%%%%%%%%%%%%||||--||||%%%%%%%%%%%%%%%||||-----||||%%%%%%%%%%%%||||-----||||%%%%%%%%%%%%%%%%-----%%%%%%%%%%%%%%%%||||---||||%%%%%%%%%%%%%%%%%%-----%%%%%%%%%%%%%%%%%%%%%%%%%%%%%%%F%%%%
