--------------------------------------------------------------------------------------------------------------------------------------------------------------------------------------------------------
--------------------------------------------------------------------------------------------------------------------------------------------------------------------------------------------------------
--------------------------------------------------------------------------------------------------------------------------------------------------------------------------------------------------------
--------------------------------------------------------------------------------------------------------------------------------------------------------------------------------------------------------
--------------------------------------------------------------------------------------------------------------------------------------------------------------------------------------------------------
--------------------------------------------------------------------------------------------------------------------------------------------------------------------------------------------------------
--------------------------------------------------------------------------------------------------------------------------------------------------------------------------------------------------------
--------------------------------------------------------------------------------------------------------------------------------------------------------------------------------------------------------
--------------------------------------------------------------------------------------------------------------------------------------------------------------------------------------------------------
--------------------------------------------------------------------------------------------------------------------------------------------------------------------------------------------------------
---------------------------------#---#------------------------------------------------------------------------------------------------------------------------------------------------------------------
--------------------------------##---##-----------------------------------------------------------------------------------------------------------------------------------------------------------------
------------------------------%%%%---%%%%---------------------------------------------------------------------------------------------------------------------------------------------------------------
%%%%%%%%%%--------------------||||---||||--------------%%%%----%%%%---------------------------------------------------------------%%%%---%%%%-----------------------------------------------------------
||||||||||%%%%%%%%------------||||---||||--------------||||----||||-------------%%%%-----%%%%--------------------------------r----||||---||||-----------k-------------------k-----------------%%%%%F%%%%
||||||||||||||||||%%%%%%%%%%%%||||---||||%%%%%%%%%%%%%%||||----||||%%%%%%%%%%%%%||||-----||||%%%%%%%%%%%%%%%%-----%%%%%%%%%%%%%%%%||||---||||%%%%%%%%%%%%%%%%%%-----%%%%%%%%%%%%%%%%%%%%%%%%%%|||||X||||
