--------------------------------------------------------------------------------------------------------------------------------------------------------------------------------------------------------
--------------------------------------------------------------------------------------------------------------------------------------------------------------------------------------------------------
--------------------------------------------------------------------------------------------------------------------------------------------------------------------------------------------------------
--------------------------------------------------------------------------------------------------------------------------------------------------------------------------------------------------------
--------------------------------------------------------------------------------------------------------------------------------------------------------------------------------------------------------
--------------------------------------------------------------------------------------------------------------------------------------------------------------------------------------------------------
--------------------------------------------------------------------------------------------------------------------------------------------------------------------------------------------------------
--------------------------------------------------------------------------------------------------------------------------------------------------------------------------------------------------------
--------------------------------------------------------------------------------------------------------------------------------------------------------------------------------------------------------
--------------------------------------------------------------------------------------------------------------------------------------------------------------------------------------------------------
--------------------------------------------------------------------------------------------------------------------------------------------------------------------------------------------------------
-------------------------------------------------------------------------------------------------------------------------------------#--#---------------------------------------------------------------
----------%%%%%%%%------------%%%%---%%%%----------------------------------------------------------------%%%%--%%%%-----------------##--##--------------------g-----------------------------------------
----------||||||||------------||||---||||-----------------#---#-----------------r-g----------------------||||--||||---------------%%%%--%%%%---------------%%%%--%%%%-----------------------------------
----------||||||||----------r-||||---||||----------------##---##-------r--------%%%%---%%%%--------------||||--||||---------------||||--||||-------g-------||||--||||-----------------------------------
%%%%%%%%%%||||||||%%%%%%%%%%%%||||---||||%%%%%%%%%%%%%%%%%%---%%%%%%%%%%%%%%%%%%||||---||||%%%%%%%%%%%%%%||||--||||%%%%%%%%%%%%%%%||||--||||%%%%%%%%%%%%%%%||||--||||%%%%%%%%%%%%%%%%%%%%%%%%%%%%%%F%%%%
