--------------------------------------------------------------------------------------------------------------------------------------------------------------------------------------------------------
--------------------------------------------------------------------------------------------------------------------------------------------------------------------------------------------------------
--------------------------------------------------------------------------------------------------------------------------------------------------------------------------------------------------------
--------------------------------------------------------------------------------------------------------------------------------------------------------------------------------------------------------
--------------------------------------------------------------------------------------------------------------------------------------------------------------------------------------------------------
--------------------------------------------------------------------------------------------------------------------------------------------------------------------------------------------------------
--------------------------------------------------------------------------------------------------------------------------------------------------------------------------------------------------------
--------------------------------------------------------------------------------------------------------------------------------------------------------------------------------------------------------
--------------------------------------------------------------------------------------------------------------------------------------------------------------------------------------------------------
--------------------------------------------------------------------------------------------------------------------------------------------------------------------------------------------------------
---------------B-----r----------------------------------------------------------------------------------------------------------------------------------------------------------------------------------
--------------------BCCCCCC--------------------------B--------------------------------------B---------------------------------B----------------------------------------B----------B--B------B-----------
--------------------------------------------------------------------------------------------------------------------------------------------------------------------------------------------------------
----------%%%%%%%%%---------------------------------------#----#-------------------------------------------------------------------------------------------%%%%---%%%%----------------------------------
%%%%%%%%%%|||||||||-----------g--------------------------##----##---------------%%%%---%%%%---------------------------------------%%%%-----%%%%------------||||---||||----------------------------------
|||||||||||||||||||%%%%%%%%%%%%%%%-----%%%%%%%%%%%%%%%%%%%%----%%%%%%%%%%%%%%%%%||||---||||%%%%%%%%%%%%%%%%%%-----%%%%%%%%%%%%%%%%||||-----||||%%%%%%%%%%%%||||---||||%%%%%%%%%%%%%%%%%%%%%%%%%%%%%F%%%%
