--------------------------------------------------------------------------------------------------------------------------------------------------------------------------------------------------------
--------------------------------------------------------------------------------------------------------------------------------------------------------------------------------------------------------
--------------------------------------------------------------------------------------------------------------------------------------------------------------------------------------------------------
--------------------------------------------------------------------------------------------------------------------------------------------------------------------------------------------------------
--------------------------------------------------------------------------------------------------------------------------------------------------------------------------------------------------------
--------------------------------------------------------------------------------------------------------------------------------------------------------------------------------------------------------
--------------------------------------------------------------------------------------------------------------------------------------------------------------------------------------------------------
--------------------------------------------------------------------------------------------------------------------------------------------------------------------------------------------------------
--------------------------------------------------------------------------------------------------------------------------------------------------------------------------------------------------------
--------------------------------------------------------------------------------------------------------------------------------------------------------------------------------------------------------
---------------------g----------------------------------------------------------------------------------------------------------#---#-------------------------------------------------------------------
--------------------CCCCCC---2-----------------------S---------S------------S------------------------------S----------S--------##---##-----------S-------------S------------S---------------------------
--------------------------------------------------------------------#--#-----------------------------------------------------%%%%---%%%%----------------------------------------------------------------
%%%%%%%%%%------k--------------------------------------------------##--##----------------------------------------------------||||---||||------------------------------------------------------%%%%%F%%%%
||||||||||%%%%%%%%-----------------------------------------------%%%%--%%%%--------------------------------------------------||||---||||----------------------g-------------------------------|||||%||||
||||||||||||||||||XXXXXXXXXXXXXXXXXXXXXXXXXXXXXXXXXXXXXXXXXXXXXXX||||--||||XXXXXXXXXXXXXXXXXXXXXXXXXXXXXXXXXXXXXXXXXXXXXXXXXX||||---||||XXXXXXXXXXXXXXXXXXXXXXXXXXXXXXXXXXXXXXXXXXXXXXXXXXXXXX||||||||||
