--------------------------------------------------------------------------------------------------------------------------------------------------------------------------------------------------------
--------------------------------------------------------------------------------------------------------------------------------------------------------------------------------------------------------
--------------------------------------------------------------------------------------------------------------------------------------------------------------------------------------------------------
--------------------------------------------------------------------------------------------------------------------------------------------------------------------------------------------------------
--------------------------------------------------------------------------------------------------------------------------------------------------------------------------------------------------------
--------------------------------------------------------------------------------------------------------------------------------------------------------------------------------------------------------
--------------------------------------------------------------------------------------------------------------------------------------------------------------------------------------------------------
--------------------------------------------------------------------------------------------------------------------------------------------------------------------------------------------------------
--------------------------------------------------------------------------------------------------------------------------------------------------------------------------------------------------------
--------------------------------------------------------------------------------------------------------------------------------------------------------------------------------------------------------
--------------------------------------------------------------------------------------------------------------------------------------------------------------------------------------------------------
--------------------------------------------------------------------------------------------------------------------------------------------------------------#---#-------------------------------------
---------------g----------------------------------------------------------------------g----------------------------------------------------------------------##---##------------------------------------
%%%%%%%%%%%%%%%%------------------------------------------#---#-----------------%%%%%%%%------------------------------------------%%%%---%%%%--------------%%%%---%%%%----------------------------------
||||||||||||||||--------------%%%%---%%%%----------------##---##----------------||||||||----g-------------------------------------||||---||||--------------||||---||||----------------------------------
||||||||||||||||XXXXXXXXXXXXXX||||---||||XXXXXXXXXXXXXXXXXX---XXXXXXXXXXXXXXXXXX||||||||XXXXXXXXXXXXXXXXXXXXX---XXXXXXXXXXXXXXXXXX||||---||||XXXXXXXXXXXXXX||||---||||XXXXXXXXXXXXXXXXXXXXXXXXXXXXXFXXXX
