--------------------------------------------------------------------------------------------------------------------------------------------------------------------------------------------------------
--------------------------------------------------------------------------------------------------------------------------------------------------------------------------------------------------------
--------------------------------------------------------------------------------------------------------------------------------------------------------------------------------------------------------
--------------------------------------------------------------------------------------------------------------------------------------------------------------------------------------------------------
--------------------------------------------------------------------------------------------------------------------------------------------------------------------------------------------------------
--------------------------------------------------------------------------------------------------------------------------------------------------------------------------------------------------------
--------------------------------------------------------------------------------------------------------------------------------------------------------------------------------------------------------
--------------------------------------------------------------------------------------------------------------------------------------------------------------------------------------------------------
--------------------------------------------------------------------------------------------------------------------------------------------------------------------------------------------------------
--------------------------------------------------------------------------------------------------------------------------------------------------------------------------------------------------------
-----------------------------------------------------------------------------------#----#---------------------------------------------------------------------------------------------------------------
----------------------------------------------------------------------------------##----##------------------r--------k-------------------r--------------------#-----#-----------------------------------
-----------Tt-------------------------------------------------------------------%%%%----%%%%-------------%%%%-----%%%%------------%%%%---%%%%----------------##-----##----------------------------------
%%%%%%%%%%-tt-------------------------------------------------------------------||||----||||-------------||||-----||||------------||||---||||--------------%%%%-----%%%%----------------------%%%%%F%%%%
||||||||||%%%%%---------------%%%%---%%%%-------------------------------g-------||||----||||----------g--||||-----||||------------||||---||||----r---------||||-----||||---------------g------|||||%||||
|||||||||||||||XXXXXXXXXXXXXXX||||---||||XXXXXXXXXXXXXXXXXX-----XXXXXXXXXXXXXXXX||||----||||XXXXXXXXXXXXX||||-----||||XXXXXXXXXXXX||||---||||XXXXXXXXXXXXXX||||-----||||XXXXXXXXXXXXXXXXXXXXXX||||||||||
