--------------------------------------------------------------------------------------------------------------------------------------------------------------------------------------------------------
--------------------------------------------------------------------------------------------------------------------------------------------------------------------------------------------------------
--------------------------------------------------------------------------------------------------------------------------------------------------------------------------------------------------------
--------------------------------------------------------------------------------------------------------------------------------------------------------------------------------------------------------
--------------------------------------------------------------------------------------------------------------------------------------------------------------------------------------------------------
--------------------------------------------------------------------------------------------------------------------------------------------------------------------------------------------------------
--------------------------------------------------------------------------------------------------------------------------------------------------------------------------------------------------------
--------------------------------------------------------------------------------------------------------------------------------------------------------------------------------------------------------
--------------------------------------------------------------------------------------------------------------------------------------------------------------------------------------------------------
--------------------------------------------------------------------------------------------------------------------------------------------------------------------------------------------------------
--------------------------------------------------------------------------------------------------------------------------------------------------------------------------------------------------------
--------------------------------------------------------------------------------------------------------------------------------------------------------------------------------------------------------
----------------------------------------------------------------------------------------------------------------------------------%%%%----%%%%----------------------------------------------------------
%%%%%%%%%%------------------------------------------------------------------------------------------------------------------------||||----||||------------------------------------------------%%%%%F%%%%
||||||||||-----------------------------------------------g----------------------%%%%-----%%%%------------%%%%---%%%%---k----------||||----||||-g----------------------------------------------|||||X||||
||||||||||%%%%%%%%%%%%%%%%%%%%%%%%-----%%%%%%%%%%%%%%%%%%%%-----%%%%%%%%%%%%%%%%||||-----||||%%%%%%%%%%%%||||---||||%%%%%%%%%%%%%%||||----||||%%%%%%%%%%%%%%%%%---%%%%%%%%%%%%%%%%%%%%%%%%%%%%|||||X||||
