--------------------------------------------------------------------------------------------------------------------------------------------------------------------------------------------------------
--------------------------------------------------------------------------------------------------------------------------------------------------------------------------------------------------------
--------------------------------------------------------------------------------------------------------------------------------------------------------------------------------------------------------
--------------------------------------------------------------------------------------------------------------------------------------------------------------------------------------------------------
--------------------------------------------------------------------------------------------------------------------------------------------------------------------------------------------------------
--------------------------------------------------------------------------------------------------------------------------------------------------------------------------------------------------------
--------------------------------------------------------------------------------------------------------------------------------------------------------------------------------------------------------
--------------------------------------------------------------------------------------------------------------------------------------------------------------------------------------------------------
--------------------------------------------------------------------------------------------------------------------------------------------------------------------------------------------------------
--------------------------------------------------------------------------------------------------------------------------------------------------------------------------------------------------------
--------------------------------------------------------------------------------------------------------------------------------------------------------------------------------------------------------
--------------------------------------------------------------------------------------------------------------------------------------------------------------r-----------------------------------------
----------%%%%%%-------------------------------------------------------------------------------------------------------------------------------------------%%%%---%%%%----------------------------------
%%%%%%%%%%||||||----------------------------------------------------------------%%%%---%%%%---------------------------------------%%%%--%%%%---------------||||---||||------------------------%%%%%F%%%%
||||||||||||||||----g---------%%%%---%%%%--------------%%%%---%%%%--------------||||---||||--------------%%%%-%%%%----------------||||--||||-----g---------||||---||||------------------------|||||%||||
||||||||||||||||XXXXXXXXXXXXXX||||---||||XXXXXXXXXXXXXX||||---||||XXXXXXXXXXXXXX||||---||||XXXXXXXXXXXXXX||||-||||XXXXXXXXXXXXXXXX||||--||||XXXXXXXXXXXXXXX||||---||||XXXXXXXXXXXXXXXXXXXXXXXX||||||||||
