--------------------------------------------------------------------------------------------------------------------------------------------------------------------------------------------------------
--------------------------------------------------------------------------------------------------------------------------------------------------------------------------------------------------------
--------------------------------------------------------------------------------------------------------------------------------------------------------------------------------------------------------
--------------------------------------------------------------------------------------------------------------------------------------------------------------------------------------------------------
--------------------------------------------------------------------------------------------------------------------------------------------------------------------------------------------------------
--------------------------------------------------------------------------------------------------------------------------------------------------------------------------------------------------------
--------------------------------------------------------------------------------------------------------------------------------------------------------------------------------------------------------
--------------------------------------------------------------------------------------------------------------------------------------------------------------------------------------------------------
--------------------------------------------------------------------------------------------------------------------------------------------------------------------------------------------------------
--------------------------------------------------------------------------------------------------------------------------------------------------------------------------------------------------------
----------------------k---------------------------------------------------------------------------------------------------------------------------------------------------------------------------------
--------------------SCCCCUCC--------------S------S----------------------------S-----------S------S-------------------S-----------------------------------S------------------------S---------------------
--------------------------------------------------------------------------------------------------------------------------------------------------------------------------------------------------------
%%%%%%%%%%-----------------------#---#--------------------------------------------------------------------------------------------------------------------------------------------------------%%%%%F%%%%
||||||||||%%%%%%%%%-------------##---##----------------g------g-----------------%%%%-%%%%-----------------------------------------------------------------------------------------------------|||||%||||
|||||||||||||||||||XXXXXXXXXXXXXXX---XXXXXXXXXXXXXXXXXXXXXX---XXXXXXXXXXXXXXXXXX||||-||||XXXXXXXXXXXXXXXXXXXX---XXXXXXXXXXXXXXXXXXXXXX---XXXXXXXXXXXXXXXXXXXXXX--XXXXXXXXXXXXXXXXXXXXXXXXXXXXX||||||||||
