--------------------------------------------------------------------------------------------------------------------------------------------------------------------------------------------------------
--------------------------------------------------------------------------------------------------------------------------------------------------------------------------------------------------------
--------------------------------------------------------------------------------------------------------------------------------------------------------------------------------------------------------
--------------------------------------------------------------------------------------------------------------------------------------------------------------------------------------------------------
--------------------------------------------------------------------------------------------------------------------------------------------------------------------------------------------------------
--------------------------------------------------------------------------------------------------------------------------------------------------------------------------------------------------------
--------------------------------------------------------------------------------------------------------------------------------------------------------------------------------------------------------
--------------------------------------------------------------------------------------------------------------------------------------------------------------------------------------------------------
--------------------------------------------------------------------------------------------------------------------------------------------------------------------------------------------------------
--------------------------------------------------------------------------------------------------------------------------------------------------------------------------------------------------------
-------------------------------------------------------------------------------------------------------------------------------------#-----#------------------------------------------------------------
------------------------------------------------------------------------------------------------------------------------------------##-----##-----------------------------------------------------------
----------%%%%%%%-----------------------------------------------------------------------------------------------------------------%%%%-----%%%%---------------------------------------------------------
%%%%%%%%%%|||||||--------------------------------------------------------------------------g--------------------------------------||||-----||||-----------------------------------------------%%%%%F%%%%
|||||||||||||||||---------------------------------------------------------------%%%%----%%%%---g-------------------------g--------||||-----||||-----------------------------------------------|||||X||||
|||||||||||||||||%%%%%%%%%%%%%%%%%-----%%%%%%%%%%%%%%%%%%%%-----%%%%%%%%%%%%%%%%||||----||||%%%%%%%%%%%%%%%%%-%%%%%%%%%%%%%%%%%%%%||||-----||||%%%%%%%%%%%%%%%%-----%%%%%%%%%%%%%%%%%%%%%%%%%%|||||X||||
