--------------------------------------------------------------------------------------------------------------------------------------------------------------------------------------------------------
--------------------------------------------------------------------------------------------------------------------------------------------------------------------------------------------------------
--------------------------------------------------------------------------------------------------------------------------------------------------------------------------------------------------------
--------------------------------------------------------------------------------------------------------------------------------------------------------------------------------------------------------
--------------------------------------------------------------------------------------------------------------------------------------------------------------------------------------------------------
--------------------------------------------------------------------------------------------------------------------------------------------------------------------------------------------------------
--------------------------------------------------------------------------------------------------------------------------------------------------------------------------------------------------------
--------------------------------------------------------------------------------------------------------------------------------------------------------------------------------------------------------
--------------------------------------------------------------------------------------------------------------------------------------------------------------------------------------------------------
--------------------------------------------------------------------------------------------------------------------------------------------------------------------------------------------------------
-----------------------------------------------------------------------------------#-----#--------------------------------------------------------------------------------------------------------------
--------------------------------r-------------------------------------------------##-----##-----------------------------------------kr------------------------------------------------------------------
----------%%%%%%%%%-----------%%%%---%%%%---------------------------------------%%%%-----%%%%---------------#-----#---------------%%%%----%%%%----------------------------------------------------------
%%%%%%%%%%|||||||||-----------||||---||||-----------------#----#----------------||||-----||||--------------##-----##--------------||||----||||------------------------------------------------%%%%%F%%%%
|||||||||||||||||||---k-------||||---||||----------------##----##--------g------||||-----||||------------%%%%-----%%%%----------g-||||----||||-------------%%%%----%%%%-----g-----------------|||||X||||
|||||||||||||||||||%%%%%%%%%%%||||---||||%%%%%%%%%%%%%%%%%%----%%%%%%%%%%%%%%%%%||||-----||||%%%%%%%%%%%%||||-----||||%%%%%%%%%%%%||||----||||%%%%%%%%%%%%%||||----||||%%%%%%%%%%%%%%%%%%%%%%%|||||X||||
