--------------------------------------------------------------------------------------------------------------------------------------------------------------------------------------------------------
--------------------------------------------------------------------------------------------------------------------------------------------------------------------------------------------------------
--------------------------------------------------------------------------------------------------------------------------------------------------------------------------------------------------------
--------------------------------------------------------------------------------------------------------------------------------------------------------------------------------------------------------
--------------------------------------------------------------------------------------------------------------------------------------------------------------------------------------------------------
--------------------------------------------------------------------------------------------------------------------------------------------------------------------------------------------------------
--------------------------------------------------------------------------------------------------------------------------------------------------------------------------------------------------------
--------------------------------------------------------------------------------------------------------------------------------------------------------------------------------------------------------
--------------------------------------------------------------------------------------------------------------------------------------------------------------------------------------------------------
--------------------------------------------------------------------------------------------------------------------------------------------------------------------------------------------------------
--------------------g-g-g-------------------------------------------------------------------------------------------------------------------------------------------------------------------------------
-------------------2CCCCUCCB----------B--B-------B----------B------------------------B-----------B--------------B---------------------------------------------------------------------------------------
----------%%%%%%%%-----------------------------------------------------------------------------------------------------------%%%%--%%%%-----------------------------------------------------------------
%%%%%%%%%%||||||||--------------------------------------------------#---#----------------------------------------------------||||--||||-----------------------------------------------------------------
||||||||||||||||||-------------------------------------------------##---##---------------------------------------------------||||--||||-----------------------------------------------------------------
||||||||||||||||||%%%%%%%%%%%%%%%%%%%%%%%%%%%%%%%%%%%%%%%%%%%%%%%%%%%---%%%%%%%%%%%%%%%%%%%%%%%%%%%%%%%%%%%%%%%%%%%%%%%%%%%%%||||--||||%%%%%%%%%%%%%%%%%%%%%%%%%%%%%%%%%%%%%%%%%%%%%%%%%%%%%%%%%%%%F%%%%
