--------------------------------------------------------------------------------------------------------------------------------------------------------------------------------------------------------
--------------------------------------------------------------------------------------------------------------------------------------------------------------------------------------------------------
--------------------------------------------------------------------------------------------------------------------------------------------------------------------------------------------------------
--------------------------------------------------------------------------------------------------------------------------------------------------------------------------------------------------------
--------------------------------------------------------------------------------------------------------------------------------------------------------------------------------------------------------
--------------------------------------------------------------------------------------------------------------------------------------------------------------------------------------------------------
--------------------------------------------------------------------------------------------------------------------------------------------------------------------------------------------------------
--------------------------------------------------------------------------------------------------------------------------------------------------------------------------------------------------------
--------------------------------------------------------------------------------------------------------------------------------------------------------------------------------------------------------
--------------------------------------------------------------------------------------------------------------------------------------------------------------------------------------------------------
---------------------g--rg------------------------------------------------------------------------------------------------------------------------------------------------------------------------------
----------------------CCUCCCC----C----------------B-------------------------B----------B------------------------B---------------------------------B-----------B--B-------------B------------------------
-----------------------------------------------------------------%%%%--%%%%-----------------------------------------------------------------------------------------------------------------------------
-----------------------------------------------------------------||||--||||-------------------------------------------------------------------------------------------------------------------%%%%%F%%%%
----------%%%%%%%%%%---------------------------------------------||||--||||-------------------------------------------------------------------------------------------------------------------|||||X||||
%%%%%%%%%%||||||||||%%%%%%%%%%%%%%%%%%%%%%%%%%%%%%%%%%%%%%%%%%%%%||||--||||%%%%%%%%%%%%%%%%%%%%%%%%%%%%%%%%%%%%%%%%%%%%%%%%%%%%%%---%%%%%%%%%%%%%%%%%%%%%%%%%%%%%%%%%%%%%%%%%%%%%%%%%%%%%%%%%%|||||X||||
