--------------------------------------------------------------------------------------------------------------------------------------------------------------------------------------------------------
--------------------------------------------------------------------------------------------------------------------------------------------------------------------------------------------------------
--------------------------------------------------------------------------------------------------------------------------------------------------------------------------------------------------------
--------------------------------------------------------------------------------------------------------------------------------------------------------------------------------------------------------
--------------------------------------------------------------------------------------------------------------------------------------------------------------------------------------------------------
--------------------------------------------------------------------------------------------------------------------------------------------------------------------------------------------------------
--------------------------------------------------------------------------------------------------------------------------------------------------------------------------------------------------------
--------------------------------------------------------------------------------------------------------------------------------------------------------------------------------------------------------
--------------------------------------------------------------------------------------------------------------------------------------------------------------------------------------------------------
--------------------------------------------------------------------------------------------------------------------------------------------------------------------------------------------------------
-------------------------------------------------------------------------------------------------------------------------------------#---#--------------------------------------------------------------
------------------------------------------------------------------------------------------------------------------------------------##---##-------------------------------------------------------------
-------------------------------------------------------%%%%-%%%%------------------------------------------------------------------%%%%---%%%%-----------------------------------------------------------
%%%%%%%%%%---------------------------------------------||||-||||------------------------------------------------------------------||||---||||-------------------------------------------------%%%%%F%%%%
||||||||||%%%%%%%%------------%%%%---%%%%-----------k--||||-||||----------------%%%%---%%%%--------------%%%%---%%%%--------------||||---||||--------------%%%%--%%%%-------------g--------g--|||||X||||
||||||||||||||||||%%%%%%%%%%%%||||---||||%%%%%%%%%%%%%%||||-||||%%%%%%%%%%%%%%%%||||---||||%%%%%%%%%%%%%%||||---||||%%%%%%%%%%%%%%||||---||||%%%%%%%%%%%%%%||||--||||%%%%%%%%%%%%%%%%%%%%%%%%%|||||X||||
