--------------------------------------------------------------------------------------------------------------------------------------------------------------------------------------------------------
--------------------------------------------------------------------------------------------------------------------------------------------------------------------------------------------------------
--------------------------------------------------------------------------------------------------------------------------------------------------------------------------------------------------------
--------------------------------------------------------------------------------------------------------------------------------------------------------------------------------------------------------
--------------------------------------------------------------------------------------------------------------------------------------------------------------------------------------------------------
--------------------------------------------------------------------------------------------------------------------------------------------------------------------------------------------------------
--------------------------------------------------------------------------------------------------------------------------------------------------------------------------------------------------------
--------------------------------------------------------------------------------------------------------------------------------------------------------------------------------------------------------
--------------------------------------------------------------------------------------------------------------------------------------------------------------------------------------------------------
--------------------------------------------------------------------------------------------------------------------------------------------------------------------------------------------------------
--------------------------------------------------------------------------------------------------------------------------------#---#-------------------------------------------------------------------
-------------------------------------------------------------------------------------------------------------------------------##---##------------------------------------------------------------------
----------%%%%%%%%%----------------------------------------------%%%%--%%%%--------------------------------------------------%%%%---%%%%----------------------------------------------------------------
----------|||||||||----------------------------------------------||||--||||--------------------------------------------------||||---||||----------------------------------------------------------------
----------|||||||||------------r--------------------g------------||||--||||--------------------g-----------------------------||||---||||----------------------------------------------------------------
XXXXXXXXXX|||||||||XXXXXXXXXXXXXXXXXXXXXXXXXXXXXXXXXXXXXXXXXXXXXX||||--||||XXXXXXXXXXXXXXXXXXXXXXXXXXXXXXXXXXXXXXXXXXXXXXXXXX||||---||||XXXXXXXXXXXXXXXXXXXXXXXXXXXXXXXXXXXXXXXXXXXXXXXXXXXXXXXXXXXFXXXX
