--------------------------------------------------------------------------------------------------------------------------------------------------------------------------------------------------------
--------------------------------------------------------------------------------------------------------------------------------------------------------------------------------------------------------
--------------------------------------------------------------------------------------------------------------------------------------------------------------------------------------------------------
--------------------------------------------------------------------------------------------------------------------------------------------------------------------------------------------------------
--------------------------------------------------------------------------------------------------------------------------------------------------------------------------------------------------------
--------------------------------------------------------------------------------------------------------------------------------------------------------------------------------------------------------
--------------------------------------------------------------------------------------------------------------------------------------------------------------------------------------------------------
--------------------------------------------------------------------------------------------------------------------------------------------------------------------------------------------------------
--------------------------------------------------------------------------------------------------------------------------------------------------------------------------------------------------------
--------------------------------------------------------------------------------------------------------------------------------------------------------------------------------------------------------
-------------------------------------------------------------------------------------------------------------------------------------#-----#------------------------------------------------------------
------------------------------------------------------------------------------------------------------------------------------------##-----##-----------------------------------------------------------
----------------------------------------------------------------------------------------------------------------------------------%%%%-----%%%%---------------#---#-------------------------------------
%%%%%%%%%%----------------------------------------------------------------------%%%%-----%%%%-------------------------------------||||-----||||--------------##---##--------------------------%%%%%F%%%%
||||||||||%%%%%%%%%------------------------------------%%%%--%%%%--k------------||||-----||||--------k----------------------------||||-----||||------------%%%%---%%%%--------------------r---|||||X||||
|||||||||||||||||||%%%%%%%%%%%%%%%-----%%%%%%%%%%%%%%%%||||--||||%%%%%%%%%%%%%%%||||-----||||%%%%%%%%%%%%%%%%-----%%%%%%%%%%%%%%%%||||-----||||%%%%%%%%%%%%||||---||||%%%%%%%%%%%%%%%%%%%%%%%%|||||X||||
