--------------------------------------------------------------------------------------------------------------------------------------------------------------------------------------------------------
--------------------------------------------------------------------------------------------------------------------------------------------------------------------------------------------------------
--------------------------------------------------------------------------------------------------------------------------------------------------------------------------------------------------------
--------------------------------------------------------------------------------------------------------------------------------------------------------------------------------------------------------
--------------------------------------------------------------------------------------------------------------------------------------------------------------------------------------------------------
--------------------------------------------------------------------------------------------------------------------------------------------------------------------------------------------------------
--------------------------------------------------------------------------------------------------------------------------------------------------------------------------------------------------------
--------------------------------------------------------------------------------------------------------------------------------------------------------------------------------------------------------
--------------------------------------------------------------------------------------------------------------------------------------------------------------------------------------------------------
--------------------------------------------------------------------------------------------------------------------------------------------------------------------------------------------------------
-----------------k--------------------------------------------------------------------------------------------------------------------------------------------------------------------------------------
-----------------BCCCCCC------------------B----------B-------------B--------B---------------B----------B-------------B---------------------B------------------------------------------------------------
-------------Tt--------------------------------------------------------------------#---#-----------------%%%%---%%%%------------------------------------------#-#---------------------------------------
%%%%%%%%%%---tt---------------g---------------------------------------------------##---##----------------||||---||||-----------------------------------------##-##--------------------------------------
||||||||||%%%%%%--------------%%%%---%%%%--------------%%%%---%%%%--------------%%%%---%%%%--------------||||---||||---------------------------------------%%%%-%%%%--------------------------%%%%%F%%%%
||||||||||||||||%%%%%%%%%%%%%%||||---||||%%%%%%%%%%%%%%||||---||||%%%%%%%%%%%%%%||||---||||%%%%%%%%%%%%%%||||---||||%%%%%%%%%%%%%%%%%%--%%%%%%%%%%%%%%%%%%%||||-||||%%%%%%%%%%%%%%%%%%%%%%%%%%|||||X||||
