--------------------------------------------------------------------------------------------------------------------------------------------------------------------------------------------------------
--------------------------------------------------------------------------------------------------------------------------------------------------------------------------------------------------------
--------------------------------------------------------------------------------------------------------------------------------------------------------------------------------------------------------
--------------------------------------------------------------------------------------------------------------------------------------------------------------------------------------------------------
--------------------------------------------------------------------------------------------------------------------------------------------------------------------------------------------------------
--------------------------------------------------------------------------------------------------------------------------------------------------------------------------------------------------------
--------------------------------------------------------------------------------------------------------------------------------------------------------------------------------------------------------
--------------------------------------------------------------------------------------------------------------------------------------------------------------------------------------------------------
--------------------------------------------------------------------------------------------------------------------------------------------------------------------------------------------------------
--------------------------------------------------------------------------------------------------------------------------------------------------------------------------------------------------------
--------------------------------------------------------------------------------------------------------------------------------------------------------------------------------------------------------
------------g-------------------------------------------------------------------------------------------------------------------------------------------------#---#-------------------------------------
----------%%%%%%%%---------------------------------------------------------------------------------------%%%%-%%%%-------------------------------------------##---##------------------------------------
----------||||||||------------%%%%---%%%%--------------%%%%--%%%%---------------%%%%---%%%%--------------||||-||||--------------------------g--------------%%%%---%%%%------------------------%%%%%F%%%%
%%%%%%%%%%||||||||------------||||---||||------k-------||||--||||---------------||||---||||------r--g----||||-||||-------------g--%%%%---%%%%--------------||||---||||------------------------|||||X||||
||||||||||||||||||%%%%%%%%%%%%||||---||||%%%%%%%%%%%%%%||||--||||%%%%%%%%%%%%%%%||||---||||%%%%%%%%%%%%%%||||-||||%%%%%%%%%%%%%%%%||||---||||%%%%%%%%%%%%%%||||---||||%%%%%%%%%%%%%%%%%%%%%%%%|||||X||||
