--------------------------------------------------------------------------------------------------------------------------------------------------------------------------------------------------------
--------------------------------------------------------------------------------------------------------------------------------------------------------------------------------------------------------
--------------------------------------------------------------------------------------------------------------------------------------------------------------------------------------------------------
--------------------------------------------------------------------------------------------------------------------------------------------------------------------------------------------------------
--------------------------------------------------------------------------------------------------------------------------------------------------------------------------------------------------------
--------------------------------------------------------------------------------------------------------------------------------------------------------------------------------------------------------
--------------------------------------------------------------------------------------------------------------------------------------------------------------------------------------------------------
--------------------------------------------------------------------------------------------------------------------------------------------------------------------------------------------------------
--------------------------------------------------------------------------------------------------------------------------------------------------------------------------------------------------------
--------------------------------------------------------------------------------------------------------------------------------------------------------------------------------------------------------
--------------------------------------------------------------------------------------------------------------------------------------------------------------------------------------------------------
-----------------BCCCUCCC---B-g--------r----B--------B-----------------------------------------------B-----------------B-------------#----#----------------------------B---------B--B-------------------
----------%%%%%%--------------%%%%-----%%%%-------------------------------------%%%%-----%%%%---------------------------------------##----##------------------------------------------------------------
----------||||||--------------||||-----||||-------------------------------------||||-----||||-------------------------------------%%%%----%%%%----------------------------------------------------------
----------||||||-k-G----------||||-----||||------------%%%%---%%%%--------------||||-----||||------------%%%%-----%%%%------------||||----||||-------------%%%%---%%%%----------------------------------
%%%%%%%%%%||||||%%%%%%%%%%%%%%||||-----||||%%%%%%%%%%%%||||---||||%%%%%%%%%%%%%%||||-----||||%%%%%%%%%%%%||||-----||||%%%%%%%%%%%%||||----||||%%%%%%%%%%%%%||||---||||%%%%%%%%%%%%%%%%%%%%%%%%%%%%%F%%%%
