--------------------------------------------------------------------------------------------------------------------------------------------------------------------------------------------------------
--------------------------------------------------------------------------------------------------------------------------------------------------------------------------------------------------------
--------------------------------------------------------------------------------------------------------------------------------------------------------------------------------------------------------
--------------------------------------------------------------------------------------------------------------------------------------------------------------------------------------------------------
--------------------------------------------------------------------------------------------------------------------------------------------------------------------------------------------------------
--------------------------------------------------------------------------------------------------------------------------------------------------------------------------------------------------------
--------------------------------------------------------------------------------------------------------------------------------------------------------------------------------------------------------
--------------------------------------------------------------------------------------------------------------------------------------------------------------------------------------------------------
--------------------------------------------------------------------------------------------------------------------------------------------------------------------------------------------------------
--------------------------------------------------------------------------------------------------------------------------------------------------------------------------------------------------------
---------------------------------#---#--------------------#----#----------------------------------------------------------------------------------------------------------------------------------------
-------SS------------2UCCCCC----##---##---S--------------##----##---S-----------g-------g--------------S------------------------S---------------S-------------------------------------------------------
------------------------------%%%%---%%%%-------SS-----%%%%----%%%%-------------%%%%----%%%%------------------------------------------------------------------------------------------------------------
------------------------------||||---||||--------------||||----||||-------------||||----||||---------------------------------------------------------------%%%%----%%%%---------------------------------
----------%%%%--------r-------||||---||||--------------||||----||||-------------||||----||||--------------------------------------%%%%-----%%%%------------||||----||||---------------------------------
XXXXXXXXXX||||XXXXXXXXXXXXXXXX||||---||||XXXXXXXXXXXXXX||||----||||XXXXXXXXXXXXX||||----||||XXXXXXXXXXXXXXXXX-----XXXXXXXXXXXXXXXX||||-----||||XXXXXXXXXXXX||||----||||XXXXXXXXXXXXXXXXXXXXXXXXXXXXFXXXX
