--------------------------------------------------------------------------------------------------------------------------------------------------------------------------------------------------------
--------------------------------------------------------------------------------------------------------------------------------------------------------------------------------------------------------
--------------------------------------------------------------------------------------------------------------------------------------------------------------------------------------------------------
--------------------------------------------------------------------------------------------------------------------------------------------------------------------------------------------------------
--------------------------------------------------------------------------------------------------------------------------------------------------------------------------------------------------------
--------------------------------------------------------------------------------------------------------------------------------------------------------------------------------------------------------
--------------------------------------------------------------------------------------------------------------------------------------------------------------------------------------------------------
--------------------------------------------------------------------------------------------------------------------------------------------------------------------------------------------------------
--------------------------------------------------------------------------------------------------------------------------------------------------------------------------------------------------------
--------------------------------------------------------------------------------------------------------------------------------------------------------------------------------------------------------
--------------------------------------------------------------------------------------------------------------------------------------------------------------------------------------------------------
---------------------------------#---#------------------------------------------------------------------------------------------------------------------------#---#-------------------------------------
--------------------------------##---##----------------------------------------------------------------------------------------------------------------------##---##------------------------------------
------------------------------%%%%---%%%%-----------------#---#----------------------g----------------------#--#-------------------------------------------%%%%---%%%%----------------------------------
%%%%%%%%%%--------------------||||---||||----------------##---##---------------g%%%%-%%%%-------g-g-g------##--##------------------------------------------||||---||||-r---------------------k%%%%%F%%%%
||||||||||XXXXXXXXXXXXXXXXXXXX||||---||||XXXXXXXXXXXXXXXXXX---XXXXXXXXXXXXXXXXXX||||-||||XXXXXXXXXXXXXXXXXXXX--XXXXXXXXXXXXXXXXXXXXXXX---XXXXXXXXXXXXXXXXXX||||---||||XXXXXXXXXXXXXXXXXXXXXXXX|||||X||||
