--------------------------------------------------------------------------------------------------------------------------------------------------------------------------------------------------------
--------------------------------------------------------------------------------------------------------------------------------------------------------------------------------------------------------
--------------------------------------------------------------------------------------------------------------------------------------------------------------------------------------------------------
--------------------------------------------------------------------------------------------------------------------------------------------------------------------------------------------------------
--------------------------------------------------------------------------------------------------------------------------------------------------------------------------------------------------------
--------------------------------------------------------------------------------------------------------------------------------------------------------------------------------------------------------
--------------------------------------------------------------------------------------------------------------------------------------------------------------------------------------------------------
--------------------------------------------------------------------------------------------------------------------------------------------------------------------------------------------------------
--------------------------------------------------------------------------------------------------------------------------------------------------------------------------------------------------------
--------------------------------------------------------------------------------------------------------------------------------------------------------------------------------------------------------
---------------------r----------------------------------------------------------------------------------------------------------------------------------------------------------------------------------
--------------------BCCCCCC-B-------------------B-----------------------------B-------------B----------B----------------------------------------------------------------------------------B-------------
----------%%%%%%%%%---------------------------------------#---#--------------------------------------------------------------------------------BB-------------------------------------------------------
----------|||||||||--------------------------------------##---##----------------%%%%---%%%%--------------%%%%---%%%%--------------------------------------------------------------------------%%%%%F%%%%
%%%%%%%%%%|||||||||-----------g------------------------%%%%---%%%%--------------||||---||||--------------||||---||||--------------%%%%--%%%%--------------------------------------------------|||||X||||
|||||||||||||||||||%%%%%%%%%%%%%%%-%%%%%%%%%%%%%%%%%%%%||||---||||%%%%%%%%%%%%%%||||---||||%%%%%%%%%%%%%%||||---||||%%%%%%%%%%%%%%||||--||||%%%%%%%%%%%%%%%%%%%---%%%%%%%%%%%%%%%%%%%%%%%%%%%%|||||X||||
