--------------------------------------------------------------------------------------------------------------------------------------------------------------------------------------------------------
--------------------------------------------------------------------------------------------------------------------------------------------------------------------------------------------------------
--------------------------------------------------------------------------------------------------------------------------------------------------------------------------------------------------------
--------------------------------------------------------------------------------------------------------------------------------------------------------------------------------------------------------
--------------------------------------------------------------------------------------------------------------------------------------------------------------------------------------------------------
--------------------------------------------------------------------------------------------------------------------------------------------------------------------------------------------------------
--------------------------------------------------------------------------------------------------------------------------------------------------------------------------------------------------------
--------------------------------------------------------------------------------------------------------------------------------------------------------------------------------------------------------
--------------------------------------------------------------------------------------------------------------------------------------------------------------------------------------------------------
--------------------------------------------------------------------------------------------------------------------------------------------------------------------------------------------------------
--------------------------------------------------------------------------------------------------------------------------------------------------------------------------------------------------------
-----------------------------------------------------------------------------------#-----#--------------------------------------------------------------------------------------------------------------
------------------------------%%%%-----%%%%---------------------------------------##-----##-------------------------------------------------------------------------------------------------------------
------------------------------||||-----||||---------------#--#------------------%%%%-----%%%%------------%%%%---%%%%----------------k-------------------------------------------------------------------
----------%%%%%%%%r--r--------||||-----||||--------------##--##--g--------------||||-----||||------------||||---||||--------------%%%%-----%%%%----r---r------------------g-----------------------------
XXXXXXXXXX||||||||XXXXXXXXXXXX||||-----||||XXXXXXXXXXXXXXXX--XXXXXXXXXXXXXXXXXXX||||-----||||XXXXXXXXXXXX||||---||||XXXXXXXXXXXXXX||||-----||||XXXXXXXXXXXXXXXX-----XXXXXXXXXXXXXXXXXXXXXXXXXXXXXXXFXXXX
