--------------------------------------------------------------------------------------------------------------------------------------------------------------------------------------------------------
--------------------------------------------------------------------------------------------------------------------------------------------------------------------------------------------------------
--------------------------------------------------------------------------------------------------------------------------------------------------------------------------------------------------------
--------------------------------------------------------------------------------------------------------------------------------------------------------------------------------------------------------
--------------------------------------------------------------------------------------------------------------------------------------------------------------------------------------------------------
--------------------------------------------------------------------------------------------------------------------------------------------------------------------------------------------------------
--------------------------------------------------------------------------------------------------------------------------------------------------------------------------------------------------------
--------------------------------------------------------------------------------------------------------------------------------------------------------------------------------------------------------
--------------------------------------------------------------------------------------------------------------------------------------------------------------------------------------------------------
--------------------------------------------------------------------------------------------------------------------------------------------------------------------------------------------------------
--------------------------------------------------------------------------------------------------------------------------------------------------------------------------------------------------------
---------------------------------------------------------------k---------------------------------------------------------------------#--#---------------------------------------------------------------
-------------------------------------------------------%%%%-%%%%----------------%%%%---%%%%-----------------------------------------##--##-----------------%%%%---%%%%----------------------------------
%%%%%%%%%%---------------------------------------------||||-||||----------------||||---||||---------------------------------------%%%%--%%%%---------------||||---||||----------------------------------
||||||||||%%%%%----------------------------------g-----||||-||||--g-------------||||---||||--------k------g-----------------------||||--||||-----------k---||||---||||k---------------------------------
|||||||||||||||%%%%%%%%%%%%%%%%%%%---%%%%%%%%%%%%%%%%%%||||-||||%%%%%%%%%%%%%%%%||||---||||%%%%%%%%%%%%%%%%%%---%%%%%%%%%%%%%%%%%%||||--||||%%%%%%%%%%%%%%%||||---||||%%%%%%%%%%%%%%%%%%%%%%%%%%%%%F%%%%
