--------------------------------------------------------------------------------------------------------------------------------------------------------------------------------------------------------
--------------------------------------------------------------------------------------------------------------------------------------------------------------------------------------------------------
--------------------------------------------------------------------------------------------------------------------------------------------------------------------------------------------------------
--------------------------------------------------------------------------------------------------------------------------------------------------------------------------------------------------------
--------------------------------------------------------------------------------------------------------------------------------------------------------------------------------------------------------
--------------------------------------------------------------------------------------------------------------------------------------------------------------------------------------------------------
--------------------------------------------------------------------------------------------------------------------------------------------------------------------------------------------------------
--------------------------------------------------------------------------------------------------------------------------------------------------------------------------------------------------------
--------------------------------------------------------------------------------------------------------------------------------------------------------------------------------------------------------
--------------------------------------------------------------------------------------------------------------------------------------------------------------------------------------------------------
--------------------------------------------------------------------------------------------------------------------------------------------------------------------------------------------------------
--------------------------------------------------------------------------------------------------------------------------------------------------------------------------------------------------------
--------------------------------------------------------------------------------------------------------------------------------------------------------------------------------------------------------
%%%%%%%%%%--------------------%%%%---%%%%---------------------------------------%%%%---%%%%---------------------------------------%%%%---%%%%-----------------------------------------------------------
||||||||||-------------%%%%%--||||---||||k--------------------------------------||||---||||--------------%%%%---%%%%--------------||||---||||---------------------g---------------------------%%%%%F%%%%
||||||||||%%%%%%%%%%%%%|||||%%||||---||||%%%%%%%%%%%%%%%%%%---%%%%%%%%%%%%%%%%%%||||---||||%%%%%%%%%%%%%%||||---||||%%%%%%%%%%%%%%||||---||||%%%%%%%%%%%%%%%%%%%%%%%%%%%%%%%%%%%%%%%%%%%%%%%%%|||||X||||
