--------------------------------------------------------------------------------------------------------------------------------------------------------------------------------------------------------
--------------------------------------------------------------------------------------------------------------------------------------------------------------------------------------------------------
--------------------------------------------------------------------------------------------------------------------------------------------------------------------------------------------------------
--------------------------------------------------------------------------------------------------------------------------------------------------------------------------------------------------------
--------------------------------------------------------------------------------------------------------------------------------------------------------------------------------------------------------
--------------------------------------------------------------------------------------------------------------------------------------------------------------------------------------------------------
--------------------------------------------------------------------------------------------------------------------------------------------------------------------------------------------------------
--------------------------------------------------------------------------------------------------------------------------------------------------------------------------------------------------------
--------------------------------------------------------------------------------------------------------------------------------------------------------------------------------------------------------
--------------------------------------------------------------------------------------------------------------------------------------------------------------------------------------------------------
--------------------------------------------------------------------------------------------------------------------------------------------------------------------------------------------------------
--------------------------------------------------------------------------------------------------------------------------------------------------------------------------------------------------------
-------------------------------------------------------%%%%-----%%%%---------------------------------------------------------------------------------------%%%%-%%%%------------------------------------
-------------------------------------------------------||||-----||||------------------------------------------------------------------------r--------------||||-||||--------------------------%%%%%F%%%%
%%%%%%%%%%-------g------------%%%%-----%%%%-g----------||||-----||||------------%%%%-----%%%%--g---------%%%%-----%%%%------------%%%%----%%%%-------------||||-||||----------g----g----r-----|||||X||||
||||||||||%%%%%%%%%%%%%%%%%%%%||||-----||||%%%%%%%%%%%%||||-----||||%%%%%%%%%%%%||||-----||||%%%%%%%%%%%%||||-----||||%%%%%%%%%%%%||||----||||%%%%%%%%%%%%%||||-||||%%%%%%%%%%%%%%%%%%%%%%%%%%|||||X||||
