--------------------------------------------------------------------------------------------------------------------------------------------------------------------------------------------------------
--------------------------------------------------------------------------------------------------------------------------------------------------------------------------------------------------------
--------------------------------------------------------------------------------------------------------------------------------------------------------------------------------------------------------
--------------------------------------------------------------------------------------------------------------------------------------------------------------------------------------------------------
--------------------------------------------------------------------------------------------------------------------------------------------------------------------------------------------------------
--------------------------------------------------------------------------------------------------------------------------------------------------------------------------------------------------------
--------------------------------------------------------------------------------------------------------------------------------------------------------------------------------------------------------
--------------------------------------------------------------------------------------------------------------------------------------------------------------------------------------------------------
--------------------------------------------------------------------------------------------------------------------------------------------------------------------------------------------------------
--------------------------------------------------------------------------------------------------------------------------------------------------------------------------------------------------------
--------------------------------------------------------------------------------------------------------------------------------------------------------------------------------------------------------
--------------------------------------------------------------------------------------------------------------------------------------------------------------------------------------------------------
---------------------------------#-----#-----------------------------------------------------------------%%%%-----%%%%----------------------------------------------------------------------------------
--------------------------------##-----##-----------------#-----#---------------%%%%----%%%%-------------||||-----||||-------------------------------------%%%%----%%%%---------------------------------
%%%%%%%%%%-g------------------%%%%-----%%%%--------------##-----##--------------||||----||||-------------||||-----||||-------------------------------------||||----||||----------------r---r--%%%%%F%%%%
||||||||||XXXXXXXXXXXXXXXXXXXX||||-----||||XXXXXXXXXXXXXXXX-----XXXXXXXXXXXXXXXX||||----||||XXXXXXXXXXXXX||||-----||||XXXXXXXXXXXXXXXX--XXXXXXXXXXXXXXXXXXX||||----||||XXXXXXXXXXXXXXXXXXXXXXX|||||X||||
