--------------------------------------------------------------------------------------------------------------------------------------------------------------------------------------------------------
--------------------------------------------------------------------------------------------------------------------------------------------------------------------------------------------------------
--------------------------------------------------------------------------------------------------------------------------------------------------------------------------------------------------------
--------------------------------------------------------------------------------------------------------------------------------------------------------------------------------------------------------
--------------------------------------------------------------------------------------------------------------------------------------------------------------------------------------------------------
--------------------------------------------------------------------------------------------------------------------------------------------------------------------------------------------------------
--------------------------------------------------------------------------------------------------------------------------------------------------------------------------------------------------------
--------------------------------------------------------------------------------------------------------------------------------------------------------------------------------------------------------
--------------------------------------------------------------------------------------------------------------------------------------------------------------------------------------------------------
--------------------------------------------------------------------------------------------------------------------------------------------------------------------------------------------------------
-------------------------------------------------------------------------------------------------------------------------------------#---#--------------------------------------------------------------
------------------------------------------------------------------------------------------------------------------------------------##---##-------------------------------------------------------------
----------------g-------------k--------k------------------------------------------------------------------------------------------%%%%---%%%%-----------------------------------------------------------
%%%%%%%%%%%%%%%%%-------------%%%%---%%%%--------------%%%%--%%%%------------------#---#-----------------%%%%--%%%%---------------||||---||||-----------------------------------------------------------
|||||||||||||||||------------k||||---||||--------------||||--||||-----------------##---##-------r------g-||||--||||-------------k-||||---||||-------------------------------------------------%%%%%F%%%%
|||||||||||||||||XXXXXXXXXXXXX||||---||||XXXXXXXXXXXXXX||||--||||XXXXXXXXXXXXXXXXXXX---XXXXXXXXXXXXXXXXXX||||--||||XXXXXXXXXXXXXXX||||---||||XXXXXXXXXXXXXXXXXX--XXXXXXXXXXXXXXXXXXXXXXXXXXXXX|||||X||||
