--------------------------------------------------------------------------------------------------------------------------------------------------------------------------------------------------------
--------------------------------------------------------------------------------------------------------------------------------------------------------------------------------------------------------
--------------------------------------------------------------------------------------------------------------------------------------------------------------------------------------------------------
--------------------------------------------------------------------------------------------------------------------------------------------------------------------------------------------------------
--------------------------------------------------------------------------------------------------------------------------------------------------------------------------------------------------------
--------------------------------------------------------------------------------------------------------------------------------------------------------------------------------------------------------
--------------------------------------------------------------------------------------------------------------------------------------------------------------------------------------------------------
--------------------------------------------------------------------------------------------------------------------------------------------------------------------------------------------------------
--------------------------------------------------------------------------------------------------------------------------------------------------------------------------------------------------------
--------------------------------------------------------------------------------------------------------------------------------------------------------------------------------------------------------
-------------------------------------------------------------------------------------------------------------------------------------#---#--------------------------------------------------------------
-----------------------------------------------------------------------------------------------------------------------------------g##---##-------------------------------------------------------------
-------------%%%%%%%%-------------------------------------------------------------g-------------------------k---------------------%%%%---%%%%-----------------------------------------------------------
-----------g-||||||||------------#-----#----------------------------------------%%%%-----%%%%------------%%%%-----%%%%------------||||---||||-----------------#---#---------------------------%%%%%F%%%%
----------%%%||||||||-----------##-----##--------r-----%%%%----%%%%-------------||||-----||||-------r----||||-----||||------------||||---||||----k-----------##---##--------------------------|||||%||||
XXXXXXXXXX|||||||||||XXXXXXXXXXXXX-----XXXXXXXXXXXXXXXX||||----||||XXXXXXXXXXXXX||||-----||||XXXXXXXXXXXX||||-----||||XXXXXXXXXXXX||||---||||XXXXXXXXXXXXXXXXXX---XXXXXXXXXXXXXXXXXXXXXXXXXXXX||||||||||
