--------------------------------------------------------------------------------------------------------------------------------------------------------------------------------------------------------
--------------------------------------------------------------------------------------------------------------------------------------------------------------------------------------------------------
--------------------------------------------------------------------------------------------------------------------------------------------------------------------------------------------------------
--------------------------------------------------------------------------------------------------------------------------------------------------------------------------------------------------------
--------------------------------------------------------------------------------------------------------------------------------------------------------------------------------------------------------
--------------------------------------------------------------------------------------------------------------------------------------------------------------------------------------------------------
--------------------------------------------------------------------------------------------------------------------------------------------------------------------------------------------------------
--------------------------------------------------------------------------------------------------------------------------------------------------------------------------------------------------------
--------------------------------------------------------------------------------------------------------------------------------------------------------------------------------------------------------
--------------------------------------------------------------------------------------------------------------------------------------------------------------------------------------------------------
-----------------g--------------------------------------------------------------------------------------------------------------------------------------------------------------------------------------
-----------------2CCCCCC-B---------------B------------------------------------B----------------------B------------------------------------------B------B---------------B-----------------B--------------
------------------------------r------------------------%%%%---%%%%--------------------------------------------------------------------------------------------------------------------------------------
------------------------------%%%%--%%%%---------------||||---||||-----------------------------------------------------------------------------------------%%%%---%%%%----------------------------------
%%%%%%%%%%--------------------||||--||||---------------||||---||||--------------%%%%--%%%%----------------------------------------%%%%--%%%%---------------||||---||||----------------------------------
||||||||||%%%%%%%%%%%%%%%%%%%%||||--||||%%%%%%%%%%%%%%%||||---||||%%%%%%%%%%%%%%||||--||||%%%%%%%%%%%%%%%%%%%---%%%%%%%%%%%%%%%%%%||||--||||%%%%%%%%%%%%%%%||||---||||%%%%%%%%%%%%%%%%%%%%%%%%%%%%%F%%%%
