--------------------------------------------------------------------------------------------------------------------------------------------------------------------------------------------------------
--------------------------------------------------------------------------------------------------------------------------------------------------------------------------------------------------------
--------------------------------------------------------------------------------------------------------------------------------------------------------------------------------------------------------
--------------------------------------------------------------------------------------------------------------------------------------------------------------------------------------------------------
--------------------------------------------------------------------------------------------------------------------------------------------------------------------------------------------------------
--------------------------------------------------------------------------------------------------------------------------------------------------------------------------------------------------------
--------------------------------------------------------------------------------------------------------------------------------------------------------------------------------------------------------
--------------------------------------------------------------------------------------------------------------------------------------------------------------------------------------------------------
--------------------------------------------------------------------------------------------------------------------------------------------------------------------------------------------------------
--------------------------------------------------------------------------------------------------------------------------------------------------------------------------------------------------------
-------------------------------------------------------------------------------------------------------------------------------------#-----#------------------------------------------------------------
------------------------------------------------------------------------------------------------------------------------------------##-----##-----------------------------------------------------------
----------------------------------------------------------------------------------------------------------------------------------%%%%-----%%%%---------------#---#-------------------------------------
%%%%%%%%%%----------------------------------------------------------------------%%%%-----%%%%-------------------------------------||||-----||||--------------##---##--------------------------%%%%%F%%%%
||||||||||%%%%%%%%%------------------------------------%%%%--%%%%--k------------||||-----||||--------k----------------------------||||-----||||------------%%%%---%%%%--------------------r---|||||%||||
|||||||||||||||||||XXXXXXXXXXXXXXX-----XXXXXXXXXXXXXXXX||||--||||XXXXXXXXXXXXXXX||||-----||||XXXXXXXXXXXXXXXX-----XXXXXXXXXXXXXXXX||||-----||||XXXXXXXXXXXX||||---||||XXXXXXXXXXXXXXXXXXXXXXXX||||||||||
