--------------------------------------------------------------------------------------------------------------------------------------------------------------------------------------------------------
--------------------------------------------------------------------------------------------------------------------------------------------------------------------------------------------------------
--------------------------------------------------------------------------------------------------------------------------------------------------------------------------------------------------------
--------------------------------------------------------------------------------------------------------------------------------------------------------------------------------------------------------
--------------------------------------------------------------------------------------------------------------------------------------------------------------------------------------------------------
--------------------------------------------------------------------------------------------------------------------------------------------------------------------------------------------------------
--------------------------------------------------------------------------------------------------------------------------------------------------------------------------------------------------------
--------------------------------------------------------------------------------------------------------------------------------------------------------------------------------------------------------
--------------------------------------------------------------------------------------------------------------------------------------------------------------------------------------------------------
--------------------------------------------------------------------------------------------------------------------------------------------------------------------------------------------------------
--------------------------------------------------------------------#--------#--------------------------------------------------------------------------------------------------------------------------
------------------CCCCCC----C-----B----------------------B---------##--------##----------------B---------------------------------------------B-----------B------------B-----------B---------B-----------
-----------------------------------------------------------------%%%%--------%%%%-----------------------------------------------#-------#---------------------------------------------------------------
----------%%%%%%-------------------------------------------------||||--------||||----------------------------------------------##-------##--------------------------------------------------------------
----------||||||-g-------------------------------k---------------||||--------||||---------------g----r-----------------------%%%%-------%%%%------------------------------------g---------g-------------
%%%%%%%%%%||||||%%%%%%%%%%%%%%%%%%%%%%%%%%%%%%%%%%%%%%%%%%%%%%%%%||||--------||||%%%%%%%%%%%%%%%%%%%%%%%%%%%%%%%%%%%%%%%%%%%%||||-------||||%%%%%%%%%%%%%%%%%%%%%%%%%%%%%%%%%%%%%%%%%%%%%%%%%%%%%%%F%%%%
