--------------------------------------------------------------------------------------------------------------------------------------------------------------------------------------------------------
--------------------------------------------------------------------------------------------------------------------------------------------------------------------------------------------------------
--------------------------------------------------------------------------------------------------------------------------------------------------------------------------------------------------------
--------------------------------------------------------------------------------------------------------------------------------------------------------------------------------------------------------
--------------------------------------------------------------------------------------------------------------------------------------------------------------------------------------------------------
--------------------------------------------------------------------------------------------------------------------------------------------------------------------------------------------------------
--------------------------------------------------------------------------------------------------------------------------------------------------------------------------------------------------------
--------------------------------------------------------------------------------------------------------------------------------------------------------------------------------------------------------
--------------------------------------------------------------------------------------------------------------------------------------------------------------------------------------------------------
--------------------------------------------------------------------------------------------------------------------------------------------------------------------------------------------------------
-------------------------g------------------------------------------------------------------------------------------------------------------------------------------------------------------------------
--------------------------CCCCCCC--S---------S--S-------------------#---#-----------S--S-----------------------S-----------S--------------------------S-------------------------------------------------
----------%%%%-----------------------------------------------------##---##------------------------------------------------------#--#--------------------------------------------------------------------
----------||||---------------------------------------------------%%%%---%%%%---------------------------------------------------##--##---------------------------------------------------------%%%%%F%%%%
%%%%%%%%%%||||---------------------------------------------------||||---||||-------------------------------------------------%%%%--%%%%------g----k-------------------------------------------|||||%||||
||||||||||||||XXXXXXXXXXXXXXXXXXXXXXXXXXXXXXXXXXXXXXXXXXXXXXXXXXX||||---||||XXXXXXXXXXXXXXXXXXXXXXXXXXXXXXXXXXXXXXXXXXXXXXXXX||||--||||XXXXXXXXXXXXXXXXXXXXXXXXXXXXXXXXXXXXXXXXXXXXXXXXXXXXXXX||||||||||
