--------------------------------------------------------------------------------------------------------------------------------------------------------------------------------------------------------
--------------------------------------------------------------------------------------------------------------------------------------------------------------------------------------------------------
--------------------------------------------------------------------------------------------------------------------------------------------------------------------------------------------------------
--------------------------------------------------------------------------------------------------------------------------------------------------------------------------------------------------------
--------------------------------------------------------------------------------------------------------------------------------------------------------------------------------------------------------
--------------------------------------------------------------------------------------------------------------------------------------------------------------------------------------------------------
--------------------------------------------------------------------------------------------------------------------------------------------------------------------------------------------------------
--------------------------------------------------------------------------------------------------------------------------------------------------------------------------------------------------------
--------------------------------------------------------------------------------------------------------------------------------------------------------------------------------------------------------
--------------------------------------------------------------------------------------------------------------------------------------------------------------------------------------------------------
-----------------------------------------------------------------------------------#--#-----------------------------------------------------------------------------------------------------------------
------------------CCCCCC--------------------2------------------------S--------S---##--##---S---------------------------S----------------------S------S--------#-----#----S-------S----------------------
------------------------------r------------------------%%%%-----%%%%------------%%%%--%%%%-------------------------------------------------------------------##-----##----------------------------------
----------%%%%%%--------------%%%%-----%%%%------------||||-----||||------------||||--||||----------------------------------------%%%%---%%%%--------------%%%%-----%%%%--------------------------------
%%%%%%%%%%||||||-g------------||||-----||||------------||||-----||||------------||||--||||----------------------------------------||||---||||--------------||||-----||||--------------------------------
||||||||||||||||XXXXXXXXXXXXXX||||-----||||XXXXXXXXXXXX||||-----||||XXXXXXXXXXXX||||--||||XXXXXXXXXXXXXXXXXXX-----XXXXXXXXXXXXXXXX||||---||||XXXXXXXXXXXXXX||||-----||||XXXXXXXXXXXXXXXXXXXXXXXXXXXFXXXX
