--------------------------------------------------------------------------------------------------------------------------------------------------------------------------------------------------------
--------------------------------------------------------------------------------------------------------------------------------------------------------------------------------------------------------
--------------------------------------------------------------------------------------------------------------------------------------------------------------------------------------------------------
--------------------------------------------------------------------------------------------------------------------------------------------------------------------------------------------------------
--------------------------------------------------------------------------------------------------------------------------------------------------------------------------------------------------------
--------------------------------------------------------------------------------------------------------------------------------------------------------------------------------------------------------
--------------------------------------------------------------------------------------------------------------------------------------------------------------------------------------------------------
--------------------------------------------------------------------------------------------------------------------------------------------------------------------------------------------------------
--------------------------------------------------------------------------------------------------------------------------------------------------------------------------------------------------------
--------------------------------------------------------------------------------------------------------------------------------------------------------------------------------------------------------
--------------------------------------------------------------------------------------------------------------------------------#--------#--------------------------------------------------------------
-----------------CCUCCCC2------------B-----------------------B-------------------B--------B--B----------------------B----------##--------##---B----------B----------------------------------------------
----------%%%%%--------------------------------------------------------------------------------------------------------------%%%%--------%%%%-----------------------------------------------------------
%%%%%%%%%%|||||--------------------------------------------------r----------k------------------------------------------------||||--------||||-------------------------------------------------%%%%%F%%%%
|||||||||||||||-g------------------------------------------------%%%%-------%%%%---------------------------------------------||||--------||||-----------r-------------------------------------|||||X||||
|||||||||||||||%%%%%%%%%%%%%%%%%%%%%%%%%%%%%%%%%%%%%%%%%%%%%%%%%%||||-------||||%%%%%%%%%%%%%%%%%%%%%%%%%%%%%%%%%%%%%%%%%%%%%||||--------||||%%%%%%%%%%%%%%%%%%%%%%%%%%%%%%%%%%%%%%%%%%%%%%%%%|||||X||||
