--------------------------------------------------------------------------------------------------------------------------------------------------------------------------------------------------------
--------------------------------------------------------------------------------------------------------------------------------------------------------------------------------------------------------
--------------------------------------------------------------------------------------------------------------------------------------------------------------------------------------------------------
--------------------------------------------------------------------------------------------------------------------------------------------------------------------------------------------------------
--------------------------------------------------------------------------------------------------------------------------------------------------------------------------------------------------------
--------------------------------------------------------------------------------------------------------------------------------------------------------------------------------------------------------
--------------------------------------------------------------------------------------------------------------------------------------------------------------------------------------------------------
--------------------------------------------------------------------------------------------------------------------------------------------------------------------------------------------------------
--------------------------------------------------------------------------------------------------------------------------------------------------------------------------------------------------------
--------------------------------------------------------------------------------------------------------------------------------------------------------------------------------------------------------
-----------------r------------------------------------------------------------------------------------------#-----#-------------------------------------------#---#-------------------------------------
----------------SUCCCCCCS-----------------------------------------------------S----------------------------##-----##------------S----#-----#----S------------##---##---S--------------------------------
--------------------------------------------------------------------------------%%%%----%%%%-------------%%%%-----%%%%--------------##-----##--------------%%%%---%%%%--------SSS-----------------------
%%%%%%%%%%--------------------k-------r-------------------#----#----------------||||----||||-------------||||-----||||------------%%%%-----%%%%------------||||---||||------------------------%%%%%F%%%%
||||||||||--------------------%%%%----%%%%---------------##----##---------------||||----||||-------------||||-----||||------------||||-----||||------------||||---||||------------------------|||||%||||
||||||||||XXXXXXXXXXXXXXXXXXXX||||----||||XXXXXXXXXXXXXXXXX----XXXXXXXXXXXXXXXXX||||----||||XXXXXXXXXXXXX||||-----||||XXXXXXXXXXXX||||-----||||XXXXXXXXXXXX||||---||||XXXXXXXXXXXXXXXXXXXXXXXX||||||||||
