--------------------------------------------------------------------------------------------------------------------------------------------------------------------------------------------------------
--------------------------------------------------------------------------------------------------------------------------------------------------------------------------------------------------------
--------------------------------------------------------------------------------------------------------------------------------------------------------------------------------------------------------
--------------------------------------------------------------------------------------------------------------------------------------------------------------------------------------------------------
--------------------------------------------------------------------------------------------------------------------------------------------------------------------------------------------------------
--------------------------------------------------------------------------------------------------------------------------------------------------------------------------------------------------------
--------------------------------------------------------------------------------------------------------------------------------------------------------------------------------------------------------
--------------------------------------------------------------------------------------------------------------------------------------------------------------------------------------------------------
--------------------------------------------------------------------------------------------------------------------------------------------------------------------------------------------------------
--------------------------------------------------------------------------------------------------------------------------------------------------------------------------------------------------------
--------------------------------------------------------------------------------------------------------------------------------------------------------------#---#-------------------------------------
-------------------------------------------------------------------------------------------------------------------------------------------------------------##---##------------------------------------
---------------------------------------r-------------------------------------------------------------------------------------------------------------------%%%%---%%%%----------------------------------
------------------------------%%%%---%%%%-------------------------------------------------------------------#--#-------------------------------------------||||---||||------------------------%%%%%F%%%%
----------%%%%%%%%%%%%%%------||||---||||---g------------------------------------k-------------------------##--##------------------------------------------||||---||||------------------------|||||X||||
%%%%%%%%%%||||||||||||||%%%%%%||||---||||%%%%%%%%%%%%%%%%%%---%%%%%%%%%%%%%%%%%%%%%%---%%%%%%%%%%%%%%%%%%%%%%--%%%%%%%%%%%%%%%%%%%%%%%-%%%%%%%%%%%%%%%%%%%%||||---||||%%%%%%%%%%%%%%%%%%%%%%%%|||||X||||
