--------------------------------------------------------------------------------------------------------------------------------------------------------------------------------------------------------
--------------------------------------------------------------------------------------------------------------------------------------------------------------------------------------------------------
--------------------------------------------------------------------------------------------------------------------------------------------------------------------------------------------------------
--------------------------------------------------------------------------------------------------------------------------------------------------------------------------------------------------------
--------------------------------------------------------------------------------------------------------------------------------------------------------------------------------------------------------
--------------------------------------------------------------------------------------------------------------------------------------------------------------------------------------------------------
--------------------------------------------------------------------------------------------------------------------------------------------------------------------------------------------------------
--------------------------------------------------------------------------------------------------------------------------------------------------------------------------------------------------------
--------------------------------------------------------------------------------------------------------------------------------------------------------------------------------------------------------
--------------------------------------------------------------------------------------------------------------------------------------------------------------------------------------------------------
-----------------r--------------------------------------------------#---#-------------------------------------------------------------------------------------------------------------------------------
------------------CCCCCCC-S--------------------------S-------------##---##---S-------S-------------S------------S-----------------------S-----------------------S---------------------------------------
----------%%%%%%-------------------------------------------------%%%%---%%%%----------------------------------------------------------------------------------------------------------------------------
----------||||||-------------------------------------------------||||---||||-------------------------------------------------k-----g----------------------------------------------------------%%%%%F%%%%
%%%%%%%%%%||||||-------------------------------------------------||||---||||-------------------------------------------------%%%%--%%%%---------------------r---------------------------------|||||%||||
||||||||||||||||XXXXXXXXXXXXXXXXXXXXXXXXXXXXXXXXXXXXXXXXXXXXXXXXX||||---||||XXXXXXXXXXXXXXXXXXXXXXXXXXXXXXXXXXXXXXXXXXXXXXXXX||||--||||XXXXXXXXXXXXXXXXXXXXXXXXXXXXXXXXXXXXXXXXXXXXXXXXXXXXXXX||||||||||
